,hexiao_num,pred,pred1,,
226,74,40.2,40,33.8,34
15367,32,15,15,17,17
13647,25,18.3,18,6.7,7
21631,15,9.5,9,5.5,6
43102,16,10.9,10,5.1,6
38916,8,4,4,4,4
7496,8,4,4,4,4
10122,8,4,4,4,4
15260,31,27.5,27,3.5,4
44043,15,12.1,12,2.9,3
43572,8,5.1,5,2.9,3
45247,6,3.1,3,2.9,3
7903,7,4.2,4,2.8,3
66127,9,6.2,6,2.8,3
43661,5,2.4,2,2.6,3
20080,14,11.4,11,2.6,3
61690,7,4.5,4,2.5,3
8845,6,3.6,3,2.4,3
54515,14,11.7,11,2.3,3
1980,4,2,2,2,2
44104,6,4.1,4,1.9,2
53916,2,0.2,0,1.8,2
37131,10,8.3,8,1.7,2
3161,5,3.4,3,1.6,2
48647,6,4.4,4,1.6,2
2534,3,1.5,1,1.5,2
193,9,7.5,7,1.5,2
1563,6,4.5,4,1.5,2
85390,3,1.7,1,1.3,2
61248,4,2.7,2,1.3,2
106339,4,2.766666667,2,1.233333333,2
46929,3,1.8,1,1.2,2
9443,3,1.8,1,1.2,2
112037,2,0.8,0,1.2,2
108718,2,0.8,0,1.2,2
24587,2,0.8,0,1.2,2
86072,16,14.8,14,1.2,2
4088,2,0.9,0,1.1,2
43799,8,6.9,6,1.1,2
13971,1,0,0,1,1
69989,4,3,3,1,1
44976,4,3,3,1,1
100220,2,1,1,1,1
24549,3,2,2,1,1
66508,5,4.08,4,0.92,1
26947,15,14.1,14,0.9,1
55072,5,4.1,4,0.9,1
63195,1,0.1,0,0.9,1
62107,4,3.1,3,0.9,1
44208,2,1.1,1,0.9,1
39141,2,1.1,1,0.9,1
113925,1,0.106666667,0,0.893333333,1
82431,1,0.132638889,0,0.867361111,1
63056,14,13.2,13,0.8,1
31208,9,8.2,8,0.8,1
69813,2,1.2,1,0.8,1
82112,2,1.2,1,0.8,1
114149,6,5.2,5,0.8,1
17545,3,2.2,2,0.8,1
109087,3,2.2,2,0.8,1
22262,3,2.2,2,0.8,1
98162,3,2.2,2,0.8,1
120275,4,3.2,3,0.8,1
77552,4,3.2,3,0.8,1
55856,2,1.260873016,1,0.739126984,1
42365,2,1.260873016,1,0.739126984,1
90077,3,2.3,2,0.7,1
110403,8,7.3,7,0.7,1
98551,3,2.3,2,0.7,1
68606,2,1.3,1,0.7,1
794,2,1.3,1,0.7,1
9382,15,14.3,14,0.7,1
22875,15,14.3,14,0.7,1
54028,9,8.3,8,0.7,1
73905,1,0.383333333,0,0.616666667,1
31511,3,2.4,2,0.6,1
880,2,1.4,1,0.6,1
73471,4,3.4,3,0.6,1
69308,3,2.4,2,0.6,1
64532,10,9.4,9,0.6,1
17330,16,15.4,15,0.6,1
2010,6,5.4,5,0.6,1
21242,1,0.402772922,0,0.597227078,1
116181,1,0.402772922,0,0.597227078,1
18866,1,0.402772922,0,0.597227078,1
20116,1,0.402772922,0,0.597227078,1
21350,1,0.402772922,0,0.597227078,1
83350,2,1.471428571,1,0.528571429,1
9822,2,1.5,1,0.5,1
8951,7,6.5,6,0.5,1
24043,2,1.5,1,0.5,1
50820,2,1.5,1,0.5,1
86290,2,1.5,1,0.5,1
15909,1,0.5,0,0.5,1
32516,2,1.5,1,0.5,1
8778,6,5.5,5,0.5,1
79913,8,7.5,7,0.5,1
103690,8,7.5,7,0.5,1
93057,13,12.5,12,0.5,1
15414,2,1.5,1,0.5,1
9096,4,3.5,3,0.5,1
2076,1,0.5,0,0.5,1
41550,1,0.5,0,0.5,1
20030,2,1.5,1,0.5,1
2837,2,1.5,1,0.5,1
72602,5,4.52,4,0.48,1
96634,1,0.535,0,0.465,1
79834,1,0.535,0,0.465,1
11734,3,2.541666667,2,0.458333333,1
94121,11,10.6,10,0.4,1
23045,13,12.6,12,0.4,1
78687,8,7.6,7,0.4,1
103958,1,0.6,0,0.4,1
17355,1,0.6,0,0.4,1
19881,2,1.6,1,0.4,1
4792,4,3.6,3,0.4,1
12294,2,1.6,1,0.4,1
15055,2,1.6,1,0.4,1
105772,3,2.6,2,0.4,1
115045,3,2.6,2,0.4,1
73891,2,1.6,1,0.4,1
87631,5,4.625,4,0.375,1
63079,1,0.641666667,0,0.358333333,1
22538,1,0.651666667,0,0.348333333,1
38565,19,18.7,18,0.3,1
9430,11,10.7,10,0.3,1
125,13,12.7,12,0.3,1
7604,2,1.7,1,0.3,1
15130,2,1.7,1,0.3,1
91822,1,0.7,0,0.3,1
44206,2,1.7,1,0.3,1
58715,2,1.7,1,0.3,1
111548,2,1.7,1,0.3,1
58437,7,6.7,6,0.3,1
16925,1,0.711247972,0,0.288752028,1
96350,1,0.711247972,0,0.288752028,1
41775,1,0.711247972,0,0.288752028,1
112654,1,0.758333333,0,0.241666667,1
111746,1,0.785,0,0.215,1
29802,7,6.8,6,0.2,1
14362,6,5.8,5,0.2,1
13618,6,5.8,5,0.2,1
21321,7,6.8,6,0.2,1
101464,4,3.8,3,0.2,1
99613,6,5.8,5,0.2,1
99742,4,3.8,3,0.2,1
58629,8,7.8,7,0.2,1
32887,6,5.8,5,0.2,1
18357,2,1.8,1,0.2,1
47412,2,1.8,1,0.2,1
60681,1,0.8,0,0.2,1
98435,1,0.8,0,0.2,1
25180,15,14.8,14,0.2,1
88192,2,1.814285714,1,0.185714286,1
40116,1,0.832954545,0,0.167045455,1
103871,4,3.85,3,0.15,1
53756,1,0.858452951,0,0.141547049,1
14325,17,16.9,16,0.1,1
59989,20,19.9,19,0.1,1
9507,17,16.9,16,0.1,1
88386,3,2.9,2,0.1,1
20559,2,1.9,1,0.1,1
9581,2,1.9,1,0.1,1
45194,4,3.9,3,0.1,1
57104,4,3.9,3,0.1,1
115567,1,0.9,0,0.1,1
110035,1,0.9,0,0.1,1
44834,1,0.9,0,0.1,1
66638,1,0.9,0,0.1,1
101960,1,0.9,0,0.1,1
62576,1,0.9,0,0.1,1
114008,1,0.9,0,0.1,1
4475,10,9.9,9,0.1,1
108442,10,9.9,9,0.1,1
79033,9,8.9,8,0.1,1
94984,6,5.9,5,0.1,1
86190,14,13.9,13,0.1,1
2708,7,6.9,6,0.1,1
10628,8,7.9,7,0.1,1
75021,11,10.9,10,0.1,1
95869,6,5.9,5,0.1,1
5418,11,10.9,10,0.1,1
1651,15,14.9,14,0.1,1
6321,13,12.9,12,0.1,1
275,7,6.9,6,0.1,1
8513,12,11.9,11,0.1,1
28535,7,6.9,6,0.1,1
52263,7,6.9,6,0.1,1
112999,2,1.914761905,1,0.085238095,1
62033,2,1.914761905,1,0.085238095,1
103507,1,0.920805892,0,0.079194108,1
80089,1,0.920805892,0,0.079194108,1
48493,1,0.920805892,0,0.079194108,1
112847,1,0.920805892,0,0.079194108,1
111559,1,0.920805892,0,0.079194108,1
93869,1,0.920805892,0,0.079194108,1
101221,1,0.925272727,0,0.074727273,1
41816,0,0,0,0,0
10629,0,0,0,0,0
48940,0,0,0,0,0
107774,0,0,0,0,0
79921,0,0,0,0,0
62829,0,0,0,0,0
101523,0,0,0,0,0
115004,0,0,0,0,0
40043,0,0,0,0,0
78601,0,0,0,0,0
37974,0,0,0,0,0
88422,0,0,0,0,0
104504,0,0,0,0,0
59384,0,0,0,0,0
15219,1,1,1,0,0
118264,0,0,0,0,0
87202,0,0,0,0,0
11712,0,0,0,0,0
60911,0,0,0,0,0
109382,0,0,0,0,0
21966,0,0,0,0,0
89436,0,0,0,0,0
89581,0,0,0,0,0
103468,0,0,0,0,0
10677,0,0,0,0,0
15759,0,0,0,0,0
85391,0,0,0,0,0
79619,0,0,0,0,0
5030,0,0,0,0,0
8013,0,0,0,0,0
6224,0,0,0,0,0
86825,0,0,0,0,0
51088,0,0,0,0,0
33081,0,0,0,0,0
101915,0,0,0,0,0
75055,5,5,5,0,0
13996,0,0,0,0,0
24466,0,0,0,0,0
97482,0,0,0,0,0
65652,0,0,0,0,0
19824,1,1,1,0,0
113837,0,0,0,0,0
118108,0,0,0,0,0
66334,0,0,0,0,0
71297,0,0,0,0,0
20725,0,0,0,0,0
104069,0,0,0,0,0
14270,0,0,0,0,0
29756,0,0,0,0,0
34802,0,0,0,0,0
49183,0,0,0,0,0
2476,0,0,0,0,0
22252,0,0,0,0,0
83856,0,0,0,0,0
82301,0,0,0,0,0
63995,0,0,0,0,0
57719,0,0,0,0,0
73139,0,0,0,0,0
114927,0,0,0,0,0
91505,0,0,0,0,0
53882,0,0,0,0,0
46120,0,0,0,0,0
83365,0,0,0,0,0
56096,0,0,0,0,0
106341,0,0,0,0,0
32686,0,0,0,0,0
45529,0,0,0,0,0
84257,0,0,0,0,0
25277,0,0,0,0,0
64104,0,0,0,0,0
36807,0,0,0,0,0
50161,3,3,3,0,0
69690,0,0,0,0,0
114146,0,0,0,0,0
38918,0,0,0,0,0
18561,0,0,0,0,0
62137,0,0,0,0,0
55231,0,0,0,0,0
80106,0,0,0,0,0
30213,0,0,0,0,0
48959,0,0,0,0,0
106186,0,0,0,0,0
40741,0,0,0,0,0
70802,0,0,0,0,0
36973,0,0,0,0,0
46194,0,0,0,0,0
52308,0,0,0,0,0
49723,0,0,0,0,0
15839,0,0,0,0,0
106492,0,0,0,0,0
56446,0,0,0,0,0
117829,0,0,0,0,0
46727,0,0,0,0,0
44523,0,0,0,0,0
79507,0,0,0,0,0
78679,0,0,0,0,0
80257,0,0,0,0,0
65446,0,0,0,0,0
52329,0,0,0,0,0
3564,0,0,0,0,0
101350,0,0,0,0,0
48386,0,0,0,0,0
116656,0,0,0,0,0
36965,0,0,0,0,0
120444,0,0,0,0,0
21445,0,0,0,0,0
22477,0,0,0,0,0
67662,0,0,0,0,0
48595,0,0,0,0,0
70378,0,0,0,0,0
36186,0,0,0,0,0
59210,0,0,0,0,0
83483,0,0,0,0,0
63353,0,0,0,0,0
59978,0,0,0,0,0
63932,0,0,0,0,0
23596,0,0,0,0,0
55403,0,0,0,0,0
24978,0,0,0,0,0
85779,0,0,0,0,0
61150,0,0,0,0,0
36459,0,0,0,0,0
82063,0,0,0,0,0
65424,0,0,0,0,0
85961,0,0,0,0,0
29984,0,0,0,0,0
102628,2,2,2,0,0
72663,0,0,0,0,0
102865,0,0,0,0,0
68605,0,0,0,0,0
83587,0,0,0,0,0
80845,0,0,0,0,0
73796,0,0,0,0,0
16219,0,0,0,0,0
77604,0,0,0,0,0
35287,0,0,0,0,0
98166,0,0,0,0,0
57024,0,0,0,0,0
11803,0,0,0,0,0
82345,0,0,0,0,0
112977,0,0,0,0,0
118947,0,0,0,0,0
28738,0,0,0,0,0
34701,0,0,0,0,0
66732,0,0,0,0,0
1882,0,0,0,0,0
7518,0,0,0,0,0
22393,0,0,0,0,0
14437,0,0,0,0,0
5449,0,0,0,0,0
119514,0,0,0,0,0
27553,0,0,0,0,0
87348,0,0,0,0,0
117659,0,0,0,0,0
16213,0,0,0,0,0
76269,0,0,0,0,0
88874,0,0,0,0,0
6150,0,0,0,0,0
30815,0,0,0,0,0
105003,0,0,0,0,0
73712,0,0,0,0,0
56866,0,0,0,0,0
91374,0,0,0,0,0
40460,0,0,0,0,0
80819,0,0,0,0,0
14643,0,0,0,0,0
40792,0,0,0,0,0
29750,0,0,0,0,0
9885,0,0,0,0,0
46215,0,0,0,0,0
4473,0,0,0,0,0
3858,0,0,0,0,0
38712,0,0,0,0,0
53896,0,0,0,0,0
114693,0,0,0,0,0
58206,0,0,0,0,0
5207,0,0,0,0,0
50966,0,0,0,0,0
68758,0,0,0,0,0
8838,0,0,0,0,0
49632,0,0,0,0,0
112856,0,0,0,0,0
75584,0,0,0,0,0
15322,0,0,0,0,0
95993,0,0,0,0,0
3254,0,0,0,0,0
87926,0,0,0,0,0
53371,0,0,0,0,0
28912,0,0,0,0,0
71587,0,0,0,0,0
41248,0,0,0,0,0
59929,0,0,0,0,0
117394,0,0,0,0,0
60771,0,0,0,0,0
57357,0,0,0,0,0
98774,0,0,0,0,0
69260,0,0,0,0,0
6062,0,0,0,0,0
51073,0,0,0,0,0
19870,0,0,0,0,0
62973,0,0,0,0,0
13529,0,0,0,0,0
76743,0,0,0,0,0
37164,0,0,0,0,0
26853,0,0,0,0,0
24711,0,0,0,0,0
39561,0,0,0,0,0
54229,0,0,0,0,0
107161,0,0,0,0,0
96642,0,0,0,0,0
118305,0,0,0,0,0
72585,0,0,0,0,0
47910,0,0,0,0,0
120274,0,0,0,0,0
16764,0,0,0,0,0
113713,0,0,0,0,0
21136,0,0,0,0,0
57844,0,0,0,0,0
118027,0,0,0,0,0
116039,0,0,0,0,0
85407,0,0,0,0,0
15005,0,0,0,0,0
41661,0,0,0,0,0
89809,0,0,0,0,0
27560,0,0,0,0,0
75052,0,0,0,0,0
19747,0,0,0,0,0
92905,0,0,0,0,0
84457,0,0,0,0,0
32932,0,0,0,0,0
107909,0,0,0,0,0
33337,0,0,0,0,0
48593,0,0,0,0,0
59595,0,0,0,0,0
16324,0,0,0,0,0
103117,0,0,0,0,0
56687,0,0,0,0,0
68629,0,0,0,0,0
99067,0,0,0,0,0
66649,0,0,0,0,0
4100,0,0,0,0,0
53325,0,0,0,0,0
108321,0,0,0,0,0
27195,0,0,0,0,0
53305,0,0,0,0,0
114883,0,0,0,0,0
46898,0,0,0,0,0
86741,0,0,0,0,0
23949,0,0,0,0,0
57637,0,0,0,0,0
114594,0,0,0,0,0
22431,0,0,0,0,0
115804,0,0,0,0,0
64912,0,0,0,0,0
58951,0,0,0,0,0
57915,0,0,0,0,0
24872,0,0,0,0,0
40993,0,0,0,0,0
42561,0,0,0,0,0
11539,0,0,0,0,0
39229,0,0,0,0,0
116847,0,0,0,0,0
11457,0,0,0,0,0
28317,0,0,0,0,0
30364,0,0,0,0,0
35197,0,0,0,0,0
75835,0,0,0,0,0
44147,0,0,0,0,0
110040,0,0,0,0,0
7210,0,0,0,0,0
7618,0,0,0,0,0
52129,0,0,0,0,0
46405,0,0,0,0,0
69480,0,0,0,0,0
40351,0,0,0,0,0
116345,0,0,0,0,0
17986,0,0,0,0,0
36402,0,0,0,0,0
92336,0,0,0,0,0
21766,0,0,0,0,0
27468,0,0,0,0,0
15548,0,0,0,0,0
1066,0,0,0,0,0
74959,0,0,0,0,0
46412,0,0,0,0,0
87705,0,0,0,0,0
62322,0,0,0,0,0
72298,0,0,0,0,0
10406,0,0,0,0,0
100937,0,0,0,0,0
2344,0,0,0,0,0
88450,0,0,0,0,0
117480,0,0,0,0,0
61743,0,0,0,0,0
55951,0,0,0,0,0
1902,0,0,0,0,0
20533,0,0,0,0,0
106941,0,0,0,0,0
108407,0,0,0,0,0
80905,0,0,0,0,0
19727,0,0,0,0,0
119797,0,0,0,0,0
24251,0,0,0,0,0
26391,0,0,0,0,0
6719,0,0,0,0,0
65383,0,0,0,0,0
73871,0,0,0,0,0
95063,0,0,0,0,0
96346,0,0,0,0,0
38939,0,0,0,0,0
96680,0,0,0,0,0
13338,0,0,0,0,0
57314,0,0,0,0,0
12276,5,5,5,0,0
24058,0,0,0,0,0
93793,0,0,0,0,0
69323,0,0,0,0,0
2887,0,0,0,0,0
84357,0,0,0,0,0
49262,4,4,4,0,0
39271,0,0,0,0,0
2486,0,0,0,0,0
57905,0,0,0,0,0
35257,0,0,0,0,0
107649,0,0,0,0,0
51127,0,0,0,0,0
116929,0,0,0,0,0
119091,0,0,0,0,0
103213,0,0,0,0,0
50107,0,0,0,0,0
6861,12,12,12,0,0
18622,0,0,0,0,0
28130,0,0,0,0,0
21565,0,0,0,0,0
56782,0,0,0,0,0
91563,0,0,0,0,0
47378,0,0,0,0,0
110576,0,0,0,0,0
97646,0,0,0,0,0
98493,0,0,0,0,0
93476,0,0,0,0,0
6810,0,0,0,0,0
37134,0,0,0,0,0
45384,0,0,0,0,0
2640,0,0,0,0,0
10632,0,0,0,0,0
60093,0,0,0,0,0
12654,0,0,0,0,0
5106,0,0,0,0,0
1049,0,0,0,0,0
89064,0,0,0,0,0
74413,0,0,0,0,0
100505,0,0,0,0,0
45191,0,0,0,0,0
11900,0,0,0,0,0
14313,0,0,0,0,0
4857,0,0,0,0,0
68852,0,0,0,0,0
51124,3,3,3,0,0
64080,0,0,0,0,0
54575,0,0,0,0,0
97037,0,0,0,0,0
85465,0,0,0,0,0
22884,0,0,0,0,0
64937,0,0,0,0,0
114288,0,0,0,0,0
35940,0,0,0,0,0
70825,0,0,0,0,0
15980,0,0,0,0,0
53767,1,1,1,0,0
9866,0,0,0,0,0
105107,0,0,0,0,0
9046,0,0,0,0,0
6613,0,0,0,0,0
68088,0,0,0,0,0
40238,0,0,0,0,0
112497,0,0,0,0,0
79559,0,0,0,0,0
86349,0,0,0,0,0
90567,0,0,0,0,0
9105,0,0,0,0,0
79186,0,0,0,0,0
21482,0,0,0,0,0
65772,0,0,0,0,0
61371,0,0,0,0,0
57069,0,0,0,0,0
54280,0,0,0,0,0
339,0,0,0,0,0
32976,0,0,0,0,0
49116,0,0,0,0,0
91202,0,0,0,0,0
115292,0,0,0,0,0
12658,0,0,0,0,0
98891,0,0,0,0,0
37659,0,0,0,0,0
18677,0,0,0,0,0
35228,0,0,0,0,0
19805,0,0,0,0,0
9608,0,0,0,0,0
67644,0,0,0,0,0
76807,0,0,0,0,0
58719,0,0,0,0,0
79583,0,0,0,0,0
95632,0,0,0,0,0
111199,0,0,0,0,0
21193,0,0,0,0,0
90614,0,0,0,0,0
57434,0,0,0,0,0
119747,0,0,0,0,0
39251,0,0,0,0,0
28472,1,1,1,0,0
1025,0,0,0,0,0
89597,0,0,0,0,0
119576,0,0,0,0,0
46853,0,0,0,0,0
42199,0,0,0,0,0
64363,0,0,0,0,0
70505,0,0,0,0,0
53724,0,0,0,0,0
24218,0,0,0,0,0
87068,0,0,0,0,0
101914,0,0,0,0,0
42374,0,0,0,0,0
102671,5,5,5,0,0
76000,0,0,0,0,0
85207,0,0,0,0,0
104728,0,0,0,0,0
26915,0,0,0,0,0
6447,0,0,0,0,0
39434,0,0,0,0,0
9599,0,0,0,0,0
87735,0,0,0,0,0
13643,0,0,0,0,0
119024,0,0,0,0,0
63899,0,0,0,0,0
98958,0,0,0,0,0
82275,0,0,0,0,0
27564,0,0,0,0,0
47431,0,0,0,0,0
32757,0,0,0,0,0
120012,0,0,0,0,0
38039,0,0,0,0,0
97949,0,0,0,0,0
38980,0,0,0,0,0
80152,0,0,0,0,0
94551,0,0,0,0,0
62831,0,0,0,0,0
36309,0,0,0,0,0
81045,0,0,0,0,0
39026,0,0,0,0,0
8355,0,0,0,0,0
91610,0,0,0,0,0
112104,0,0,0,0,0
108033,0,0,0,0,0
67306,0,0,0,0,0
64741,0,0,0,0,0
53629,0,0,0,0,0
22576,0,0,0,0,0
59172,0,0,0,0,0
106525,0,0,0,0,0
4525,0,0,0,0,0
114142,0,0,0,0,0
65131,0,0,0,0,0
117518,0,0,0,0,0
84110,0,0,0,0,0
59289,0,0,0,0,0
79768,0,0,0,0,0
17028,0,0,0,0,0
115975,0,0,0,0,0
71878,0,0,0,0,0
55027,0,0,0,0,0
109286,0,0,0,0,0
78916,0,0,0,0,0
28500,0,0,0,0,0
45601,0,0,0,0,0
78522,0,0,0,0,0
64002,0,0,0,0,0
68600,0,0,0,0,0
114675,0,0,0,0,0
18444,0,0,0,0,0
82066,0,0,0,0,0
23567,0,0,0,0,0
85918,0,0,0,0,0
118852,0,0,0,0,0
18338,0,0,0,0,0
102269,0,0,0,0,0
10653,0,0,0,0,0
71422,1,1,1,0,0
22223,0,0,0,0,0
80906,0,0,0,0,0
32834,0,0,0,0,0
85537,0,0,0,0,0
121,0,0,0,0,0
31969,0,0,0,0,0
26343,0,0,0,0,0
45823,1,1,1,0,0
4285,0,0,0,0,0
2589,0,0,0,0,0
99465,0,0,0,0,0
41668,0,0,0,0,0
76818,0,0,0,0,0
48877,0,0,0,0,0
68653,0,0,0,0,0
11088,0,0,0,0,0
85266,0,0,0,0,0
8785,0,0,0,0,0
66203,0,0,0,0,0
97782,0,0,0,0,0
105629,0,0,0,0,0
4907,0,0,0,0,0
45240,0,0,0,0,0
82600,0,0,0,0,0
20842,0,0,0,0,0
113561,0,0,0,0,0
83796,0,0,0,0,0
21328,0,0,0,0,0
55595,0,0,0,0,0
85107,0,0,0,0,0
114429,1,1,1,0,0
107069,0,0,0,0,0
41459,0,0,0,0,0
88688,0,0,0,0,0
91747,0,0,0,0,0
22736,0,0,0,0,0
75132,0,0,0,0,0
45960,0,0,0,0,0
90623,0,0,0,0,0
52932,0,0,0,0,0
72955,0,0,0,0,0
85338,0,0,0,0,0
108908,0,0,0,0,0
72114,0,0,0,0,0
37205,0,0,0,0,0
45482,0,0,0,0,0
67038,0,0,0,0,0
59399,0,0,0,0,0
11864,0,0,0,0,0
117606,0,0,0,0,0
92757,0,0,0,0,0
43086,0,0,0,0,0
104048,0,0,0,0,0
108806,0,0,0,0,0
80001,0,0,0,0,0
11127,0,0,0,0,0
41849,0,0,0,0,0
105358,0,0,0,0,0
55172,0,0,0,0,0
116187,0,0,0,0,0
90035,0,0,0,0,0
59022,0,0,0,0,0
46463,0,0,0,0,0
69152,0,0,0,0,0
27603,0,0,0,0,0
3832,0,0,0,0,0
7892,0,0,0,0,0
78728,0,0,0,0,0
20556,0,0,0,0,0
58009,0,0,0,0,0
43160,0,0,0,0,0
114949,0,0,0,0,0
91440,0,0,0,0,0
53927,0,0,0,0,0
6863,0,0,0,0,0
95062,0,0,0,0,0
38932,0,0,0,0,0
63633,0,0,0,0,0
102663,0,0,0,0,0
26147,0,0,0,0,0
16120,0,0,0,0,0
86196,0,0,0,0,0
60362,0,0,0,0,0
66915,0,0,0,0,0
23291,0,0,0,0,0
119584,0,0,0,0,0
115971,0,0,0,0,0
34042,0,0,0,0,0
58557,0,0,0,0,0
85496,0,0,0,0,0
60227,0,0,0,0,0
47067,0,0,0,0,0
81285,0,0,0,0,0
98215,0,0,0,0,0
2955,0,0,0,0,0
114208,0,0,0,0,0
62140,0,0,0,0,0
15623,0,0,0,0,0
103511,0,0,0,0,0
107545,0,0,0,0,0
93766,0,0,0,0,0
100327,0,0,0,0,0
67282,0,0,0,0,0
70131,0,0,0,0,0
89491,0,0,0,0,0
77637,0,0,0,0,0
103972,0,0,0,0,0
117911,0,0,0,0,0
66986,0,0,0,0,0
57949,0,0,0,0,0
58137,0,0,0,0,0
112982,0,0,0,0,0
17491,0,0,0,0,0
45127,0,0,0,0,0
101450,0,0,0,0,0
54412,0,0,0,0,0
35923,0,0,0,0,0
18138,0,0,0,0,0
102266,0,0,0,0,0
111188,0,0,0,0,0
51772,0,0,0,0,0
20686,0,0,0,0,0
105494,0,0,0,0,0
58196,0,0,0,0,0
61369,0,0,0,0,0
8554,0,0,0,0,0
82608,0,0,0,0,0
51949,0,0,0,0,0
11516,0,0,0,0,0
82372,0,0,0,0,0
83308,0,0,0,0,0
9255,0,0,0,0,0
20768,0,0,0,0,0
36638,0,0,0,0,0
93076,0,0,0,0,0
27048,0,0,0,0,0
56165,0,0,0,0,0
33800,0,0,0,0,0
50688,0,0,0,0,0
88932,0,0,0,0,0
80576,0,0,0,0,0
79510,0,0,0,0,0
38900,0,0,0,0,0
8854,0,0,0,0,0
17892,0,0,0,0,0
106865,0,0,0,0,0
92909,0,0,0,0,0
22910,0,0,0,0,0
100404,0,0,0,0,0
109212,0,0,0,0,0
6016,0,0,0,0,0
64915,0,0,0,0,0
79359,0,0,0,0,0
111302,0,0,0,0,0
17439,0,0,0,0,0
78004,0,0,0,0,0
5975,0,0,0,0,0
25929,0,0,0,0,0
114524,0,0,0,0,0
82107,0,0,0,0,0
76514,0,0,0,0,0
53270,0,0,0,0,0
94711,0,0,0,0,0
27039,0,0,0,0,0
95929,0,0,0,0,0
81052,0,0,0,0,0
107668,0,0,0,0,0
107152,0,0,0,0,0
28971,0,0,0,0,0
9429,0,0,0,0,0
64413,0,0,0,0,0
45778,0,0,0,0,0
37683,0,0,0,0,0
99656,0,0,0,0,0
102273,0,0,0,0,0
10272,0,0,0,0,0
92657,0,0,0,0,0
26724,0,0,0,0,0
68013,0,0,0,0,0
16006,0,0,0,0,0
57259,0,0,0,0,0
53090,0,0,0,0,0
79097,0,0,0,0,0
10072,0,0,0,0,0
28984,0,0,0,0,0
14451,0,0,0,0,0
109356,0,0,0,0,0
50186,0,0,0,0,0
52250,0,0,0,0,0
15504,0,0,0,0,0
63905,0,0,0,0,0
70309,0,0,0,0,0
63583,0,0,0,0,0
29455,0,0,0,0,0
101659,0,0,0,0,0
40526,0,0,0,0,0
1087,0,0,0,0,0
64669,0,0,0,0,0
26248,0,0,0,0,0
108612,0,0,0,0,0
60889,0,0,0,0,0
11578,0,0,0,0,0
10725,0,0,0,0,0
74011,0,0,0,0,0
108097,0,0,0,0,0
117863,0,0,0,0,0
116806,0,0,0,0,0
116856,0,0,0,0,0
80609,0,0,0,0,0
19579,0,0,0,0,0
30678,0,0,0,0,0
38765,0,0,0,0,0
14888,0,0,0,0,0
82442,0,0,0,0,0
61747,0,0,0,0,0
47827,0,0,0,0,0
79456,0,0,0,0,0
10075,0,0,0,0,0
85291,0,0,0,0,0
38149,0,0,0,0,0
63619,0,0,0,0,0
32338,0,0,0,0,0
117633,0,0,0,0,0
40220,0,0,0,0,0
119098,0,0,0,0,0
34157,0,0,0,0,0
114107,0,0,0,0,0
113092,0,0,0,0,0
116558,0,0,0,0,0
9171,0,0,0,0,0
61029,0,0,0,0,0
21799,0,0,0,0,0
54007,0,0,0,0,0
52605,0,0,0,0,0
118901,0,0,0,0,0
70245,0,0,0,0,0
114206,0,0,0,0,0
35694,0,0,0,0,0
22115,0,0,0,0,0
33505,0,0,0,0,0
56779,0,0,0,0,0
27874,0,0,0,0,0
28710,0,0,0,0,0
86622,0,0,0,0,0
17670,0,0,0,0,0
6889,0,0,0,0,0
70031,0,0,0,0,0
9839,0,0,0,0,0
89429,1,1,1,0,0
77128,0,0,0,0,0
113334,0,0,0,0,0
39601,0,0,0,0,0
1372,0,0,0,0,0
12549,0,0,0,0,0
50668,0,0,0,0,0
60558,0,0,0,0,0
47994,0,0,0,0,0
113464,0,0,0,0,0
14148,0,0,0,0,0
119163,0,0,0,0,0
31301,0,0,0,0,0
30937,0,0,0,0,0
110431,2,2,2,0,0
8022,0,0,0,0,0
16741,0,0,0,0,0
43619,0,0,0,0,0
80851,0,0,0,0,0
47625,0,0,0,0,0
90739,0,0,0,0,0
90692,0,0,0,0,0
77150,0,0,0,0,0
90693,0,0,0,0,0
26540,0,0,0,0,0
61239,0,0,0,0,0
109455,0,0,0,0,0
25215,0,0,0,0,0
87050,0,0,0,0,0
8091,0,0,0,0,0
28190,0,0,0,0,0
26829,0,0,0,0,0
10538,0,0,0,0,0
73673,0,0,0,0,0
56478,0,0,0,0,0
4530,0,0,0,0,0
77792,0,0,0,0,0
88314,0,0,0,0,0
82934,0,0,0,0,0
79217,0,0,0,0,0
73701,0,0,0,0,0
80087,0,0,0,0,0
62463,0,0,0,0,0
98236,0,0,0,0,0
103844,0,0,0,0,0
29917,0,0,0,0,0
10358,0,0,0,0,0
65633,0,0,0,0,0
75015,0,0,0,0,0
72380,0,0,0,0,0
21550,0,0,0,0,0
33500,0,0,0,0,0
119337,0,0,0,0,0
80053,0,0,0,0,0
65807,0,0,0,0,0
30606,0,0,0,0,0
32955,0,0,0,0,0
77309,0,0,0,0,0
91192,0,0,0,0,0
26194,0,0,0,0,0
79313,0,0,0,0,0
57670,0,0,0,0,0
14584,0,0,0,0,0
79433,0,0,0,0,0
67744,0,0,0,0,0
98175,0,0,0,0,0
33217,0,0,0,0,0
80856,0,0,0,0,0
13965,0,0,0,0,0
41700,0,0,0,0,0
33136,0,0,0,0,0
109680,0,0,0,0,0
64833,0,0,0,0,0
73131,0,0,0,0,0
118469,0,0,0,0,0
18682,0,0,0,0,0
97310,0,0,0,0,0
34696,0,0,0,0,0
682,0,0,0,0,0
102320,0,0,0,0,0
94076,0,0,0,0,0
56075,0,0,0,0,0
72463,0,0,0,0,0
102890,0,0,0,0,0
107646,0,0,0,0,0
80167,0,0,0,0,0
104949,0,0,0,0,0
51978,0,0,0,0,0
69230,0,0,0,0,0
104098,0,0,0,0,0
111067,0,0,0,0,0
102296,0,0,0,0,0
41193,0,0,0,0,0
27771,0,0,0,0,0
60928,0,0,0,0,0
58267,0,0,0,0,0
88567,0,0,0,0,0
72852,0,0,0,0,0
64779,0,0,0,0,0
53690,0,0,0,0,0
7322,0,0,0,0,0
85774,0,0,0,0,0
63569,0,0,0,0,0
106153,0,0,0,0,0
23,0,0,0,0,0
16047,0,0,0,0,0
68103,0,0,0,0,0
100974,0,0,0,0,0
52062,0,0,0,0,0
30626,0,0,0,0,0
42073,0,0,0,0,0
105263,0,0,0,0,0
77606,0,0,0,0,0
102613,0,0,0,0,0
52885,0,0,0,0,0
78271,0,0,0,0,0
70311,0,0,0,0,0
69388,0,0,0,0,0
115326,0,0,0,0,0
89939,0,0,0,0,0
17490,0,0,0,0,0
95424,0,0,0,0,0
84342,0,0,0,0,0
105831,0,0,0,0,0
102349,0,0,0,0,0
100454,0,0,0,0,0
14794,0,0,0,0,0
16781,0,0,0,0,0
102080,0,0,0,0,0
14360,0,0,0,0,0
67418,0,0,0,0,0
103863,0,0,0,0,0
15456,0,0,0,0,0
22555,2,2,2,0,0
17287,0,0,0,0,0
75674,0,0,0,0,0
76751,0,0,0,0,0
3664,0,0,0,0,0
114809,0,0,0,0,0
72242,0,0,0,0,0
56884,0,0,0,0,0
90638,0,0,0,0,0
114147,0,0,0,0,0
5350,0,0,0,0,0
41212,0,0,0,0,0
29733,0,0,0,0,0
73626,0,0,0,0,0
38735,0,0,0,0,0
61014,0,0,0,0,0
15377,0,0,0,0,0
17972,0,0,0,0,0
97106,0,0,0,0,0
8074,0,0,0,0,0
28226,0,0,0,0,0
68392,0,0,0,0,0
37545,0,0,0,0,0
115176,0,0,0,0,0
56288,0,0,0,0,0
36635,0,0,0,0,0
103250,0,0,0,0,0
35519,0,0,0,0,0
3631,0,0,0,0,0
90643,1,1,1,0,0
66935,0,0,0,0,0
97386,0,0,0,0,0
21781,0,0,0,0,0
78205,0,0,0,0,0
9582,0,0,0,0,0
17651,0,0,0,0,0
39752,0,0,0,0,0
108359,0,0,0,0,0
76526,0,0,0,0,0
84765,0,0,0,0,0
44108,0,0,0,0,0
83255,0,0,0,0,0
3729,0,0,0,0,0
108507,0,0,0,0,0
100659,0,0,0,0,0
87978,0,0,0,0,0
119776,0,0,0,0,0
48685,0,0,0,0,0
100317,0,0,0,0,0
108624,0,0,0,0,0
22109,0,0,0,0,0
102335,0,0,0,0,0
92829,0,0,0,0,0
111205,0,0,0,0,0
21159,0,0,0,0,0
92085,0,0,0,0,0
29258,0,0,0,0,0
83381,0,0,0,0,0
104646,0,0,0,0,0
8326,0,0,0,0,0
26616,0,0,0,0,0
44902,0,0,0,0,0
54074,0,0,0,0,0
22941,0,0,0,0,0
48658,0,0,0,0,0
27433,0,0,0,0,0
116215,0,0,0,0,0
119664,0,0,0,0,0
38207,0,0,0,0,0
23900,0,0,0,0,0
13161,0,0,0,0,0
55114,0,0,0,0,0
38191,0,0,0,0,0
54125,0,0,0,0,0
23449,0,0,0,0,0
113930,0,0,0,0,0
32984,0,0,0,0,0
25027,0,0,0,0,0
119910,0,0,0,0,0
35531,0,0,0,0,0
52837,0,0,0,0,0
118930,0,0,0,0,0
70852,0,0,0,0,0
27763,0,0,0,0,0
82615,0,0,0,0,0
72488,0,0,0,0,0
86744,0,0,0,0,0
92942,0,0,0,0,0
70998,0,0,0,0,0
39385,0,0,0,0,0
9070,0,0,0,0,0
21919,0,0,0,0,0
67868,0,0,0,0,0
25539,0,0,0,0,0
28386,0,0,0,0,0
2103,0,0,0,0,0
119324,0,0,0,0,0
107519,0,0,0,0,0
71155,0,0,0,0,0
68665,0,0,0,0,0
105096,0,0,0,0,0
12812,0,0,0,0,0
63632,1,1,1,0,0
68065,0,0,0,0,0
88549,0,0,0,0,0
108064,0,0,0,0,0
53839,0,0,0,0,0
41660,0,0,0,0,0
117714,0,0,0,0,0
26818,0,0,0,0,0
88058,0,0,0,0,0
94477,0,0,0,0,0
82433,0,0,0,0,0
44020,0,0,0,0,0
47261,2,2,2,0,0
84574,0,0,0,0,0
4339,0,0,0,0,0
68506,0,0,0,0,0
84572,0,0,0,0,0
33568,0,0,0,0,0
89280,0,0,0,0,0
45659,0,0,0,0,0
84711,0,0,0,0,0
17516,0,0,0,0,0
75413,0,0,0,0,0
32648,0,0,0,0,0
82908,0,0,0,0,0
96,0,0,0,0,0
15018,0,0,0,0,0
25275,0,0,0,0,0
64625,0,0,0,0,0
35420,0,0,0,0,0
81248,0,0,0,0,0
82215,0,0,0,0,0
12356,0,0,0,0,0
12428,0,0,0,0,0
5937,0,0,0,0,0
79710,0,0,0,0,0
112734,0,0,0,0,0
43683,0,0,0,0,0
33343,0,0,0,0,0
44352,0,0,0,0,0
82688,0,0,0,0,0
100672,0,0,0,0,0
118293,1,1,1,0,0
72521,0,0,0,0,0
102010,0,0,0,0,0
55267,0,0,0,0,0
54560,0,0,0,0,0
79762,0,0,0,0,0
77338,0,0,0,0,0
76436,0,0,0,0,0
35533,0,0,0,0,0
84291,0,0,0,0,0
119048,0,0,0,0,0
63839,0,0,0,0,0
51599,0,0,0,0,0
13551,0,0,0,0,0
94668,0,0,0,0,0
96771,0,0,0,0,0
78647,0,0,0,0,0
109528,0,0,0,0,0
35612,0,0,0,0,0
85066,0,0,0,0,0
22387,0,0,0,0,0
8656,0,0,0,0,0
19846,0,0,0,0,0
100859,0,0,0,0,0
59153,0,0,0,0,0
61310,0,0,0,0,0
76489,0,0,0,0,0
29840,0,0,0,0,0
113120,0,0,0,0,0
58647,0,0,0,0,0
17958,0,0,0,0,0
50028,0,0,0,0,0
99882,0,0,0,0,0
72500,0,0,0,0,0
44979,0,0,0,0,0
4124,0,0,0,0,0
111502,0,0,0,0,0
61164,0,0,0,0,0
1373,0,0,0,0,0
1767,0,0,0,0,0
109285,0,0,0,0,0
89413,0,0,0,0,0
70324,0,0,0,0,0
82531,0,0,0,0,0
62955,0,0,0,0,0
67625,0,0,0,0,0
79205,0,0,0,0,0
12427,0,0,0,0,0
12161,0,0,0,0,0
73544,0,0,0,0,0
32263,0,0,0,0,0
80702,0,0,0,0,0
12477,2,2,2,0,0
16034,0,0,0,0,0
31778,0,0,0,0,0
115387,0,0,0,0,0
34860,0,0,0,0,0
86466,0,0,0,0,0
1102,0,0,0,0,0
48929,0,0,0,0,0
100268,0,0,0,0,0
54235,0,0,0,0,0
36876,0,0,0,0,0
102170,0,0,0,0,0
56544,0,0,0,0,0
66352,0,0,0,0,0
87592,0,0,0,0,0
17333,0,0,0,0,0
93718,0,0,0,0,0
44641,0,0,0,0,0
90674,0,0,0,0,0
8102,0,0,0,0,0
9798,3,3,3,0,0
42466,0,0,0,0,0
55950,0,0,0,0,0
36869,0,0,0,0,0
2749,0,0,0,0,0
99585,0,0,0,0,0
58716,0,0,0,0,0
61209,0,0,0,0,0
66630,0,0,0,0,0
83524,0,0,0,0,0
55095,0,0,0,0,0
117539,0,0,0,0,0
80173,0,0,0,0,0
22600,0,0,0,0,0
68023,0,0,0,0,0
94398,0,0,0,0,0
16652,0,0,0,0,0
56461,0,0,0,0,0
31133,0,0,0,0,0
91755,0,0,0,0,0
89310,0,0,0,0,0
115802,0,0,0,0,0
115448,0,0,0,0,0
75624,0,0,0,0,0
58117,0,0,0,0,0
88408,0,0,0,0,0
66228,0,0,0,0,0
44769,0,0,0,0,0
96888,0,0,0,0,0
66963,0,0,0,0,0
78847,0,0,0,0,0
33771,3,3,3,0,0
113733,0,0,0,0,0
8018,0,0,0,0,0
24310,0,0,0,0,0
15789,0,0,0,0,0
43158,0,0,0,0,0
48805,0,0,0,0,0
70666,0,0,0,0,0
41239,0,0,0,0,0
116064,0,0,0,0,0
37338,0,0,0,0,0
37282,0,0,0,0,0
51212,0,0,0,0,0
7408,0,0,0,0,0
45015,0,0,0,0,0
55261,0,0,0,0,0
39916,0,0,0,0,0
78705,0,0,0,0,0
83451,0,0,0,0,0
76255,0,0,0,0,0
109433,0,0,0,0,0
60896,0,0,0,0,0
113907,0,0,0,0,0
41729,0,0,0,0,0
103087,0,0,0,0,0
42516,0,0,0,0,0
78412,0,0,0,0,0
15077,0,0,0,0,0
12487,0,0,0,0,0
15829,0,0,0,0,0
120353,0,0,0,0,0
104456,0,0,0,0,0
90401,0,0,0,0,0
41967,0,0,0,0,0
76581,0,0,0,0,0
14596,0,0,0,0,0
87325,0,0,0,0,0
14923,0,0,0,0,0
82392,0,0,0,0,0
93111,0,0,0,0,0
82102,0,0,0,0,0
28071,0,0,0,0,0
9208,0,0,0,0,0
49791,0,0,0,0,0
7803,0,0,0,0,0
69832,0,0,0,0,0
18498,0,0,0,0,0
17416,0,0,0,0,0
109675,0,0,0,0,0
72885,3,3,3,0,0
82374,0,0,0,0,0
23148,0,0,0,0,0
75022,0,0,0,0,0
5539,0,0,0,0,0
63262,0,0,0,0,0
88382,0,0,0,0,0
104764,0,0,0,0,0
53207,0,0,0,0,0
35846,0,0,0,0,0
107216,2,2,2,0,0
44031,0,0,0,0,0
67716,1,1,1,0,0
27801,0,0,0,0,0
95794,0,0,0,0,0
27658,0,0,0,0,0
111182,0,0,0,0,0
7957,0,0,0,0,0
107414,0,0,0,0,0
59577,0,0,0,0,0
99547,0,0,0,0,0
13171,0,0,0,0,0
112099,0,0,0,0,0
61082,0,0,0,0,0
17,0,0,0,0,0
64000,0,0,0,0,0
45006,0,0,0,0,0
103716,0,0,0,0,0
79657,0,0,0,0,0
94914,0,0,0,0,0
59729,0,0,0,0,0
120448,0,0,0,0,0
110943,0,0,0,0,0
68063,0,0,0,0,0
34969,0,0,0,0,0
58157,0,0,0,0,0
31673,0,0,0,0,0
107507,0,0,0,0,0
53776,0,0,0,0,0
12806,0,0,0,0,0
61380,0,0,0,0,0
107571,0,0,0,0,0
63818,0,0,0,0,0
51116,0,0,0,0,0
81012,0,0,0,0,0
58193,0,0,0,0,0
91509,0,0,0,0,0
107298,0,0,0,0,0
20652,5,5,5,0,0
112894,0,0,0,0,0
66813,0,0,0,0,0
119116,0,0,0,0,0
29916,0,0,0,0,0
23791,0,0,0,0,0
7112,0,0,0,0,0
89696,0,0,0,0,0
48011,0,0,0,0,0
46590,0,0,0,0,0
41639,0,0,0,0,0
77649,0,0,0,0,0
727,0,0,0,0,0
10387,0,0,0,0,0
88556,0,0,0,0,0
95348,0,0,0,0,0
2485,0,0,0,0,0
116138,0,0,0,0,0
40511,0,0,0,0,0
12057,0,0,0,0,0
32824,0,0,0,0,0
21600,0,0,0,0,0
5048,0,0,0,0,0
42274,0,0,0,0,0
69383,0,0,0,0,0
57863,0,0,0,0,0
52994,0,0,0,0,0
98941,0,0,0,0,0
86777,0,0,0,0,0
105527,0,0,0,0,0
40339,0,0,0,0,0
88179,0,0,0,0,0
57172,0,0,0,0,0
14928,0,0,0,0,0
50211,0,0,0,0,0
75866,0,0,0,0,0
114266,0,0,0,0,0
70265,0,0,0,0,0
58088,0,0,0,0,0
107206,0,0,0,0,0
32676,0,0,0,0,0
354,0,0,0,0,0
34801,0,0,0,0,0
113552,0,0,0,0,0
11290,0,0,0,0,0
83590,0,0,0,0,0
11468,0,0,0,0,0
8968,0,0,0,0,0
103955,0,0,0,0,0
51058,0,0,0,0,0
84016,0,0,0,0,0
33950,0,0,0,0,0
94428,0,0,0,0,0
95017,0,0,0,0,0
115784,0,0,0,0,0
12409,0,0,0,0,0
115146,0,0,0,0,0
62686,0,0,0,0,0
78398,0,0,0,0,0
17819,0,0,0,0,0
58561,0,0,0,0,0
73179,0,0,0,0,0
62003,0,0,0,0,0
11971,0,0,0,0,0
43394,0,0,0,0,0
117525,0,0,0,0,0
115393,0,0,0,0,0
42628,0,0,0,0,0
85263,0,0,0,0,0
24041,0,0,0,0,0
34835,0,0,0,0,0
97648,0,0,0,0,0
41680,0,0,0,0,0
79863,0,0,0,0,0
85951,0,0,0,0,0
106658,0,0,0,0,0
96429,0,0,0,0,0
83230,0,0,0,0,0
65677,0,0,0,0,0
53732,0,0,0,0,0
8080,0,0,0,0,0
6322,0,0,0,0,0
75842,0,0,0,0,0
81695,3,3,3,0,0
80313,0,0,0,0,0
89922,0,0,0,0,0
30625,0,0,0,0,0
37170,0,0,0,0,0
67560,0,0,0,0,0
66361,0,0,0,0,0
68085,0,0,0,0,0
13430,0,0,0,0,0
91441,0,0,0,0,0
78296,0,0,0,0,0
111972,0,0,0,0,0
38245,0,0,0,0,0
49126,0,0,0,0,0
90978,0,0,0,0,0
114156,0,0,0,0,0
64863,0,0,0,0,0
90575,0,0,0,0,0
105973,0,0,0,0,0
107784,0,0,0,0,0
69271,0,0,0,0,0
80277,0,0,0,0,0
48757,0,0,0,0,0
66736,0,0,0,0,0
54009,0,0,0,0,0
2648,0,0,0,0,0
105563,0,0,0,0,0
94880,0,0,0,0,0
7222,0,0,0,0,0
4368,0,0,0,0,0
104162,0,0,0,0,0
74615,0,0,0,0,0
13441,0,0,0,0,0
117612,0,0,0,0,0
23355,0,0,0,0,0
89900,0,0,0,0,0
35318,0,0,0,0,0
117900,0,0,0,0,0
39213,0,0,0,0,0
106191,0,0,0,0,0
66902,0,0,0,0,0
95654,0,0,0,0,0
54318,0,0,0,0,0
63710,0,0,0,0,0
24896,0,0,0,0,0
6456,0,0,0,0,0
108098,0,0,0,0,0
38361,0,0,0,0,0
33232,0,0,0,0,0
68465,0,0,0,0,0
105784,0,0,0,0,0
78248,0,0,0,0,0
50424,0,0,0,0,0
33111,0,0,0,0,0
61701,0,0,0,0,0
57062,0,0,0,0,0
109306,0,0,0,0,0
10557,0,0,0,0,0
98185,0,0,0,0,0
75563,0,0,0,0,0
35383,0,0,0,0,0
62802,0,0,0,0,0
74957,0,0,0,0,0
8009,0,0,0,0,0
24416,0,0,0,0,0
32231,0,0,0,0,0
93603,0,0,0,0,0
16052,0,0,0,0,0
61275,0,0,0,0,0
55453,0,0,0,0,0
95352,0,0,0,0,0
50709,0,0,0,0,0
66488,0,0,0,0,0
91090,0,0,0,0,0
59222,0,0,0,0,0
45339,0,0,0,0,0
16214,0,0,0,0,0
87185,0,0,0,0,0
101871,0,0,0,0,0
17678,0,0,0,0,0
50943,0,0,0,0,0
31378,0,0,0,0,0
35680,0,0,0,0,0
63426,0,0,0,0,0
71332,0,0,0,0,0
80709,0,0,0,0,0
26520,0,0,0,0,0
94836,0,0,0,0,0
114615,0,0,0,0,0
89157,0,0,0,0,0
65971,0,0,0,0,0
31503,0,0,0,0,0
40066,0,0,0,0,0
1752,0,0,0,0,0
68923,0,0,0,0,0
119468,0,0,0,0,0
36870,0,0,0,0,0
120471,0,0,0,0,0
12269,0,0,0,0,0
10062,0,0,0,0,0
41888,0,0,0,0,0
116736,0,0,0,0,0
54741,0,0,0,0,0
26820,0,0,0,0,0
53526,0,0,0,0,0
35998,0,0,0,0,0
101821,0,0,0,0,0
60385,0,0,0,0,0
103547,0,0,0,0,0
15567,0,0,0,0,0
7994,0,0,0,0,0
51563,0,0,0,0,0
41679,0,0,0,0,0
62970,0,0,0,0,0
104915,0,0,0,0,0
49484,0,0,0,0,0
103571,0,0,0,0,0
693,0,0,0,0,0
10309,0,0,0,0,0
3554,0,0,0,0,0
69484,0,0,0,0,0
38684,0,0,0,0,0
34936,0,0,0,0,0
87289,0,0,0,0,0
101140,0,0,0,0,0
36117,0,0,0,0,0
25096,0,0,0,0,0
30285,0,0,0,0,0
69394,0,0,0,0,0
94213,0,0,0,0,0
2060,0,0,0,0,0
26647,0,0,0,0,0
42855,0,0,0,0,0
83568,0,0,0,0,0
118605,0,0,0,0,0
25316,0,0,0,0,0
54662,0,0,0,0,0
108852,0,0,0,0,0
53843,0,0,0,0,0
43926,0,0,0,0,0
107363,0,0,0,0,0
66686,0,0,0,0,0
93296,0,0,0,0,0
57346,0,0,0,0,0
18717,0,0,0,0,0
74280,0,0,0,0,0
45153,0,0,0,0,0
42359,0,0,0,0,0
5422,0,0,0,0,0
92476,0,0,0,0,0
67700,0,0,0,0,0
42597,0,0,0,0,0
19526,0,0,0,0,0
76701,0,0,0,0,0
98298,0,0,0,0,0
100159,0,0,0,0,0
8775,0,0,0,0,0
82149,0,0,0,0,0
25714,0,0,0,0,0
15215,0,0,0,0,0
104143,0,0,0,0,0
110355,0,0,0,0,0
116007,0,0,0,0,0
81370,0,0,0,0,0
38453,0,0,0,0,0
37640,0,0,0,0,0
59612,0,0,0,0,0
104623,0,0,0,0,0
76998,0,0,0,0,0
118872,0,0,0,0,0
7909,0,0,0,0,0
6937,0,0,0,0,0
92669,0,0,0,0,0
47727,0,0,0,0,0
72835,0,0,0,0,0
101762,0,0,0,0,0
114857,0,0,0,0,0
33849,0,0,0,0,0
26352,0,0,0,0,0
17411,2,2,2,0,0
4363,0,0,0,0,0
52602,0,0,0,0,0
22804,0,0,0,0,0
81226,0,0,0,0,0
72509,0,0,0,0,0
112486,0,0,0,0,0
75575,1,1,1,0,0
35957,0,0,0,0,0
6283,0,0,0,0,0
72642,0,0,0,0,0
53760,0,0,0,0,0
90378,0,0,0,0,0
119604,0,0,0,0,0
71403,0,0,0,0,0
82179,0,0,0,0,0
52912,0,0,0,0,0
10647,0,0,0,0,0
30734,1,1,1,0,0
69662,0,0,0,0,0
20566,0,0,0,0,0
98065,0,0,0,0,0
82682,0,0,0,0,0
39064,0,0,0,0,0
3905,0,0,0,0,0
11476,0,0,0,0,0
36019,0,0,0,0,0
80320,0,0,0,0,0
38369,0,0,0,0,0
99496,0,0,0,0,0
13860,0,0,0,0,0
527,0,0,0,0,0
100904,0,0,0,0,0
82310,0,0,0,0,0
6736,0,0,0,0,0
101583,0,0,0,0,0
100274,0,0,0,0,0
89149,0,0,0,0,0
93872,0,0,0,0,0
117966,0,0,0,0,0
76398,0,0,0,0,0
65406,0,0,0,0,0
48325,0,0,0,0,0
14292,0,0,0,0,0
111036,0,0,0,0,0
36219,0,0,0,0,0
32120,0,0,0,0,0
17050,0,0,0,0,0
58233,0,0,0,0,0
33291,0,0,0,0,0
78723,0,0,0,0,0
58038,0,0,0,0,0
77512,0,0,0,0,0
36925,0,0,0,0,0
3649,0,0,0,0,0
32608,0,0,0,0,0
108143,0,0,0,0,0
17235,0,0,0,0,0
64201,0,0,0,0,0
88414,0,0,0,0,0
48501,0,0,0,0,0
9891,0,0,0,0,0
105814,0,0,0,0,0
91778,0,0,0,0,0
57665,0,0,0,0,0
102315,0,0,0,0,0
50706,0,0,0,0,0
107531,0,0,0,0,0
58652,0,0,0,0,0
9064,0,0,0,0,0
118524,0,0,0,0,0
44218,0,0,0,0,0
82947,0,0,0,0,0
42397,0,0,0,0,0
65565,0,0,0,0,0
9333,0,0,0,0,0
50592,0,0,0,0,0
91660,0,0,0,0,0
31807,0,0,0,0,0
40933,0,0,0,0,0
33510,0,0,0,0,0
115502,1,1,1,0,0
23565,0,0,0,0,0
17776,0,0,0,0,0
65258,0,0,0,0,0
50752,0,0,0,0,0
61503,0,0,0,0,0
33788,0,0,0,0,0
33142,0,0,0,0,0
18761,0,0,0,0,0
34306,3,3,3,0,0
26584,0,0,0,0,0
106361,0,0,0,0,0
6795,0,0,0,0,0
65837,0,0,0,0,0
79139,0,0,0,0,0
14400,0,0,0,0,0
13354,0,0,0,0,0
44028,0,0,0,0,0
118386,0,0,0,0,0
88593,2,2,2,0,0
20235,0,0,0,0,0
105408,0,0,0,0,0
6549,0,0,0,0,0
113005,0,0,0,0,0
18229,0,0,0,0,0
24753,0,0,0,0,0
83901,0,0,0,0,0
34300,0,0,0,0,0
89792,0,0,0,0,0
50542,0,0,0,0,0
13833,0,0,0,0,0
42027,0,0,0,0,0
90872,0,0,0,0,0
96982,0,0,0,0,0
118062,0,0,0,0,0
57047,0,0,0,0,0
12666,0,0,0,0,0
30545,0,0,0,0,0
100954,0,0,0,0,0
93170,0,0,0,0,0
47326,0,0,0,0,0
119917,0,0,0,0,0
61412,0,0,0,0,0
10763,0,0,0,0,0
32682,0,0,0,0,0
345,0,0,0,0,0
57674,0,0,0,0,0
11501,0,0,0,0,0
43186,0,0,0,0,0
35691,0,0,0,0,0
47607,0,0,0,0,0
30113,0,0,0,0,0
85948,0,0,0,0,0
77426,0,0,0,0,0
45283,0,0,0,0,0
63722,0,0,0,0,0
25608,0,0,0,0,0
113393,0,0,0,0,0
54251,0,0,0,0,0
31042,0,0,0,0,0
113717,0,0,0,0,0
97306,0,0,0,0,0
1916,0,0,0,0,0
106622,0,0,0,0,0
6679,0,0,0,0,0
13314,0,0,0,0,0
116134,0,0,0,0,0
101325,0,0,0,0,0
104664,0,0,0,0,0
91011,0,0,0,0,0
8996,0,0,0,0,0
43577,0,0,0,0,0
105142,0,0,0,0,0
60402,0,0,0,0,0
32527,0,0,0,0,0
118797,0,0,0,0,0
79240,0,0,0,0,0
111953,0,0,0,0,0
10069,0,0,0,0,0
108315,0,0,0,0,0
116368,0,0,0,0,0
46058,0,0,0,0,0
2369,0,0,0,0,0
61884,0,0,0,0,0
71179,0,0,0,0,0
101218,0,0,0,0,0
76981,0,0,0,0,0
97580,0,0,0,0,0
117,0,0,0,0,0
9364,0,0,0,0,0
98286,0,0,0,0,0
12033,0,0,0,0,0
118159,0,0,0,0,0
94743,1,1,1,0,0
39785,2,2,2,0,0
111436,3,3,3,0,0
28112,0,0,0,0,0
113710,0,0,0,0,0
80826,0,0,0,0,0
100688,0,0,0,0,0
94475,0,0,0,0,0
114769,0,0,0,0,0
112023,0,0,0,0,0
72973,0,0,0,0,0
55059,0,0,0,0,0
4953,0,0,0,0,0
90741,0,0,0,0,0
97314,1,1,1,0,0
114848,0,0,0,0,0
59971,0,0,0,0,0
27071,0,0,0,0,0
37966,0,0,0,0,0
92407,0,0,0,0,0
95458,0,0,0,0,0
82585,0,0,0,0,0
60719,0,0,0,0,0
16988,0,0,0,0,0
111212,0,0,0,0,0
116497,0,0,0,0,0
33988,0,0,0,0,0
99633,0,0,0,0,0
24762,0,0,0,0,0
91707,0,0,0,0,0
61771,0,0,0,0,0
33625,0,0,0,0,0
105181,0,0,0,0,0
79161,0,0,0,0,0
64407,0,0,0,0,0
65232,0,0,0,0,0
76730,0,0,0,0,0
73316,0,0,0,0,0
111963,0,0,0,0,0
47031,0,0,0,0,0
77678,0,0,0,0,0
56206,0,0,0,0,0
119828,0,0,0,0,0
50165,0,0,0,0,0
1002,0,0,0,0,0
27842,0,0,0,0,0
120417,0,0,0,0,0
3582,0,0,0,0,0
65450,0,0,0,0,0
120537,0,0,0,0,0
50346,0,0,0,0,0
20759,0,0,0,0,0
71044,0,0,0,0,0
39833,0,0,0,0,0
94549,0,0,0,0,0
11877,0,0,0,0,0
88860,0,0,0,0,0
3169,0,0,0,0,0
6185,0,0,0,0,0
70851,0,0,0,0,0
27588,0,0,0,0,0
83932,0,0,0,0,0
22062,0,0,0,0,0
19534,0,0,0,0,0
33375,0,0,0,0,0
77965,0,0,0,0,0
59947,0,0,0,0,0
78351,0,0,0,0,0
102338,0,0,0,0,0
107259,0,0,0,0,0
32689,0,0,0,0,0
85587,0,0,0,0,0
71237,0,0,0,0,0
60693,0,0,0,0,0
115765,0,0,0,0,0
3210,0,0,0,0,0
97131,0,0,0,0,0
82929,0,0,0,0,0
106212,0,0,0,0,0
88928,0,0,0,0,0
17085,0,0,0,0,0
67869,0,0,0,0,0
20461,0,0,0,0,0
88799,0,0,0,0,0
119334,0,0,0,0,0
81096,0,0,0,0,0
34016,0,0,0,0,0
51232,0,0,0,0,0
69045,1,1,1,0,0
102001,1,1,1,0,0
36004,0,0,0,0,0
26325,0,0,0,0,0
29485,0,0,0,0,0
28713,0,0,0,0,0
35814,0,0,0,0,0
55791,0,0,0,0,0
109592,0,0,0,0,0
18552,0,0,0,0,0
39928,0,0,0,0,0
21428,0,0,0,0,0
49654,0,0,0,0,0
73887,0,0,0,0,0
7237,0,0,0,0,0
103996,0,0,0,0,0
107722,0,0,0,0,0
114020,0,0,0,0,0
18453,0,0,0,0,0
1572,0,0,0,0,0
62667,0,0,0,0,0
28785,0,0,0,0,0
72748,0,0,0,0,0
54473,0,0,0,0,0
14810,0,0,0,0,0
98476,0,0,0,0,0
90014,0,0,0,0,0
113091,0,0,0,0,0
34823,0,0,0,0,0
77806,0,0,0,0,0
5771,0,0,0,0,0
115433,0,0,0,0,0
6713,0,0,0,0,0
29091,0,0,0,0,0
45999,0,0,0,0,0
560,0,0,0,0,0
78194,0,0,0,0,0
97081,0,0,0,0,0
115881,0,0,0,0,0
112916,3,3,3,0,0
22304,0,0,0,0,0
22391,0,0,0,0,0
114838,0,0,0,0,0
55505,0,0,0,0,0
109942,0,0,0,0,0
29086,0,0,0,0,0
77718,2,2,2,0,0
72632,0,0,0,0,0
71951,0,0,0,0,0
111025,0,0,0,0,0
82533,0,0,0,0,0
13167,1,1,1,0,0
24793,0,0,0,0,0
37766,0,0,0,0,0
74197,0,0,0,0,0
56074,0,0,0,0,0
74852,0,0,0,0,0
106938,0,0,0,0,0
36533,0,0,0,0,0
3614,0,0,0,0,0
106828,0,0,0,0,0
59423,0,0,0,0,0
99826,0,0,0,0,0
30201,0,0,0,0,0
118780,0,0,0,0,0
9296,0,0,0,0,0
40495,0,0,0,0,0
78257,0,0,0,0,0
53316,0,0,0,0,0
111613,0,0,0,0,0
58638,0,0,0,0,0
104780,0,0,0,0,0
120513,0,0,0,0,0
57672,0,0,0,0,0
27245,0,0,0,0,0
101608,0,0,0,0,0
99129,0,0,0,0,0
82619,0,0,0,0,0
81365,0,0,0,0,0
71219,0,0,0,0,0
53332,0,0,0,0,0
97997,0,0,0,0,0
106990,0,0,0,0,0
31724,0,0,0,0,0
8749,0,0,0,0,0
66325,0,0,0,0,0
62822,0,0,0,0,0
83382,0,0,0,0,0
11714,0,0,0,0,0
11927,1,1,1,0,0
46946,0,0,0,0,0
76352,0,0,0,0,0
47683,0,0,0,0,0
106787,0,0,0,0,0
61683,0,0,0,0,0
69368,0,0,0,0,0
87115,0,0,0,0,0
118689,0,0,0,0,0
9028,0,0,0,0,0
17543,1,1,1,0,0
41798,0,0,0,0,0
61844,0,0,0,0,0
71642,0,0,0,0,0
33912,0,0,0,0,0
25026,0,0,0,0,0
51068,0,0,0,0,0
31580,0,0,0,0,0
69681,0,0,0,0,0
93444,0,0,0,0,0
29504,0,0,0,0,0
57343,0,0,0,0,0
114867,0,0,0,0,0
118761,0,0,0,0,0
50886,0,0,0,0,0
15451,0,0,0,0,0
80873,0,0,0,0,0
34159,0,0,0,0,0
98159,0,0,0,0,0
18031,0,0,0,0,0
13130,0,0,0,0,0
28290,0,0,0,0,0
41056,0,0,0,0,0
62328,0,0,0,0,0
99292,0,0,0,0,0
107472,0,0,0,0,0
67420,0,0,0,0,0
19002,0,0,0,0,0
84946,0,0,0,0,0
27717,0,0,0,0,0
55777,0,0,0,0,0
77384,0,0,0,0,0
8167,0,0,0,0,0
57294,0,0,0,0,0
75660,0,0,0,0,0
105953,0,0,0,0,0
73106,0,0,0,0,0
58714,0,0,0,0,0
81309,0,0,0,0,0
51768,0,0,0,0,0
56464,0,0,0,0,0
18353,0,0,0,0,0
76447,0,0,0,0,0
111396,0,0,0,0,0
84966,0,0,0,0,0
90548,0,0,0,0,0
113244,0,0,0,0,0
81969,0,0,0,0,0
110942,0,0,0,0,0
98405,0,0,0,0,0
2519,0,0,0,0,0
82583,0,0,0,0,0
113862,0,0,0,0,0
115444,0,0,0,0,0
34435,0,0,0,0,0
98578,0,0,0,0,0
103600,0,0,0,0,0
108073,0,0,0,0,0
83655,0,0,0,0,0
22285,0,0,0,0,0
95668,0,0,0,0,0
71120,0,0,0,0,0
13004,0,0,0,0,0
55092,0,0,0,0,0
40734,0,0,0,0,0
63214,0,0,0,0,0
57008,0,0,0,0,0
8590,0,0,0,0,0
10134,0,0,0,0,0
93668,0,0,0,0,0
12771,0,0,0,0,0
3884,0,0,0,0,0
23081,0,0,0,0,0
37112,0,0,0,0,0
41952,0,0,0,0,0
114024,0,0,0,0,0
41991,0,0,0,0,0
95542,0,0,0,0,0
51399,0,0,0,0,0
65828,0,0,0,0,0
70207,0,0,0,0,0
54046,0,0,0,0,0
29603,0,0,0,0,0
59842,0,0,0,0,0
84559,0,0,0,0,0
57174,0,0,0,0,0
73010,0,0,0,0,0
33633,0,0,0,0,0
22078,0,0,0,0,0
61062,0,0,0,0,0
107728,0,0,0,0,0
112053,0,0,0,0,0
71625,0,0,0,0,0
117449,0,0,0,0,0
5467,0,0,0,0,0
99192,0,0,0,0,0
109643,0,0,0,0,0
86395,0,0,0,0,0
15595,0,0,0,0,0
16842,0,0,0,0,0
19923,0,0,0,0,0
91023,0,0,0,0,0
109741,0,0,0,0,0
73613,0,0,0,0,0
47463,0,0,0,0,0
25360,0,0,0,0,0
97701,0,0,0,0,0
58322,0,0,0,0,0
22682,0,0,0,0,0
90481,0,0,0,0,0
5318,0,0,0,0,0
87346,0,0,0,0,0
41268,0,0,0,0,0
79681,0,0,0,0,0
55784,0,0,0,0,0
103582,0,0,0,0,0
10032,0,0,0,0,0
84397,0,0,0,0,0
112662,0,0,0,0,0
104749,0,0,0,0,0
9394,0,0,0,0,0
25979,13,13,13,0,0
57417,0,0,0,0,0
49319,0,0,0,0,0
64296,0,0,0,0,0
18309,0,0,0,0,0
109389,0,0,0,0,0
104017,0,0,0,0,0
56874,0,0,0,0,0
14136,0,0,0,0,0
5730,0,0,0,0,0
69215,0,0,0,0,0
918,1,1,1,0,0
22145,0,0,0,0,0
112545,0,0,0,0,0
77764,0,0,0,0,0
78246,0,0,0,0,0
101106,0,0,0,0,0
19112,0,0,0,0,0
76258,0,0,0,0,0
43537,0,0,0,0,0
107864,0,0,0,0,0
42677,0,0,0,0,0
12661,0,0,0,0,0
27311,0,0,0,0,0
45853,0,0,0,0,0
34491,0,0,0,0,0
11783,0,0,0,0,0
80924,0,0,0,0,0
42927,0,0,0,0,0
88257,0,0,0,0,0
78043,0,0,0,0,0
25973,0,0,0,0,0
51810,0,0,0,0,0
48667,0,0,0,0,0
18010,0,0,0,0,0
42580,0,0,0,0,0
112567,0,0,0,0,0
16494,2,2,2,0,0
41044,0,0,0,0,0
63985,0,0,0,0,0
63046,0,0,0,0,0
1012,0,0,0,0,0
96938,0,0,0,0,0
47349,0,0,0,0,0
82540,0,0,0,0,0
54316,0,0,0,0,0
38100,0,0,0,0,0
119306,0,0,0,0,0
105759,0,0,0,0,0
85591,0,0,0,0,0
33181,0,0,0,0,0
9409,0,0,0,0,0
42331,0,0,0,0,0
81294,0,0,0,0,0
118409,0,0,0,0,0
79253,0,0,0,0,0
12052,0,0,0,0,0
113272,0,0,0,0,0
96598,0,0,0,0,0
33454,0,0,0,0,0
48850,0,0,0,0,0
13539,0,0,0,0,0
68712,0,0,0,0,0
114044,0,0,0,0,0
102085,0,0,0,0,0
97747,0,0,0,0,0
38331,0,0,0,0,0
32927,0,0,0,0,0
15009,0,0,0,0,0
101322,0,0,0,0,0
117639,0,0,0,0,0
43484,0,0,0,0,0
32477,0,0,0,0,0
18245,0,0,0,0,0
19880,0,0,0,0,0
91884,0,0,0,0,0
96286,0,0,0,0,0
930,0,0,0,0,0
68617,0,0,0,0,0
98902,0,0,0,0,0
18466,0,0,0,0,0
64520,0,0,0,0,0
45095,0,0,0,0,0
34722,0,0,0,0,0
14491,0,0,0,0,0
94135,0,0,0,0,0
44269,0,0,0,0,0
64471,0,0,0,0,0
28412,0,0,0,0,0
51881,0,0,0,0,0
23676,0,0,0,0,0
35462,0,0,0,0,0
62843,0,0,0,0,0
57878,0,0,0,0,0
89869,0,0,0,0,0
114309,0,0,0,0,0
30178,0,0,0,0,0
9949,0,0,0,0,0
15749,0,0,0,0,0
41954,0,0,0,0,0
5399,0,0,0,0,0
18903,0,0,0,0,0
108381,0,0,0,0,0
82741,0,0,0,0,0
48440,0,0,0,0,0
37744,0,0,0,0,0
88917,0,0,0,0,0
43100,0,0,0,0,0
22928,0,0,0,0,0
15429,0,0,0,0,0
29265,0,0,0,0,0
100395,0,0,0,0,0
117083,0,0,0,0,0
8209,0,0,0,0,0
84919,0,0,0,0,0
71600,0,0,0,0,0
15081,0,0,0,0,0
69686,0,0,0,0,0
104016,0,0,0,0,0
99902,0,0,0,0,0
69944,0,0,0,0,0
40114,0,0,0,0,0
15769,0,0,0,0,0
69075,0,0,0,0,0
49336,0,0,0,0,0
49682,0,0,0,0,0
37779,0,0,0,0,0
114322,0,0,0,0,0
66419,0,0,0,0,0
75747,0,0,0,0,0
43031,0,0,0,0,0
87007,0,0,0,0,0
21979,0,0,0,0,0
53678,0,0,0,0,0
60691,0,0,0,0,0
33548,0,0,0,0,0
33397,0,0,0,0,0
62259,0,0,0,0,0
111546,0,0,0,0,0
97495,0,0,0,0,0
71128,0,0,0,0,0
79984,0,0,0,0,0
13268,0,0,0,0,0
66947,0,0,0,0,0
24594,0,0,0,0,0
116896,0,0,0,0,0
5731,0,0,0,0,0
119221,0,0,0,0,0
18875,0,0,0,0,0
75892,0,0,0,0,0
50636,0,0,0,0,0
106869,0,0,0,0,0
34564,0,0,0,0,0
23915,0,0,0,0,0
80508,0,0,0,0,0
57635,0,0,0,0,0
41669,0,0,0,0,0
27019,0,0,0,0,0
72721,0,0,0,0,0
71522,0,0,0,0,0
60379,0,0,0,0,0
119698,0,0,0,0,0
100239,0,0,0,0,0
53125,0,0,0,0,0
14760,0,0,0,0,0
95271,0,0,0,0,0
118787,0,0,0,0,0
120280,0,0,0,0,0
59314,0,0,0,0,0
26156,0,0,0,0,0
105695,0,0,0,0,0
38061,0,0,0,0,0
73570,0,0,0,0,0
61254,0,0,0,0,0
111936,0,0,0,0,0
75421,0,0,0,0,0
46888,0,0,0,0,0
48149,0,0,0,0,0
109500,0,0,0,0,0
30555,0,0,0,0,0
113008,0,0,0,0,0
117273,0,0,0,0,0
57643,0,0,0,0,0
86617,0,0,0,0,0
89767,0,0,0,0,0
119213,0,0,0,0,0
76382,0,0,0,0,0
302,0,0,0,0,0
35750,0,0,0,0,0
110000,0,0,0,0,0
10925,0,0,0,0,0
19229,0,0,0,0,0
84693,0,0,0,0,0
56528,0,0,0,0,0
27239,0,0,0,0,0
61780,0,0,0,0,0
86954,0,0,0,0,0
114336,0,0,0,0,0
26560,0,0,0,0,0
90466,0,0,0,0,0
17314,0,0,0,0,0
73841,0,0,0,0,0
72857,0,0,0,0,0
5752,0,0,0,0,0
27305,0,0,0,0,0
76249,0,0,0,0,0
84694,0,0,0,0,0
55542,0,0,0,0,0
82972,0,0,0,0,0
40489,0,0,0,0,0
55412,0,0,0,0,0
115665,0,0,0,0,0
9821,0,0,0,0,0
51987,0,0,0,0,0
58698,0,0,0,0,0
30528,0,0,0,0,0
34927,0,0,0,0,0
10535,0,0,0,0,0
22388,0,0,0,0,0
54704,0,0,0,0,0
70572,0,0,0,0,0
46338,0,0,0,0,0
27637,0,0,0,0,0
18330,0,0,0,0,0
58828,0,0,0,0,0
49617,0,0,0,0,0
48140,0,0,0,0,0
18093,0,0,0,0,0
23515,0,0,0,0,0
40577,0,0,0,0,0
69257,0,0,0,0,0
96676,0,0,0,0,0
438,0,0,0,0,0
55409,0,0,0,0,0
66329,0,0,0,0,0
16861,0,0,0,0,0
72477,0,0,0,0,0
12401,0,0,0,0,0
48760,0,0,0,0,0
120571,0,0,0,0,0
14358,0,0,0,0,0
37299,0,0,0,0,0
9221,3,3,3,0,0
72391,0,0,0,0,0
33796,0,0,0,0,0
83952,0,0,0,0,0
13951,0,0,0,0,0
84638,0,0,0,0,0
55456,0,0,0,0,0
8428,0,0,0,0,0
57950,0,0,0,0,0
21047,0,0,0,0,0
91687,0,0,0,0,0
64355,0,0,0,0,0
61362,0,0,0,0,0
284,0,0,0,0,0
56403,0,0,0,0,0
97039,3,3,3,0,0
24182,0,0,0,0,0
66734,0,0,0,0,0
93009,0,0,0,0,0
77728,0,0,0,0,0
51972,0,0,0,0,0
80345,0,0,0,0,0
83069,0,0,0,0,0
32080,0,0,0,0,0
32336,0,0,0,0,0
48870,0,0,0,0,0
88032,0,0,0,0,0
119325,0,0,0,0,0
53789,0,0,0,0,0
6230,0,0,0,0,0
76210,0,0,0,0,0
59938,0,0,0,0,0
9349,0,0,0,0,0
105799,1,1,1,0,0
32669,0,0,0,0,0
10317,0,0,0,0,0
61270,0,0,0,0,0
60788,0,0,0,0,0
58722,0,0,0,0,0
76329,0,0,0,0,0
9549,0,0,0,0,0
98439,0,0,0,0,0
64054,0,0,0,0,0
53762,0,0,0,0,0
94754,0,0,0,0,0
92126,0,0,0,0,0
120300,0,0,0,0,0
3606,0,0,0,0,0
87063,0,0,0,0,0
89823,0,0,0,0,0
50587,0,0,0,0,0
119405,0,0,0,0,0
41084,0,0,0,0,0
35221,0,0,0,0,0
89056,0,0,0,0,0
85905,0,0,0,0,0
41425,0,0,0,0,0
84017,0,0,0,0,0
99222,0,0,0,0,0
5877,0,0,0,0,0
66001,0,0,0,0,0
11274,0,0,0,0,0
2377,0,0,0,0,0
31423,0,0,0,0,0
33984,0,0,0,0,0
62351,0,0,0,0,0
48278,0,0,0,0,0
90946,0,0,0,0,0
29338,0,0,0,0,0
20780,0,0,0,0,0
16775,0,0,0,0,0
111943,0,0,0,0,0
77816,0,0,0,0,0
5150,0,0,0,0,0
11450,0,0,0,0,0
60366,0,0,0,0,0
45889,0,0,0,0,0
115460,0,0,0,0,0
11044,0,0,0,0,0
69051,0,0,0,0,0
54509,0,0,0,0,0
30753,0,0,0,0,0
90823,0,0,0,0,0
119469,0,0,0,0,0
91117,0,0,0,0,0
56261,0,0,0,0,0
46063,0,0,0,0,0
34450,0,0,0,0,0
33041,0,0,0,0,0
105841,0,0,0,0,0
97888,0,0,0,0,0
40916,0,0,0,0,0
103654,0,0,0,0,0
111267,0,0,0,0,0
4534,0,0,0,0,0
60660,0,0,0,0,0
110892,0,0,0,0,0
82722,0,0,0,0,0
90218,0,0,0,0,0
63227,0,0,0,0,0
50268,0,0,0,0,0
73762,0,0,0,0,0
2054,0,0,0,0,0
38665,0,0,0,0,0
13864,0,0,0,0,0
30235,0,0,0,0,0
93412,0,0,0,0,0
87145,0,0,0,0,0
61351,0,0,0,0,0
24214,0,0,0,0,0
95621,0,0,0,0,0
72971,0,0,0,0,0
89995,0,0,0,0,0
86401,0,0,0,0,0
50751,0,0,0,0,0
28901,0,0,0,0,0
92550,0,0,0,0,0
106175,0,0,0,0,0
17677,0,0,0,0,0
106490,0,0,0,0,0
102796,1,1,1,0,0
61870,0,0,0,0,0
81882,0,0,0,0,0
89905,0,0,0,0,0
113737,0,0,0,0,0
104814,0,0,0,0,0
101117,0,0,0,0,0
6045,0,0,0,0,0
114953,0,0,0,0,0
117031,0,0,0,0,0
56282,0,0,0,0,0
108684,0,0,0,0,0
114653,1,1,1,0,0
47385,0,0,0,0,0
35407,0,0,0,0,0
3768,0,0,0,0,0
116711,0,0,0,0,0
95487,0,0,0,0,0
33804,0,0,0,0,0
43304,0,0,0,0,0
6459,2,2,2,0,0
39400,0,0,0,0,0
69330,0,0,0,0,0
102834,0,0,0,0,0
112305,0,0,0,0,0
43462,0,0,0,0,0
19665,0,0,0,0,0
109696,0,0,0,0,0
12704,0,0,0,0,0
60146,0,0,0,0,0
120474,0,0,0,0,0
111520,0,0,0,0,0
62915,0,0,0,0,0
101829,0,0,0,0,0
66502,0,0,0,0,0
110635,0,0,0,0,0
111898,0,0,0,0,0
36708,0,0,0,0,0
81306,0,0,0,0,0
117588,0,0,0,0,0
85753,0,0,0,0,0
83861,0,0,0,0,0
2158,0,0,0,0,0
111043,0,0,0,0,0
93075,0,0,0,0,0
26312,0,0,0,0,0
7076,0,0,0,0,0
92206,0,0,0,0,0
93729,0,0,0,0,0
119119,1,1,1,0,0
22678,0,0,0,0,0
75037,0,0,0,0,0
68844,0,0,0,0,0
12105,0,0,0,0,0
82162,0,0,0,0,0
8701,0,0,0,0,0
24912,0,0,0,0,0
45600,0,0,0,0,0
67861,0,0,0,0,0
58681,0,0,0,0,0
12348,0,0,0,0,0
63341,0,0,0,0,0
64636,0,0,0,0,0
98101,0,0,0,0,0
18714,0,0,0,0,0
112501,0,0,0,0,0
76902,0,0,0,0,0
48139,0,0,0,0,0
2794,0,0,0,0,0
40348,0,0,0,0,0
115077,0,0,0,0,0
111667,0,0,0,0,0
50831,0,0,0,0,0
99490,0,0,0,0,0
61242,0,0,0,0,0
22740,0,0,0,0,0
44991,0,0,0,0,0
49666,0,0,0,0,0
30791,0,0,0,0,0
69238,0,0,0,0,0
99929,0,0,0,0,0
21934,0,0,0,0,0
36406,0,0,0,0,0
33576,0,0,0,0,0
60212,0,0,0,0,0
78443,0,0,0,0,0
66245,0,0,0,0,0
79052,0,0,0,0,0
71107,0,0,0,0,0
9220,0,0,0,0,0
67184,0,0,0,0,0
13946,0,0,0,0,0
1630,0,0,0,0,0
86250,0,0,0,0,0
56765,0,0,0,0,0
99890,0,0,0,0,0
92005,2,2,2,0,0
111359,0,0,0,0,0
54922,0,0,0,0,0
80216,0,0,0,0,0
83775,0,0,0,0,0
60657,0,0,0,0,0
112011,0,0,0,0,0
54279,0,0,0,0,0
62052,0,0,0,0,0
15613,0,0,0,0,0
44329,0,0,0,0,0
96223,5,5,5,0,0
19023,0,0,0,0,0
78473,0,0,0,0,0
63444,0,0,0,0,0
3438,0,0,0,0,0
82055,0,0,0,0,0
61670,0,0,0,0,0
118181,0,0,0,0,0
107208,0,0,0,0,0
13416,0,0,0,0,0
29605,0,0,0,0,0
53680,0,0,0,0,0
18056,0,0,0,0,0
100551,0,0,0,0,0
19271,0,0,0,0,0
8611,0,0,0,0,0
106966,0,0,0,0,0
70350,0,0,0,0,0
24879,0,0,0,0,0
14094,1,1,1,0,0
74334,0,0,0,0,0
114125,0,0,0,0,0
79797,0,0,0,0,0
83309,0,0,0,0,0
39655,0,0,0,0,0
105260,0,0,0,0,0
23575,0,0,0,0,0
98697,0,0,0,0,0
116798,0,0,0,0,0
42574,0,0,0,0,0
79279,0,0,0,0,0
7168,0,0,0,0,0
38897,0,0,0,0,0
62947,0,0,0,0,0
88060,0,0,0,0,0
53527,0,0,0,0,0
36966,0,0,0,0,0
113671,0,0,0,0,0
62868,0,0,0,0,0
28701,0,0,0,0,0
35995,0,0,0,0,0
1519,0,0,0,0,0
1675,0,0,0,0,0
13303,0,0,0,0,0
94107,0,0,0,0,0
57216,0,0,0,0,0
106832,0,0,0,0,0
113697,0,0,0,0,0
31122,0,0,0,0,0
66598,0,0,0,0,0
69734,0,0,0,0,0
51701,0,0,0,0,0
63006,0,0,0,0,0
78968,0,0,0,0,0
118927,0,0,0,0,0
63196,0,0,0,0,0
38663,0,0,0,0,0
3243,0,0,0,0,0
75327,0,0,0,0,0
38463,0,0,0,0,0
21688,0,0,0,0,0
93427,0,0,0,0,0
44858,0,0,0,0,0
56558,2,2,2,0,0
35460,0,0,0,0,0
120303,0,0,0,0,0
116489,0,0,0,0,0
80800,0,0,0,0,0
105664,6,6,6,0,0
50142,0,0,0,0,0
59527,1,1,1,0,0
87997,0,0,0,0,0
92429,0,0,0,0,0
31359,0,0,0,0,0
62736,0,0,0,0,0
93851,0,0,0,0,0
53212,0,0,0,0,0
112864,0,0,0,0,0
15232,0,0,0,0,0
68298,1,1,1,0,0
83621,0,0,0,0,0
115519,0,0,0,0,0
114561,0,0,0,0,0
50084,0,0,0,0,0
60796,0,0,0,0,0
12700,0,0,0,0,0
105934,0,0,0,0,0
46825,0,0,0,0,0
14061,0,0,0,0,0
57129,0,0,0,0,0
3837,0,0,0,0,0
97152,0,0,0,0,0
106324,0,0,0,0,0
64962,0,0,0,0,0
97627,0,0,0,0,0
107144,0,0,0,0,0
91122,0,0,0,0,0
9860,0,0,0,0,0
102555,0,0,0,0,0
96316,0,0,0,0,0
100717,0,0,0,0,0
111964,0,0,0,0,0
47045,0,0,0,0,0
12418,0,0,0,0,0
58515,0,0,0,0,0
106639,0,0,0,0,0
89928,0,0,0,0,0
40984,0,0,0,0,0
61175,0,0,0,0,0
112004,0,0,0,0,0
85482,0,0,0,0,0
66547,0,0,0,0,0
42811,0,0,0,0,0
101590,0,0,0,0,0
26425,1,1,1,0,0
37533,0,0,0,0,0
43790,0,0,0,0,0
375,0,0,0,0,0
94057,0,0,0,0,0
18733,0,0,0,0,0
21210,0,0,0,0,0
52997,0,0,0,0,0
23920,0,0,0,0,0
22706,0,0,0,0,0
9402,0,0,0,0,0
42453,0,0,0,0,0
50137,0,0,0,0,0
3599,0,0,0,0,0
8862,0,0,0,0,0
23928,0,0,0,0,0
78502,0,0,0,0,0
4258,0,0,0,0,0
50108,0,0,0,0,0
96694,0,0,0,0,0
83827,0,0,0,0,0
5693,0,0,0,0,0
61756,0,0,0,0,0
114226,0,0,0,0,0
118304,0,0,0,0,0
51009,0,0,0,0,0
16066,0,0,0,0,0
18023,0,0,0,0,0
90225,0,0,0,0,0
68700,0,0,0,0,0
27295,0,0,0,0,0
116363,3,3,3,0,0
97947,0,0,0,0,0
40483,0,0,0,0,0
45584,0,0,0,0,0
23746,0,0,0,0,0
60325,0,0,0,0,0
79542,0,0,0,0,0
90891,0,0,0,0,0
113832,0,0,0,0,0
10109,0,0,0,0,0
9484,0,0,0,0,0
10087,0,0,0,0,0
73119,0,0,0,0,0
73369,0,0,0,0,0
10173,0,0,0,0,0
70421,0,0,0,0,0
67368,0,0,0,0,0
44472,0,0,0,0,0
70427,0,0,0,0,0
16017,0,0,0,0,0
23618,0,0,0,0,0
69356,0,0,0,0,0
75115,0,0,0,0,0
94204,0,0,0,0,0
55315,0,0,0,0,0
59892,0,0,0,0,0
47191,0,0,0,0,0
97959,0,0,0,0,0
101065,0,0,0,0,0
40966,0,0,0,0,0
88773,0,0,0,0,0
44756,0,0,0,0,0
36674,0,0,0,0,0
115537,0,0,0,0,0
70725,0,0,0,0,0
14726,0,0,0,0,0
27334,0,0,0,0,0
9705,0,0,0,0,0
12152,0,0,0,0,0
69948,0,0,0,0,0
25957,0,0,0,0,0
40942,0,0,0,0,0
112613,0,0,0,0,0
35398,0,0,0,0,0
21431,0,0,0,0,0
27073,0,0,0,0,0
21420,0,0,0,0,0
81751,0,0,0,0,0
74910,0,0,0,0,0
69511,0,0,0,0,0
33889,0,0,0,0,0
2655,0,0,0,0,0
49237,0,0,0,0,0
109852,0,0,0,0,0
106518,0,0,0,0,0
83143,0,0,0,0,0
13039,0,0,0,0,0
79487,0,0,0,0,0
19250,0,0,0,0,0
39515,0,0,0,0,0
1393,0,0,0,0,0
105022,0,0,0,0,0
43914,0,0,0,0,0
69718,0,0,0,0,0
101868,0,0,0,0,0
97023,0,0,0,0,0
72722,0,0,0,0,0
80438,0,0,0,0,0
73223,0,0,0,0,0
86490,0,0,0,0,0
20430,0,0,0,0,0
84171,0,0,0,0,0
85340,2,2,2,0,0
11491,0,0,0,0,0
73885,0,0,0,0,0
49176,0,0,0,0,0
68958,0,0,0,0,0
39531,0,0,0,0,0
11863,0,0,0,0,0
26665,0,0,0,0,0
6055,0,0,0,0,0
67277,0,0,0,0,0
27146,0,0,0,0,0
6838,0,0,0,0,0
42621,0,0,0,0,0
53866,0,0,0,0,0
56103,0,0,0,0,0
34931,0,0,0,0,0
110628,0,0,0,0,0
110388,0,0,0,0,0
111112,0,0,0,0,0
107645,0,0,0,0,0
4497,0,0,0,0,0
10543,0,0,0,0,0
60760,0,0,0,0,0
83396,0,0,0,0,0
116567,0,0,0,0,0
87886,0,0,0,0,0
25715,0,0,0,0,0
84479,0,0,0,0,0
47150,0,0,0,0,0
114559,0,0,0,0,0
35638,0,0,0,0,0
3340,0,0,0,0,0
83611,0,0,0,0,0
47997,0,0,0,0,0
39566,0,0,0,0,0
22202,0,0,0,0,0
6626,0,0,0,0,0
53193,0,0,0,0,0
15163,0,0,0,0,0
778,0,0,0,0,0
71903,0,0,0,0,0
25380,0,0,0,0,0
119412,0,0,0,0,0
81568,0,0,0,0,0
12078,0,0,0,0,0
56686,0,0,0,0,0
112152,0,0,0,0,0
21155,0,0,0,0,0
110213,0,0,0,0,0
61009,0,0,0,0,0
46422,1,1,1,0,0
116117,0,0,0,0,0
50228,0,0,0,0,0
15690,0,0,0,0,0
55472,0,0,0,0,0
94816,0,0,0,0,0
94973,0,0,0,0,0
1531,0,0,0,0,0
54002,0,0,0,0,0
103923,0,0,0,0,0
100526,0,0,0,0,0
67520,0,0,0,0,0
111405,0,0,0,0,0
75330,0,0,0,0,0
39066,0,0,0,0,0
19198,0,0,0,0,0
78864,0,0,0,0,0
96572,0,0,0,0,0
46700,0,0,0,0,0
109077,0,0,0,0,0
75808,0,0,0,0,0
108793,0,0,0,0,0
48644,0,0,0,0,0
88846,0,0,0,0,0
64295,0,0,0,0,0
64060,0,0,0,0,0
13389,0,0,0,0,0
108498,0,0,0,0,0
1724,0,0,0,0,0
102581,0,0,0,0,0
47423,0,0,0,0,0
34152,0,0,0,0,0
96070,0,0,0,0,0
107730,0,0,0,0,0
71286,0,0,0,0,0
28987,1,1,1,0,0
90644,0,0,0,0,0
57441,0,0,0,0,0
40946,0,0,0,0,0
60649,0,0,0,0,0
60769,0,0,0,0,0
63766,0,0,0,0,0
12443,0,0,0,0,0
8182,0,0,0,0,0
25047,0,0,0,0,0
66298,0,0,0,0,0
9244,0,0,0,0,0
40106,0,0,0,0,0
81961,0,0,0,0,0
112981,0,0,0,0,0
23076,0,0,0,0,0
16246,0,0,0,0,0
102535,0,0,0,0,0
22945,0,0,0,0,0
68767,0,0,0,0,0
88390,0,0,0,0,0
83512,0,0,0,0,0
24412,0,0,0,0,0
79125,0,0,0,0,0
16862,0,0,0,0,0
3485,0,0,0,0,0
68766,3,3,3,0,0
42771,0,0,0,0,0
98737,0,0,0,0,0
108005,0,0,0,0,0
80019,0,0,0,0,0
74485,0,0,0,0,0
6671,0,0,0,0,0
57666,0,0,0,0,0
32949,0,0,0,0,0
75417,0,0,0,0,0
119950,0,0,0,0,0
39096,0,0,0,0,0
113815,0,0,0,0,0
55232,0,0,0,0,0
94236,0,0,0,0,0
50253,0,0,0,0,0
80868,0,0,0,0,0
72149,0,0,0,0,0
43070,0,0,0,0,0
117279,0,0,0,0,0
59427,1,1,1,0,0
95537,0,0,0,0,0
49051,0,0,0,0,0
102383,0,0,0,0,0
26631,0,0,0,0,0
40461,0,0,0,0,0
28673,0,0,0,0,0
38854,0,0,0,0,0
74963,0,0,0,0,0
43226,0,0,0,0,0
67297,0,0,0,0,0
74909,0,0,0,0,0
38570,0,0,0,0,0
11234,0,0,0,0,0
28349,0,0,0,0,0
55523,0,0,0,0,0
108061,0,0,0,0,0
6607,1,1,1,0,0
73494,0,0,0,0,0
32422,0,0,0,0,0
25531,0,0,0,0,0
112957,0,0,0,0,0
25911,0,0,0,0,0
66996,0,0,0,0,0
10919,0,0,0,0,0
72410,0,0,0,0,0
77994,0,0,0,0,0
79649,0,0,0,0,0
77311,0,0,0,0,0
82877,0,0,0,0,0
40009,0,0,0,0,0
56858,0,0,0,0,0
10990,0,0,0,0,0
61145,0,0,0,0,0
113565,0,0,0,0,0
17810,0,0,0,0,0
65220,0,0,0,0,0
67266,0,0,0,0,0
23028,0,0,0,0,0
50522,0,0,0,0,0
728,0,0,0,0,0
8979,0,0,0,0,0
78972,0,0,0,0,0
46852,0,0,0,0,0
87053,0,0,0,0,0
37397,0,0,0,0,0
63186,0,0,0,0,0
40520,0,0,0,0,0
8410,0,0,0,0,0
10022,0,0,0,0,0
83456,0,0,0,0,0
4380,0,0,0,0,0
47107,0,0,0,0,0
3258,0,0,0,0,0
19251,0,0,0,0,0
105929,0,0,0,0,0
33360,0,0,0,0,0
56069,0,0,0,0,0
74300,0,0,0,0,0
6155,0,0,0,0,0
14826,0,0,0,0,0
79950,0,0,0,0,0
81635,0,0,0,0,0
14578,0,0,0,0,0
14485,0,0,0,0,0
30212,0,0,0,0,0
84310,0,0,0,0,0
40561,0,0,0,0,0
91169,0,0,0,0,0
92092,0,0,0,0,0
72640,0,0,0,0,0
51774,5,5,5,0,0
29743,0,0,0,0,0
41049,0,0,0,0,0
71108,0,0,0,0,0
102918,0,0,0,0,0
101787,0,0,0,0,0
57834,0,0,0,0,0
16372,0,0,0,0,0
83662,0,0,0,0,0
114650,0,0,0,0,0
82917,0,0,0,0,0
2886,0,0,0,0,0
73935,0,0,0,0,0
17051,0,0,0,0,0
28742,0,0,0,0,0
60162,0,0,0,0,0
58485,0,0,0,0,0
83360,0,0,0,0,0
63329,0,0,0,0,0
75726,0,0,0,0,0
68453,0,0,0,0,0
77424,0,0,0,0,0
116457,0,0,0,0,0
107185,0,0,0,0,0
48109,0,0,0,0,0
9679,0,0,0,0,0
108918,0,0,0,0,0
92072,0,0,0,0,0
28524,0,0,0,0,0
64581,0,0,0,0,0
55758,0,0,0,0,0
7938,0,0,0,0,0
65421,0,0,0,0,0
100427,0,0,0,0,0
53796,0,0,0,0,0
55890,0,0,0,0,0
88872,0,0,0,0,0
74662,0,0,0,0,0
16223,0,0,0,0,0
72586,4,4,4,0,0
91381,0,0,0,0,0
32500,0,0,0,0,0
104536,0,0,0,0,0
83411,0,0,0,0,0
71591,0,0,0,0,0
36758,0,0,0,0,0
106746,0,0,0,0,0
88122,0,0,0,0,0
32893,0,0,0,0,0
21109,0,0,0,0,0
113342,0,0,0,0,0
22071,0,0,0,0,0
89878,0,0,0,0,0
81057,0,0,0,0,0
116026,0,0,0,0,0
14737,0,0,0,0,0
63153,0,0,0,0,0
29269,0,0,0,0,0
8185,0,0,0,0,0
50861,0,0,0,0,0
62041,0,0,0,0,0
35075,0,0,0,0,0
39902,0,0,0,0,0
46123,0,0,0,0,0
58617,0,0,0,0,0
104358,0,0,0,0,0
31093,0,0,0,0,0
54784,0,0,0,0,0
53783,0,0,0,0,0
102154,0,0,0,0,0
28875,0,0,0,0,0
783,0,0,0,0,0
71969,0,0,0,0,0
88505,0,0,0,0,0
80507,0,0,0,0,0
108451,0,0,0,0,0
105488,0,0,0,0,0
107041,0,0,0,0,0
101105,0,0,0,0,0
109832,0,0,0,0,0
29128,0,0,0,0,0
20562,0,0,0,0,0
119640,0,0,0,0,0
21738,0,0,0,0,0
22713,0,0,0,0,0
101420,0,0,0,0,0
30509,0,0,0,0,0
50440,0,0,0,0,0
61104,0,0,0,0,0
51801,0,0,0,0,0
101373,0,0,0,0,0
6561,0,0,0,0,0
12171,0,0,0,0,0
181,0,0,0,0,0
110644,0,0,0,0,0
71154,0,0,0,0,0
111806,0,0,0,0,0
1617,0,0,0,0,0
63732,0,0,0,0,0
77834,0,0,0,0,0
70630,2,2,2,0,0
111821,0,0,0,0,0
114886,0,0,0,0,0
14490,0,0,0,0,0
24095,0,0,0,0,0
10028,0,0,0,0,0
83571,1,1,1,0,0
5803,0,0,0,0,0
92581,0,0,0,0,0
116712,0,0,0,0,0
37704,0,0,0,0,0
6349,0,0,0,0,0
43077,0,0,0,0,0
17621,0,0,0,0,0
11429,0,0,0,0,0
8612,0,0,0,0,0
35190,0,0,0,0,0
102438,0,0,0,0,0
92761,0,0,0,0,0
24534,0,0,0,0,0
102364,0,0,0,0,0
4234,0,0,0,0,0
42867,0,0,0,0,0
21337,0,0,0,0,0
36253,0,0,0,0,0
67568,0,0,0,0,0
88636,0,0,0,0,0
47278,0,0,0,0,0
75573,0,0,0,0,0
109054,0,0,0,0,0
92157,0,0,0,0,0
11816,0,0,0,0,0
13150,0,0,0,0,0
38805,0,0,0,0,0
32460,0,0,0,0,0
62926,0,0,0,0,0
96681,0,0,0,0,0
3644,0,0,0,0,0
28118,0,0,0,0,0
60767,0,0,0,0,0
71885,0,0,0,0,0
93497,0,0,0,0,0
100998,0,0,0,0,0
73897,0,0,0,0,0
108955,0,0,0,0,0
76302,0,0,0,0,0
39745,0,0,0,0,0
105539,2,2,2,0,0
89291,0,0,0,0,0
3747,0,0,0,0,0
61402,0,0,0,0,0
120334,0,0,0,0,0
43803,0,0,0,0,0
57237,0,0,0,0,0
47305,0,0,0,0,0
44812,0,0,0,0,0
60483,0,0,0,0,0
49690,0,0,0,0,0
63644,0,0,0,0,0
33885,5,5,5,0,0
4566,0,0,0,0,0
114338,0,0,0,0,0
8156,0,0,0,0,0
63427,0,0,0,0,0
1594,0,0,0,0,0
31488,0,0,0,0,0
11305,0,0,0,0,0
19640,0,0,0,0,0
36419,0,0,0,0,0
71288,0,0,0,0,0
115725,0,0,0,0,0
29229,0,0,0,0,0
27191,0,0,0,0,0
105677,0,0,0,0,0
13335,0,0,0,0,0
67639,0,0,0,0,0
116702,0,0,0,0,0
88267,0,0,0,0,0
12308,0,0,0,0,0
62,0,0,0,0,0
68636,0,0,0,0,0
76541,0,0,0,0,0
53584,0,0,0,0,0
109793,0,0,0,0,0
78717,0,0,0,0,0
76790,0,0,0,0,0
7420,0,0,0,0,0
28220,0,0,0,0,0
118182,0,0,0,0,0
54569,0,0,0,0,0
1696,0,0,0,0,0
4104,0,0,0,0,0
83149,0,0,0,0,0
57313,0,0,0,0,0
118168,0,0,0,0,0
4782,0,0,0,0,0
107577,0,0,0,0,0
82786,0,0,0,0,0
54276,2,2,2,0,0
49339,0,0,0,0,0
95346,0,0,0,0,0
7863,0,0,0,0,0
62923,0,0,0,0,0
57619,0,0,0,0,0
106273,0,0,0,0,0
71388,0,0,0,0,0
108281,0,0,0,0,0
92584,0,0,0,0,0
33089,0,0,0,0,0
43191,0,0,0,0,0
21543,0,0,0,0,0
36681,0,0,0,0,0
56,0,0,0,0,0
116946,0,0,0,0,0
101588,0,0,0,0,0
37342,0,0,0,0,0
77992,0,0,0,0,0
23137,0,0,0,0,0
35439,0,0,0,0,0
108147,0,0,0,0,0
93106,0,0,0,0,0
88630,0,0,0,0,0
23547,0,0,0,0,0
34156,0,0,0,0,0
61549,0,0,0,0,0
7164,0,0,0,0,0
64039,0,0,0,0,0
94871,0,0,0,0,0
27234,0,0,0,0,0
74012,0,0,0,0,0
61583,0,0,0,0,0
62965,0,0,0,0,0
87356,0,0,0,0,0
87242,0,0,0,0,0
110822,0,0,0,0,0
410,0,0,0,0,0
54443,0,0,0,0,0
40296,0,0,0,0,0
102173,0,0,0,0,0
19944,0,0,0,0,0
6642,0,0,0,0,0
110226,0,0,0,0,0
89967,0,0,0,0,0
8942,1,1,1,0,0
46113,0,0,0,0,0
93717,0,0,0,0,0
117589,0,0,0,0,0
111306,0,0,0,0,0
56553,0,0,0,0,0
41428,0,0,0,0,0
100315,0,0,0,0,0
17460,0,0,0,0,0
38172,0,0,0,0,0
108911,0,0,0,0,0
55075,0,0,0,0,0
20670,0,0,0,0,0
108633,0,0,0,0,0
69707,0,0,0,0,0
36781,0,0,0,0,0
26538,0,0,0,0,0
66391,0,0,0,0,0
104335,0,0,0,0,0
50495,0,0,0,0,0
93697,0,0,0,0,0
111273,0,0,0,0,0
29054,0,0,0,0,0
37871,0,0,0,0,0
31752,0,0,0,0,0
103029,0,0,0,0,0
32934,0,0,0,0,0
25797,0,0,0,0,0
65794,0,0,0,0,0
45303,0,0,0,0,0
40570,0,0,0,0,0
16644,0,0,0,0,0
26158,0,0,0,0,0
80950,0,0,0,0,0
29463,0,0,0,0,0
87000,0,0,0,0,0
90467,0,0,0,0,0
18467,0,0,0,0,0
115671,0,0,0,0,0
46630,0,0,0,0,0
106970,0,0,0,0,0
24134,0,0,0,0,0
70888,0,0,0,0,0
110836,0,0,0,0,0
60856,0,0,0,0,0
75227,0,0,0,0,0
11301,0,0,0,0,0
74414,0,0,0,0,0
55016,0,0,0,0,0
116061,0,0,0,0,0
79588,0,0,0,0,0
13312,0,0,0,0,0
26232,0,0,0,0,0
51216,0,0,0,0,0
106488,0,0,0,0,0
37423,0,0,0,0,0
47369,0,0,0,0,0
57838,0,0,0,0,0
54291,0,0,0,0,0
96917,0,0,0,0,0
42242,3,3,3,0,0
57715,1,1,1,0,0
72324,0,0,0,0,0
66894,0,0,0,0,0
116936,0,0,0,0,0
2374,0,0,0,0,0
110021,0,0,0,0,0
50580,0,0,0,0,0
53723,1,1,1,0,0
97058,0,0,0,0,0
47293,1,1,1,0,0
119912,0,0,0,0,0
60820,0,0,0,0,0
65883,0,0,0,0,0
89541,0,0,0,0,0
133,0,0,0,0,0
56440,0,0,0,0,0
74536,0,0,0,0,0
23176,0,0,0,0,0
116178,0,0,0,0,0
11957,0,0,0,0,0
76593,0,0,0,0,0
76011,0,0,0,0,0
107350,0,0,0,0,0
68408,0,0,0,0,0
28484,0,0,0,0,0
86489,0,0,0,0,0
9422,0,0,0,0,0
85180,0,0,0,0,0
81283,0,0,0,0,0
119715,0,0,0,0,0
48099,0,0,0,0,0
102279,0,0,0,0,0
13962,0,0,0,0,0
48293,0,0,0,0,0
107249,0,0,0,0,0
96561,0,0,0,0,0
53053,0,0,0,0,0
91355,0,0,0,0,0
22284,0,0,0,0,0
4655,0,0,0,0,0
42104,0,0,0,0,0
15087,0,0,0,0,0
89807,0,0,0,0,0
113007,0,0,0,0,0
61301,0,0,0,0,0
10950,0,0,0,0,0
87357,0,0,0,0,0
17200,0,0,0,0,0
60135,0,0,0,0,0
50810,0,0,0,0,0
7153,0,0,0,0,0
93019,0,0,0,0,0
112622,0,0,0,0,0
71197,0,0,0,0,0
1081,0,0,0,0,0
97120,0,0,0,0,0
61293,0,0,0,0,0
12282,0,0,0,0,0
84605,0,0,0,0,0
58583,0,0,0,0,0
74929,0,0,0,0,0
116895,0,0,0,0,0
68543,0,0,0,0,0
69401,0,0,0,0,0
115360,2,2,2,0,0
91653,0,0,0,0,0
91480,0,0,0,0,0
10587,0,0,0,0,0
107276,0,0,0,0,0
17159,0,0,0,0,0
5056,0,0,0,0,0
69117,0,0,0,0,0
3137,0,0,0,0,0
22437,0,0,0,0,0
38351,0,0,0,0,0
45365,0,0,0,0,0
38945,0,0,0,0,0
51870,0,0,0,0,0
83690,0,0,0,0,0
94219,0,0,0,0,0
74547,0,0,0,0,0
83812,0,0,0,0,0
35951,0,0,0,0,0
60420,0,0,0,0,0
71406,0,0,0,0,0
33794,0,0,0,0,0
80238,0,0,0,0,0
117664,0,0,0,0,0
89343,0,0,0,0,0
4255,1,1,1,0,0
89483,0,0,0,0,0
17396,0,0,0,0,0
99467,0,0,0,0,0
101223,0,0,0,0,0
104436,0,0,0,0,0
104743,0,0,0,0,0
36177,0,0,0,0,0
68049,0,0,0,0,0
52583,0,0,0,0,0
12407,0,0,0,0,0
50693,0,0,0,0,0
5105,0,0,0,0,0
97126,0,0,0,0,0
29339,0,0,0,0,0
82868,0,0,0,0,0
22859,0,0,0,0,0
9093,0,0,0,0,0
21231,0,0,0,0,0
119400,0,0,0,0,0
27998,0,0,0,0,0
76124,0,0,0,0,0
32593,0,0,0,0,0
35307,0,0,0,0,0
107392,0,0,0,0,0
91769,0,0,0,0,0
47963,0,0,0,0,0
24227,0,0,0,0,0
98270,0,0,0,0,0
10460,0,0,0,0,0
30326,0,0,0,0,0
61546,0,0,0,0,0
82296,0,0,0,0,0
112810,0,0,0,0,0
24096,0,0,0,0,0
72937,0,0,0,0,0
80562,0,0,0,0,0
11656,0,0,0,0,0
84045,0,0,0,0,0
55057,0,0,0,0,0
111511,0,0,0,0,0
4414,0,0,0,0,0
63241,0,0,0,0,0
35490,0,0,0,0,0
33740,0,0,0,0,0
74742,0,0,0,0,0
19705,0,0,0,0,0
54049,0,0,0,0,0
76100,0,0,0,0,0
66157,0,0,0,0,0
106791,0,0,0,0,0
72039,0,0,0,0,0
86745,0,0,0,0,0
28860,0,0,0,0,0
8606,0,0,0,0,0
65875,0,0,0,0,0
110900,0,0,0,0,0
78487,0,0,0,0,0
61086,0,0,0,0,0
115868,0,0,0,0,0
58954,0,0,0,0,0
29358,0,0,0,0,0
88645,0,0,0,0,0
8320,0,0,0,0,0
21170,0,0,0,0,0
44228,0,0,0,0,0
85021,0,0,0,0,0
86306,0,0,0,0,0
57675,0,0,0,0,0
34092,0,0,0,0,0
13840,0,0,0,0,0
6472,0,0,0,0,0
45346,0,0,0,0,0
119250,0,0,0,0,0
65188,0,0,0,0,0
47452,0,0,0,0,0
34019,0,0,0,0,0
81114,0,0,0,0,0
94147,0,0,0,0,0
37469,0,0,0,0,0
92306,0,0,0,0,0
43198,0,0,0,0,0
69255,0,0,0,0,0
6344,0,0,0,0,0
47382,0,0,0,0,0
112434,0,0,0,0,0
24910,0,0,0,0,0
53257,0,0,0,0,0
115795,0,0,0,0,0
94261,0,0,0,0,0
96782,0,0,0,0,0
22415,0,0,0,0,0
74868,0,0,0,0,0
67405,0,0,0,0,0
51803,0,0,0,0,0
113840,1,1,1,0,0
19721,0,0,0,0,0
70420,0,0,0,0,0
36748,0,0,0,0,0
342,0,0,0,0,0
86565,1,1,1,0,0
75156,0,0,0,0,0
23255,0,0,0,0,0
104948,0,0,0,0,0
96165,0,0,0,0,0
105458,0,0,0,0,0
116858,0,0,0,0,0
101499,0,0,0,0,0
28656,0,0,0,0,0
18768,0,0,0,0,0
71782,0,0,0,0,0
61989,0,0,0,0,0
59828,0,0,0,0,0
101652,0,0,0,0,0
66940,0,0,0,0,0
1712,0,0,0,0,0
71163,0,0,0,0,0
13706,0,0,0,0,0
49788,0,0,0,0,0
12981,0,0,0,0,0
10561,0,0,0,0,0
16941,0,0,0,0,0
11792,0,0,0,0,0
15762,0,0,0,0,0
10936,0,0,0,0,0
18873,0,0,0,0,0
7171,0,0,0,0,0
32797,0,0,0,0,0
112215,0,0,0,0,0
45477,0,0,0,0,0
23535,0,0,0,0,0
26748,0,0,0,0,0
15733,0,0,0,0,0
43547,0,0,0,0,0
75248,0,0,0,0,0
62789,2,2,2,0,0
30440,0,0,0,0,0
76670,0,0,0,0,0
113173,0,0,0,0,0
97932,0,0,0,0,0
90780,0,0,0,0,0
104042,0,0,0,0,0
49977,0,0,0,0,0
98700,0,0,0,0,0
50884,0,0,0,0,0
111790,0,0,0,0,0
82236,0,0,0,0,0
20658,0,0,0,0,0
40028,0,0,0,0,0
98684,0,0,0,0,0
6984,0,0,0,0,0
27395,0,0,0,0,0
72911,0,0,0,0,0
33684,0,0,0,0,0
92338,0,0,0,0,0
68507,0,0,0,0,0
118736,0,0,0,0,0
1646,0,0,0,0,0
74692,0,0,0,0,0
111141,0,0,0,0,0
34758,0,0,0,0,0
100638,0,0,0,0,0
10205,0,0,0,0,0
44677,0,0,0,0,0
116465,0,0,0,0,0
19046,0,0,0,0,0
36482,0,0,0,0,0
81009,0,0,0,0,0
72046,0,0,0,0,0
21807,0,0,0,0,0
3030,0,0,0,0,0
26609,0,0,0,0,0
473,0,0,0,0,0
25362,0,0,0,0,0
41893,0,0,0,0,0
2670,0,0,0,0,0
18236,0,0,0,0,0
58274,0,0,0,0,0
355,0,0,0,0,0
94921,0,0,0,0,0
66978,0,0,0,0,0
18224,0,0,0,0,0
107037,0,0,0,0,0
32013,0,0,0,0,0
32651,0,0,0,0,0
14944,0,0,0,0,0
81621,0,0,0,0,0
34214,0,0,0,0,0
49719,0,0,0,0,0
88083,0,0,0,0,0
12567,0,0,0,0,0
73237,0,0,0,0,0
73410,0,0,0,0,0
75536,0,0,0,0,0
2255,1,1,1,0,0
75935,0,0,0,0,0
112555,0,0,0,0,0
57572,0,0,0,0,0
32766,0,0,0,0,0
103381,0,0,0,0,0
6271,0,0,0,0,0
8403,0,0,0,0,0
32809,0,0,0,0,0
20600,0,0,0,0,0
877,0,0,0,0,0
46386,0,0,0,0,0
102771,0,0,0,0,0
33369,0,0,0,0,0
44955,0,0,0,0,0
118873,0,0,0,0,0
73883,0,0,0,0,0
62696,0,0,0,0,0
116650,0,0,0,0,0
32076,0,0,0,0,0
41635,0,0,0,0,0
27359,0,0,0,0,0
81685,0,0,0,0,0
72024,0,0,0,0,0
71933,0,0,0,0,0
4470,0,0,0,0,0
30832,0,0,0,0,0
8364,0,0,0,0,0
96510,0,0,0,0,0
102976,0,0,0,0,0
87134,0,0,0,0,0
113079,0,0,0,0,0
84745,0,0,0,0,0
54766,0,0,0,0,0
93733,0,0,0,0,0
21607,0,0,0,0,0
52316,0,0,0,0,0
81039,0,0,0,0,0
91882,0,0,0,0,0
113006,0,0,0,0,0
43620,0,0,0,0,0
113730,0,0,0,0,0
105134,0,0,0,0,0
117161,0,0,0,0,0
69125,0,0,0,0,0
66039,0,0,0,0,0
21891,0,0,0,0,0
52226,0,0,0,0,0
108190,0,0,0,0,0
1925,0,0,0,0,0
114525,0,0,0,0,0
47791,0,0,0,0,0
25044,0,0,0,0,0
120133,0,0,0,0,0
51245,0,0,0,0,0
39014,0,0,0,0,0
45059,0,0,0,0,0
13085,0,0,0,0,0
97397,0,0,0,0,0
35622,0,0,0,0,0
30264,0,0,0,0,0
111108,0,0,0,0,0
20611,0,0,0,0,0
118279,0,0,0,0,0
8316,0,0,0,0,0
23702,0,0,0,0,0
8900,0,0,0,0,0
28950,0,0,0,0,0
12634,0,0,0,0,0
91673,0,0,0,0,0
87124,0,0,0,0,0
80698,0,0,0,0,0
18778,0,0,0,0,0
66676,0,0,0,0,0
116302,0,0,0,0,0
90542,0,0,0,0,0
86874,0,0,0,0,0
86852,0,0,0,0,0
54714,0,0,0,0,0
64434,0,0,0,0,0
96545,0,0,0,0,0
62960,0,0,0,0,0
36755,0,0,0,0,0
114198,0,0,0,0,0
110371,0,0,0,0,0
12095,0,0,0,0,0
84152,0,0,0,0,0
22566,0,0,0,0,0
93171,0,0,0,0,0
98826,0,0,0,0,0
44264,0,0,0,0,0
31950,0,0,0,0,0
106889,0,0,0,0,0
82507,0,0,0,0,0
92879,0,0,0,0,0
66579,0,0,0,0,0
28605,0,0,0,0,0
34604,0,0,0,0,0
88410,0,0,0,0,0
92375,0,0,0,0,0
69915,0,0,0,0,0
41718,0,0,0,0,0
52163,0,0,0,0,0
93680,0,0,0,0,0
56622,0,0,0,0,0
12494,0,0,0,0,0
20743,0,0,0,0,0
86941,0,0,0,0,0
50236,0,0,0,0,0
18949,0,0,0,0,0
52145,0,0,0,0,0
65399,0,0,0,0,0
86024,0,0,0,0,0
102407,0,0,0,0,0
96432,0,0,0,0,0
114735,0,0,0,0,0
94393,0,0,0,0,0
57101,0,0,0,0,0
33148,0,0,0,0,0
1792,0,0,0,0,0
119748,0,0,0,0,0
3336,0,0,0,0,0
99354,0,0,0,0,0
85363,0,0,0,0,0
76359,0,0,0,0,0
80551,0,0,0,0,0
72208,0,0,0,0,0
40185,0,0,0,0,0
32677,0,0,0,0,0
18452,0,0,0,0,0
55796,0,0,0,0,0
82426,0,0,0,0,0
63974,0,0,0,0,0
99861,0,0,0,0,0
14456,0,0,0,0,0
40553,0,0,0,0,0
43578,0,0,0,0,0
101015,0,0,0,0,0
81527,0,0,0,0,0
63707,0,0,0,0,0
7577,0,0,0,0,0
9613,0,0,0,0,0
15004,0,0,0,0,0
103058,0,0,0,0,0
61186,0,0,0,0,0
99476,0,0,0,0,0
113793,0,0,0,0,0
26511,0,0,0,0,0
21623,0,0,0,0,0
90563,0,0,0,0,0
54338,0,0,0,0,0
107129,2,2,2,0,0
119342,0,0,0,0,0
86790,0,0,0,0,0
10858,0,0,0,0,0
52827,0,0,0,0,0
79736,0,0,0,0,0
41814,0,0,0,0,0
107808,0,0,0,0,0
44161,0,0,0,0,0
100281,0,0,0,0,0
13932,0,0,0,0,0
101575,0,0,0,0,0
82747,0,0,0,0,0
94093,0,0,0,0,0
68601,0,0,0,0,0
57994,0,0,0,0,0
858,0,0,0,0,0
2086,0,0,0,0,0
118217,0,0,0,0,0
102901,0,0,0,0,0
87751,3,3,3,0,0
70907,0,0,0,0,0
90580,0,0,0,0,0
86146,0,0,0,0,0
62980,0,0,0,0,0
25942,0,0,0,0,0
78725,2,2,2,0,0
62204,0,0,0,0,0
34719,0,0,0,0,0
38113,0,0,0,0,0
74229,0,0,0,0,0
88075,0,0,0,0,0
17931,0,0,0,0,0
19638,0,0,0,0,0
56017,0,0,0,0,0
3391,0,0,0,0,0
29573,0,0,0,0,0
9486,0,0,0,0,0
90438,0,0,0,0,0
118220,0,0,0,0,0
25866,0,0,0,0,0
47255,0,0,0,0,0
100933,0,0,0,0,0
69918,0,0,0,0,0
78069,0,0,0,0,0
96597,0,0,0,0,0
111827,0,0,0,0,0
64686,0,0,0,0,0
3251,0,0,0,0,0
43517,0,0,0,0,0
51093,0,0,0,0,0
8807,0,0,0,0,0
37216,0,0,0,0,0
54004,0,0,0,0,0
22269,0,0,0,0,0
82206,0,0,0,0,0
9750,0,0,0,0,0
52044,0,0,0,0,0
70496,0,0,0,0,0
26191,0,0,0,0,0
15098,0,0,0,0,0
20749,0,0,0,0,0
115608,0,0,0,0,0
22236,0,0,0,0,0
109407,0,0,0,0,0
85404,0,0,0,0,0
31464,0,0,0,0,0
84369,0,0,0,0,0
68677,0,0,0,0,0
9157,0,0,0,0,0
7263,0,0,0,0,0
76582,0,0,0,0,0
8682,0,0,0,0,0
118137,0,0,0,0,0
86391,0,0,0,0,0
21589,0,0,0,0,0
102395,0,0,0,0,0
100081,0,0,0,0,0
109537,0,0,0,0,0
118493,0,0,0,0,0
87843,0,0,0,0,0
105859,0,0,0,0,0
113984,0,0,0,0,0
51125,0,0,0,0,0
15847,0,0,0,0,0
51693,0,0,0,0,0
36319,0,0,0,0,0
109662,0,0,0,0,0
27313,0,0,0,0,0
56873,0,0,0,0,0
50005,0,0,0,0,0
101104,0,0,0,0,0
34102,0,0,0,0,0
41393,0,0,0,0,0
87512,0,0,0,0,0
119945,0,0,0,0,0
55405,0,0,0,0,0
79436,0,0,0,0,0
42354,0,0,0,0,0
52730,0,0,0,0,0
40829,0,0,0,0,0
76355,0,0,0,0,0
95214,0,0,0,0,0
54364,0,0,0,0,0
89261,0,0,0,0,0
65627,0,0,0,0,0
91652,0,0,0,0,0
20400,0,0,0,0,0
17596,0,0,0,0,0
109829,0,0,0,0,0
2319,0,0,0,0,0
49214,0,0,0,0,0
97179,0,0,0,0,0
92530,0,0,0,0,0
60662,0,0,0,0,0
54616,0,0,0,0,0
112348,0,0,0,0,0
62624,0,0,0,0,0
54402,0,0,0,0,0
66368,0,0,0,0,0
68060,0,0,0,0,0
112602,0,0,0,0,0
58785,0,0,0,0,0
44091,0,0,0,0,0
61916,0,0,0,0,0
114551,0,0,0,0,0
109304,0,0,0,0,0
87010,0,0,0,0,0
98323,1,1,1,0,0
1883,0,0,0,0,0
95041,0,0,0,0,0
21332,0,0,0,0,0
20500,0,0,0,0,0
278,0,0,0,0,0
115635,0,0,0,0,0
110180,0,0,0,0,0
102518,0,0,0,0,0
28023,0,0,0,0,0
65453,0,0,0,0,0
60597,0,0,0,0,0
71747,0,0,0,0,0
102008,0,0,0,0,0
77138,0,0,0,0,0
93035,0,0,0,0,0
47509,0,0,0,0,0
85603,0,0,0,0,0
98728,0,0,0,0,0
48215,0,0,0,0,0
98555,0,0,0,0,0
88274,0,0,0,0,0
56875,0,0,0,0,0
117318,0,0,0,0,0
92568,0,0,0,0,0
102540,0,0,0,0,0
5403,0,0,0,0,0
4021,0,0,0,0,0
36166,0,0,0,0,0
1194,0,0,0,0,0
43737,0,0,0,0,0
57422,0,0,0,0,0
22776,0,0,0,0,0
65032,0,0,0,0,0
38874,0,0,0,0,0
71552,0,0,0,0,0
103537,0,0,0,0,0
96318,0,0,0,0,0
49739,0,0,0,0,0
31094,0,0,0,0,0
68191,0,0,0,0,0
31351,0,0,0,0,0
62840,0,0,0,0,0
57236,0,0,0,0,0
34953,0,0,0,0,0
43054,0,0,0,0,0
7857,0,0,0,0,0
14894,0,0,0,0,0
43516,0,0,0,0,0
14067,0,0,0,0,0
88100,0,0,0,0,0
19127,0,0,0,0,0
87448,0,0,0,0,0
64498,0,0,0,0,0
30699,0,0,0,0,0
16239,0,0,0,0,0
53851,0,0,0,0,0
97848,0,0,0,0,0
15405,0,0,0,0,0
111391,0,0,0,0,0
24922,0,0,0,0,0
53556,0,0,0,0,0
48360,0,0,0,0,0
86195,0,0,0,0,0
7380,0,0,0,0,0
14414,0,0,0,0,0
95826,0,0,0,0,0
60270,0,0,0,0,0
39450,0,0,0,0,0
29687,0,0,0,0,0
110348,0,0,0,0,0
49188,0,0,0,0,0
57181,0,0,0,0,0
108024,0,0,0,0,0
21058,0,0,0,0,0
41082,0,0,0,0,0
74317,0,0,0,0,0
8779,0,0,0,0,0
85473,0,0,0,0,0
31774,0,0,0,0,0
5660,0,0,0,0,0
113239,0,0,0,0,0
8162,0,0,0,0,0
533,0,0,0,0,0
32597,0,0,0,0,0
3645,0,0,0,0,0
98290,0,0,0,0,0
118799,0,0,0,0,0
3600,0,0,0,0,0
33275,0,0,0,0,0
13132,0,0,0,0,0
67408,0,0,0,0,0
65252,0,0,0,0,0
88397,0,0,0,0,0
41835,0,0,0,0,0
84405,0,0,0,0,0
114032,0,0,0,0,0
93609,0,0,0,0,0
117272,0,0,0,0,0
60308,0,0,0,0,0
32450,0,0,0,0,0
10101,0,0,0,0,0
55197,0,0,0,0,0
41081,0,0,0,0,0
27190,0,0,0,0,0
12050,0,0,0,0,0
53038,0,0,0,0,0
4689,0,0,0,0,0
31230,0,0,0,0,0
72760,0,0,0,0,0
19453,1,1,1,0,0
100635,0,0,0,0,0
112419,0,0,0,0,0
72131,0,0,0,0,0
28368,0,0,0,0,0
9010,0,0,0,0,0
22006,0,0,0,0,0
56839,3,3,3,0,0
26683,0,0,0,0,0
99263,0,0,0,0,0
49584,0,0,0,0,0
113192,0,0,0,0,0
32578,0,0,0,0,0
109222,0,0,0,0,0
96818,0,0,0,0,0
39989,2,2,2,0,0
59936,0,0,0,0,0
26407,0,0,0,0,0
78703,0,0,0,0,0
75965,0,0,0,0,0
97117,0,0,0,0,0
1665,0,0,0,0,0
3483,0,0,0,0,0
62422,0,0,0,0,0
108025,0,0,0,0,0
32858,0,0,0,0,0
23672,0,0,0,0,0
91534,0,0,0,0,0
45829,0,0,0,0,0
36823,0,0,0,0,0
107807,0,0,0,0,0
31625,0,0,0,0,0
73780,0,0,0,0,0
27666,0,0,0,0,0
3709,0,0,0,0,0
24945,0,0,0,0,0
26999,0,0,0,0,0
35451,0,0,0,0,0
96284,0,0,0,0,0
56427,0,0,0,0,0
98988,0,0,0,0,0
26816,0,0,0,0,0
52321,0,0,0,0,0
75420,0,0,0,0,0
28203,0,0,0,0,0
105423,0,0,0,0,0
78397,0,0,0,0,0
47414,0,0,0,0,0
45128,0,0,0,0,0
102969,0,0,0,0,0
100524,0,0,0,0,0
22823,0,0,0,0,0
82509,0,0,0,0,0
116729,0,0,0,0,0
70274,0,0,0,0,0
117623,0,0,0,0,0
105137,0,0,0,0,0
107527,0,0,0,0,0
5061,0,0,0,0,0
5074,0,0,0,0,0
28639,0,0,0,0,0
80714,0,0,0,0,0
50983,0,0,0,0,0
16091,0,0,0,0,0
3907,0,0,0,0,0
23648,0,0,0,0,0
78569,0,0,0,0,0
36180,0,0,0,0,0
77215,0,0,0,0,0
63464,0,0,0,0,0
40440,0,0,0,0,0
21928,0,0,0,0,0
117014,0,0,0,0,0
73601,0,0,0,0,0
21924,0,0,0,0,0
73821,0,0,0,0,0
79607,0,0,0,0,0
28508,0,0,0,0,0
66131,0,0,0,0,0
25007,0,0,0,0,0
25966,0,0,0,0,0
51750,0,0,0,0,0
68123,5,5,5,0,0
63624,0,0,0,0,0
116179,0,0,0,0,0
101978,0,0,0,0,0
35653,0,0,0,0,0
84547,0,0,0,0,0
36059,0,0,0,0,0
47482,0,0,0,0,0
38256,0,0,0,0,0
32713,0,0,0,0,0
37967,0,0,0,0,0
49772,0,0,0,0,0
89743,0,0,0,0,0
71946,0,0,0,0,0
55602,0,0,0,0,0
21469,0,0,0,0,0
61543,0,0,0,0,0
52708,0,0,0,0,0
38911,0,0,0,0,0
53612,0,0,0,0,0
42801,0,0,0,0,0
120466,0,0,0,0,0
86697,0,0,0,0,0
119028,0,0,0,0,0
18585,0,0,0,0,0
63958,0,0,0,0,0
59983,0,0,0,0,0
18984,0,0,0,0,0
22467,0,0,0,0,0
52722,0,0,0,0,0
101431,0,0,0,0,0
41223,0,0,0,0,0
100979,0,0,0,0,0
47357,0,0,0,0,0
6033,0,0,0,0,0
55790,0,0,0,0,0
36387,0,0,0,0,0
97115,0,0,0,0,0
100858,0,0,0,0,0
21509,0,0,0,0,0
63587,0,0,0,0,0
83330,0,0,0,0,0
42130,0,0,0,0,0
111257,1,1,1,0,0
116574,0,0,0,0,0
21624,0,0,0,0,0
112490,0,0,0,0,0
114504,0,0,0,0,0
75145,0,0,0,0,0
94519,0,0,0,0,0
16961,0,0,0,0,0
82783,0,0,0,0,0
108680,1,1,1,0,0
69768,0,0,0,0,0
114935,0,0,0,0,0
74306,0,0,0,0,0
4216,0,0,0,0,0
74664,0,0,0,0,0
98126,0,0,0,0,0
117233,0,0,0,0,0
13311,0,0,0,0,0
102465,0,0,0,0,0
87973,0,0,0,0,0
94502,0,0,0,0,0
6698,0,0,0,0,0
7770,0,0,0,0,0
114710,0,0,0,0,0
96925,0,0,0,0,0
110929,0,0,0,0,0
70318,0,0,0,0,0
48269,0,0,0,0,0
66782,0,0,0,0,0
114490,1,1,1,0,0
64253,0,0,0,0,0
92647,0,0,0,0,0
72364,0,0,0,0,0
14433,0,0,0,0,0
91120,0,0,0,0,0
6534,0,0,0,0,0
61192,0,0,0,0,0
44716,0,0,0,0,0
116590,0,0,0,0,0
76577,0,0,0,0,0
19187,0,0,0,0,0
66043,0,0,0,0,0
115589,0,0,0,0,0
971,0,0,0,0,0
71221,0,0,0,0,0
95822,0,0,0,0,0
108296,0,0,0,0,0
6278,1,1,1,0,0
52252,0,0,0,0,0
50338,0,0,0,0,0
108018,0,0,0,0,0
25628,0,0,0,0,0
99387,0,0,0,0,0
282,0,0,0,0,0
59970,0,0,0,0,0
103490,0,0,0,0,0
73423,0,0,0,0,0
98709,0,0,0,0,0
101825,0,0,0,0,0
87335,0,0,0,0,0
22479,0,0,0,0,0
98446,1,1,1,0,0
64164,0,0,0,0,0
107748,0,0,0,0,0
37006,0,0,0,0,0
42106,0,0,0,0,0
76186,0,0,0,0,0
109038,0,0,0,0,0
79259,0,0,0,0,0
20410,0,0,0,0,0
18048,0,0,0,0,0
45402,0,0,0,0,0
84739,0,0,0,0,0
99453,0,0,0,0,0
76369,0,0,0,0,0
101870,0,0,0,0,0
14908,0,0,0,0,0
90740,0,0,0,0,0
101509,0,0,0,0,0
25640,0,0,0,0,0
18865,0,0,0,0,0
61409,0,0,0,0,0
100589,0,0,0,0,0
82115,0,0,0,0,0
55669,0,0,0,0,0
49800,0,0,0,0,0
84729,0,0,0,0,0
1405,0,0,0,0,0
34624,0,0,0,0,0
2384,5,5,5,0,0
73671,0,0,0,0,0
114447,0,0,0,0,0
47176,0,0,0,0,0
112781,0,0,0,0,0
45573,0,0,0,0,0
41302,0,0,0,0,0
84240,0,0,0,0,0
29321,0,0,0,0,0
10001,0,0,0,0,0
76197,0,0,0,0,0
112409,0,0,0,0,0
27611,0,0,0,0,0
26006,0,0,0,0,0
73069,0,0,0,0,0
96367,0,0,0,0,0
108759,0,0,0,0,0
104024,0,0,0,0,0
41404,0,0,0,0,0
44413,0,0,0,0,0
120430,0,0,0,0,0
501,0,0,0,0,0
28028,0,0,0,0,0
9739,0,0,0,0,0
4197,0,0,0,0,0
45338,0,0,0,0,0
2637,0,0,0,0,0
118721,0,0,0,0,0
52451,0,0,0,0,0
90042,0,0,0,0,0
8855,0,0,0,0,0
53782,0,0,0,0,0
51129,0,0,0,0,0
27174,0,0,0,0,0
96328,0,0,0,0,0
1456,0,0,0,0,0
545,0,0,0,0,0
12778,0,0,0,0,0
15447,0,0,0,0,0
18896,0,0,0,0,0
16423,0,0,0,0,0
76326,0,0,0,0,0
55993,0,0,0,0,0
70136,0,0,0,0,0
76239,0,0,0,0,0
64832,0,0,0,0,0
9329,0,0,0,0,0
54554,0,0,0,0,0
14849,1,1,1,0,0
89358,0,0,0,0,0
62964,0,0,0,0,0
98472,0,0,0,0,0
60702,0,0,0,0,0
62227,0,0,0,0,0
39718,0,0,0,0,0
16056,0,0,0,0,0
85301,0,0,0,0,0
89640,0,0,0,0,0
395,0,0,0,0,0
83251,0,0,0,0,0
70606,0,0,0,0,0
112883,0,0,0,0,0
12892,0,0,0,0,0
17937,0,0,0,0,0
43463,0,0,0,0,0
65729,0,0,0,0,0
44823,0,0,0,0,0
13371,0,0,0,0,0
69409,0,0,0,0,0
2133,0,0,0,0,0
11674,0,0,0,0,0
73270,0,0,0,0,0
85007,0,0,0,0,0
3746,0,0,0,0,0
65013,0,0,0,0,0
62927,0,0,0,0,0
2830,0,0,0,0,0
33076,0,0,0,0,0
62257,0,0,0,0,0
27496,0,0,0,0,0
50466,0,0,0,0,0
22329,0,0,0,0,0
7981,0,0,0,0,0
75153,0,0,0,0,0
101482,0,0,0,0,0
47115,0,0,0,0,0
52572,0,0,0,0,0
47877,0,0,0,0,0
46478,0,0,0,0,0
93760,0,0,0,0,0
51697,0,0,0,0,0
71671,0,0,0,0,0
104822,0,0,0,0,0
98620,0,0,0,0,0
95308,0,0,0,0,0
62918,0,0,0,0,0
102867,0,0,0,0,0
100574,0,0,0,0,0
68943,0,0,0,0,0
64744,0,0,0,0,0
80711,0,0,0,0,0
68912,0,0,0,0,0
102694,0,0,0,0,0
105941,0,0,0,0,0
72809,0,0,0,0,0
38132,0,0,0,0,0
29712,0,0,0,0,0
88208,0,0,0,0,0
4376,0,0,0,0,0
57997,0,0,0,0,0
20786,0,0,0,0,0
9420,0,0,0,0,0
104651,0,0,0,0,0
74999,5,5,5,0,0
109412,0,0,0,0,0
64587,4,4,4,0,0
32181,0,0,0,0,0
40614,0,0,0,0,0
25377,0,0,0,0,0
116234,0,0,0,0,0
49412,0,0,0,0,0
49338,0,0,0,0,0
49435,0,0,0,0,0
90819,0,0,0,0,0
75905,0,0,0,0,0
97769,0,0,0,0,0
113203,0,0,0,0,0
21287,0,0,0,0,0
6582,0,0,0,0,0
103986,0,0,0,0,0
16039,0,0,0,0,0
114596,0,0,0,0,0
99220,0,0,0,0,0
119475,0,0,0,0,0
16971,0,0,0,0,0
88675,0,0,0,0,0
79260,0,0,0,0,0
77222,0,0,0,0,0
16690,0,0,0,0,0
73812,0,0,0,0,0
33073,0,0,0,0,0
40592,0,0,0,0,0
10281,0,0,0,0,0
16530,0,0,0,0,0
57154,0,0,0,0,0
104925,0,0,0,0,0
71345,0,0,0,0,0
57509,0,0,0,0,0
102666,0,0,0,0,0
97674,1,1,1,0,0
53354,0,0,0,0,0
27659,0,0,0,0,0
114076,0,0,0,0,0
92564,0,0,0,0,0
85150,0,0,0,0,0
51844,0,0,0,0,0
50989,1,1,1,0,0
73877,0,0,0,0,0
53848,0,0,0,0,0
70063,0,0,0,0,0
70441,0,0,0,0,0
70485,0,0,0,0,0
26449,0,0,0,0,0
45164,0,0,0,0,0
112987,0,0,0,0,0
15493,0,0,0,0,0
58214,0,0,0,0,0
33290,0,0,0,0,0
29379,0,0,0,0,0
107291,0,0,0,0,0
120142,0,0,0,0,0
85251,0,0,0,0,0
89065,0,0,0,0,0
46820,0,0,0,0,0
58884,0,0,0,0,0
82273,0,0,0,0,0
55703,0,0,0,0,0
28533,0,0,0,0,0
68090,0,0,0,0,0
12069,0,0,0,0,0
83760,0,0,0,0,0
107955,0,0,0,0,0
117734,0,0,0,0,0
50007,0,0,0,0,0
52060,0,0,0,0,0
69277,0,0,0,0,0
69791,0,0,0,0,0
114415,0,0,0,0,0
13655,0,0,0,0,0
3518,5,5,5,0,0
88623,0,0,0,0,0
756,0,0,0,0,0
14184,0,0,0,0,0
37566,0,0,0,0,0
69558,0,0,0,0,0
21055,0,0,0,0,0
103625,0,0,0,0,0
19780,0,0,0,0,0
106528,0,0,0,0,0
100608,0,0,0,0,0
21038,0,0,0,0,0
101963,0,0,0,0,0
56697,0,0,0,0,0
92011,0,0,0,0,0
114960,0,0,0,0,0
95005,0,0,0,0,0
88988,0,0,0,0,0
92846,0,0,0,0,0
44883,0,0,0,0,0
30080,0,0,0,0,0
13790,0,0,0,0,0
45306,0,0,0,0,0
78741,0,0,0,0,0
99035,0,0,0,0,0
57871,0,0,0,0,0
91119,0,0,0,0,0
105313,0,0,0,0,0
44659,0,0,0,0,0
39247,0,0,0,0,0
105957,0,0,0,0,0
87097,0,0,0,0,0
97378,0,0,0,0,0
57455,0,0,0,0,0
33765,0,0,0,0,0
17174,0,0,0,0,0
8006,0,0,0,0,0
80051,0,0,0,0,0
6732,0,0,0,0,0
28697,0,0,0,0,0
57587,0,0,0,0,0
22903,0,0,0,0,0
54695,0,0,0,0,0
117519,0,0,0,0,0
59574,0,0,0,0,0
9862,0,0,0,0,0
1190,0,0,0,0,0
17043,0,0,0,0,0
79096,0,0,0,0,0
11244,0,0,0,0,0
119396,0,0,0,0,0
20200,0,0,0,0,0
33558,0,0,0,0,0
29019,0,0,0,0,0
74217,0,0,0,0,0
103674,0,0,0,0,0
109026,0,0,0,0,0
105433,0,0,0,0,0
73741,0,0,0,0,0
30897,0,0,0,0,0
47580,0,0,0,0,0
52425,0,0,0,0,0
98981,0,0,0,0,0
84351,0,0,0,0,0
42586,0,0,0,0,0
63484,0,0,0,0,0
3711,0,0,0,0,0
100968,0,0,0,0,0
51139,0,0,0,0,0
29685,0,0,0,0,0
107305,0,0,0,0,0
92847,0,0,0,0,0
7066,0,0,0,0,0
3977,0,0,0,0,0
75780,0,0,0,0,0
29729,0,0,0,0,0
70743,0,0,0,0,0
109430,0,0,0,0,0
5347,0,0,0,0,0
9268,0,0,0,0,0
63031,0,0,0,0,0
89679,0,0,0,0,0
104779,0,0,0,0,0
66473,0,0,0,0,0
116990,0,0,0,0,0
24852,0,0,0,0,0
113034,0,0,0,0,0
98743,0,0,0,0,0
90635,0,0,0,0,0
101948,0,0,0,0,0
2314,0,0,0,0,0
71392,0,0,0,0,0
58188,0,0,0,0,0
35452,0,0,0,0,0
116723,0,0,0,0,0
12346,0,0,0,0,0
76390,0,0,0,0,0
91868,0,0,0,0,0
48914,0,0,0,0,0
48041,0,0,0,0,0
56700,0,0,0,0,0
63123,0,0,0,0,0
78118,0,0,0,0,0
106218,0,0,0,0,0
1442,0,0,0,0,0
63512,0,0,0,0,0
71704,0,0,0,0,0
68149,0,0,0,0,0
34385,0,0,0,0,0
117845,0,0,0,0,0
38710,0,0,0,0,0
31550,0,0,0,0,0
88886,0,0,0,0,0
68369,0,0,0,0,0
109949,0,0,0,0,0
63297,0,0,0,0,0
109428,0,0,0,0,0
55552,0,0,0,0,0
23859,0,0,0,0,0
37731,0,0,0,0,0
3722,0,0,0,0,0
37698,0,0,0,0,0
7095,0,0,0,0,0
106093,0,0,0,0,0
104909,0,0,0,0,0
94042,0,0,0,0,0
46115,0,0,0,0,0
25090,0,0,0,0,0
20053,0,0,0,0,0
96157,0,0,0,0,0
57489,0,0,0,0,0
104287,0,0,0,0,0
45322,0,0,0,0,0
75468,0,0,0,0,0
95374,0,0,0,0,0
21115,0,0,0,0,0
30954,0,0,0,0,0
52028,0,0,0,0,0
14258,0,0,0,0,0
101648,0,0,0,0,0
91431,0,0,0,0,0
15621,0,0,0,0,0
37814,0,0,0,0,0
17454,0,0,0,0,0
78609,0,0,0,0,0
111258,0,0,0,0,0
113414,0,0,0,0,0
21413,0,0,0,0,0
78458,0,0,0,0,0
75710,0,0,0,0,0
96530,0,0,0,0,0
40189,0,0,0,0,0
48136,0,0,0,0,0
28590,0,0,0,0,0
95775,0,0,0,0,0
80656,0,0,0,0,0
31350,0,0,0,0,0
45667,0,0,0,0,0
84983,0,0,0,0,0
117271,0,0,0,0,0
109354,3,3,3,0,0
6226,0,0,0,0,0
17733,0,0,0,0,0
93826,0,0,0,0,0
12352,0,0,0,0,0
82449,0,0,0,0,0
86765,0,0,0,0,0
71367,0,0,0,0,0
32252,0,0,0,0,0
7659,0,0,0,0,0
69144,0,0,0,0,0
118321,0,0,0,0,0
43725,0,0,0,0,0
32353,0,0,0,0,0
52847,0,0,0,0,0
104072,0,0,0,0,0
20520,0,0,0,0,0
47952,0,0,0,0,0
103529,0,0,0,0,0
27029,0,0,0,0,0
14260,0,0,0,0,0
64460,0,0,0,0,0
114978,0,0,0,0,0
885,0,0,0,0,0
89255,0,0,0,0,0
88712,0,0,0,0,0
33027,0,0,0,0,0
112553,0,0,0,0,0
52740,0,0,0,0,0
47425,0,0,0,0,0
71993,0,0,0,0,0
109268,0,0,0,0,0
30202,0,0,0,0,0
119184,1,1,1,0,0
30800,0,0,0,0,0
18743,0,0,0,0,0
39554,0,0,0,0,0
108299,0,0,0,0,0
93193,0,0,0,0,0
32577,0,0,0,0,0
76675,0,0,0,0,0
24467,0,0,0,0,0
21172,0,0,0,0,0
87968,0,0,0,0,0
67945,0,0,0,0,0
75733,0,0,0,0,0
105473,0,0,0,0,0
95009,0,0,0,0,0
7017,0,0,0,0,0
71584,0,0,0,0,0
53157,0,0,0,0,0
91889,0,0,0,0,0
110072,0,0,0,0,0
97665,0,0,0,0,0
95841,0,0,0,0,0
108618,0,0,0,0,0
39753,0,0,0,0,0
94427,0,0,0,0,0
112012,0,0,0,0,0
18049,0,0,0,0,0
113324,0,0,0,0,0
42162,0,0,0,0,0
60281,0,0,0,0,0
82074,0,0,0,0,0
82863,0,0,0,0,0
92990,0,0,0,0,0
71637,0,0,0,0,0
8597,0,0,0,0,0
104246,0,0,0,0,0
104167,0,0,0,0,0
5095,0,0,0,0,0
31147,0,0,0,0,0
89348,0,0,0,0,0
100625,0,0,0,0,0
24228,0,0,0,0,0
50870,0,0,0,0,0
69984,0,0,0,0,0
70193,0,0,0,0,0
24859,0,0,0,0,0
17724,0,0,0,0,0
36198,0,0,0,0,0
107495,0,0,0,0,0
85805,0,0,0,0,0
41125,0,0,0,0,0
48009,0,0,0,0,0
111740,0,0,0,0,0
30048,0,0,0,0,0
98186,0,0,0,0,0
103719,0,0,0,0,0
4570,0,0,0,0,0
24584,0,0,0,0,0
82487,0,0,0,0,0
48783,0,0,0,0,0
35435,0,0,0,0,0
13695,0,0,0,0,0
72787,0,0,0,0,0
59124,0,0,0,0,0
57684,0,0,0,0,0
115729,0,0,0,0,0
100284,0,0,0,0,0
62287,0,0,0,0,0
59696,0,0,0,0,0
21822,0,0,0,0,0
70502,0,0,0,0,0
27126,0,0,0,0,0
120523,0,0,0,0,0
58627,0,0,0,0,0
9868,0,0,0,0,0
43039,0,0,0,0,0
62655,0,0,0,0,0
75286,0,0,0,0,0
102124,0,0,0,0,0
71454,0,0,0,0,0
47409,0,0,0,0,0
83965,0,0,0,0,0
78419,0,0,0,0,0
65099,0,0,0,0,0
117987,0,0,0,0,0
50487,0,0,0,0,0
9873,0,0,0,0,0
49598,0,0,0,0,0
17048,0,0,0,0,0
72808,0,0,0,0,0
117939,0,0,0,0,0
15477,0,0,0,0,0
76085,0,0,0,0,0
67452,0,0,0,0,0
11804,0,0,0,0,0
42790,0,0,0,0,0
30701,0,0,0,0,0
16821,0,0,0,0,0
31647,0,0,0,0,0
41804,0,0,0,0,0
55372,0,0,0,0,0
31613,0,0,0,0,0
119624,0,0,0,0,0
111634,0,0,0,0,0
116827,0,0,0,0,0
67254,0,0,0,0,0
41290,0,0,0,0,0
85136,0,0,0,0,0
98799,0,0,0,0,0
75104,0,0,0,0,0
29825,0,0,0,0,0
37661,0,0,0,0,0
89251,0,0,0,0,0
90385,0,0,0,0,0
94776,0,0,0,0,0
62160,0,0,0,0,0
98365,0,0,0,0,0
74746,0,0,0,0,0
95173,0,0,0,0,0
62241,0,0,0,0,0
91452,0,0,0,0,0
119525,0,0,0,0,0
66170,0,0,0,0,0
68537,0,0,0,0,0
5280,0,0,0,0,0
9461,0,0,0,0,0
14331,0,0,0,0,0
78976,0,0,0,0,0
31749,0,0,0,0,0
96594,0,0,0,0,0
70962,0,0,0,0,0
7384,0,0,0,0,0
9285,0,0,0,0,0
81064,0,0,0,0,0
66306,0,0,0,0,0
78172,0,0,0,0,0
100486,0,0,0,0,0
31114,0,0,0,0,0
27198,0,0,0,0,0
111146,0,0,0,0,0
109151,0,0,0,0,0
64378,0,0,0,0,0
77269,0,0,0,0,0
63002,0,0,0,0,0
20627,0,0,0,0,0
110236,0,0,0,0,0
119042,0,0,0,0,0
55287,0,0,0,0,0
50452,0,0,0,0,0
4846,0,0,0,0,0
111849,0,0,0,0,0
49351,0,0,0,0,0
95400,0,0,0,0,0
112283,0,0,0,0,0
109597,0,0,0,0,0
78355,0,0,0,0,0
24375,0,0,0,0,0
97840,0,0,0,0,0
59992,0,0,0,0,0
116670,0,0,0,0,0
63234,0,0,0,0,0
44271,0,0,0,0,0
53094,0,0,0,0,0
64597,0,0,0,0,0
41703,0,0,0,0,0
51327,0,0,0,0,0
93417,0,0,0,0,0
108801,0,0,0,0,0
42944,0,0,0,0,0
77147,0,0,0,0,0
85287,0,0,0,0,0
43124,0,0,0,0,0
23324,0,0,0,0,0
62464,0,0,0,0,0
14410,0,0,0,0,0
110650,0,0,0,0,0
105969,0,0,0,0,0
112168,0,0,0,0,0
85884,0,0,0,0,0
26497,0,0,0,0,0
118452,0,0,0,0,0
34771,0,0,0,0,0
42193,0,0,0,0,0
93464,0,0,0,0,0
75516,0,0,0,0,0
714,0,0,0,0,0
57647,0,0,0,0,0
27027,0,0,0,0,0
1616,0,0,0,0,0
54640,0,0,0,0,0
103496,0,0,0,0,0
62247,0,0,0,0,0
44014,0,0,0,0,0
7939,0,0,0,0,0
30010,0,0,0,0,0
46000,0,0,0,0,0
4834,0,0,0,0,0
16241,0,0,0,0,0
35626,0,0,0,0,0
72953,0,0,0,0,0
112467,0,0,0,0,0
19397,0,0,0,0,0
35556,0,0,0,0,0
52411,0,0,0,0,0
94980,0,0,0,0,0
93079,0,0,0,0,0
99052,0,0,0,0,0
13710,0,0,0,0,0
1824,0,0,0,0,0
98926,0,0,0,0,0
47857,0,0,0,0,0
11064,0,0,0,0,0
52290,0,0,0,0,0
111895,0,0,0,0,0
49246,0,0,0,0,0
15824,0,0,0,0,0
7631,0,0,0,0,0
73008,0,0,0,0,0
80254,0,0,0,0,0
1591,0,0,0,0,0
108730,0,0,0,0,0
83006,0,0,0,0,0
2880,0,0,0,0,0
14844,0,0,0,0,0
65265,0,0,0,0,0
55644,0,0,0,0,0
85663,0,0,0,0,0
43969,0,0,0,0,0
47860,0,0,0,0,0
5913,0,0,0,0,0
83101,0,0,0,0,0
6969,0,0,0,0,0
8457,0,0,0,0,0
95134,0,0,0,0,0
58782,0,0,0,0,0
110744,0,0,0,0,0
99181,0,0,0,0,0
33998,0,0,0,0,0
64237,0,0,0,0,0
52190,1,1,1,0,0
82909,0,0,0,0,0
38646,0,0,0,0,0
115009,0,0,0,0,0
27813,0,0,0,0,0
678,0,0,0,0,0
117733,0,0,0,0,0
112462,0,0,0,0,0
4467,2,2,2,0,0
81827,0,0,0,0,0
118636,0,0,0,0,0
25958,5,5,5,0,0
43964,0,0,0,0,0
37497,0,0,0,0,0
62697,0,0,0,0,0
71021,0,0,0,0,0
19760,0,0,0,0,0
115840,0,0,0,0,0
41368,0,0,0,0,0
66238,0,0,0,0,0
72049,0,0,0,0,0
50596,0,0,0,0,0
77063,0,0,0,0,0
79615,0,0,0,0,0
10421,0,0,0,0,0
7258,0,0,0,0,0
40224,0,0,0,0,0
10960,0,0,0,0,0
50987,8,8,8,0,0
54085,0,0,0,0,0
31549,0,0,0,0,0
62188,0,0,0,0,0
1059,0,0,0,0,0
116118,0,0,0,0,0
84577,0,0,0,0,0
24954,0,0,0,0,0
46139,0,0,0,0,0
59653,0,0,0,0,0
95243,0,0,0,0,0
81694,0,0,0,0,0
40781,0,0,0,0,0
5879,0,0,0,0,0
15612,0,0,0,0,0
101257,0,0,0,0,0
34,0,0,0,0,0
78177,0,0,0,0,0
102006,0,0,0,0,0
47206,0,0,0,0,0
58104,0,0,0,0,0
63001,0,0,0,0,0
76386,0,0,0,0,0
534,0,0,0,0,0
36262,0,0,0,0,0
6866,0,0,0,0,0
10443,0,0,0,0,0
103618,0,0,0,0,0
1775,0,0,0,0,0
49612,0,0,0,0,0
75507,0,0,0,0,0
33361,0,0,0,0,0
15802,2,2,2,0,0
58933,0,0,0,0,0
70090,0,0,0,0,0
21289,0,0,0,0,0
33601,0,0,0,0,0
47884,0,0,0,0,0
73653,0,0,0,0,0
30533,0,0,0,0,0
20404,0,0,0,0,0
74073,0,0,0,0,0
26183,0,0,0,0,0
97870,0,0,0,0,0
43442,0,0,0,0,0
46205,0,0,0,0,0
72568,0,0,0,0,0
85204,0,0,0,0,0
1683,0,0,0,0,0
114172,0,0,0,0,0
32785,0,0,0,0,0
110404,0,0,0,0,0
89104,0,0,0,0,0
90713,0,0,0,0,0
92593,0,0,0,0,0
88379,0,0,0,0,0
116774,0,0,0,0,0
36192,0,0,0,0,0
101557,0,0,0,0,0
106088,0,0,0,0,0
63425,0,0,0,0,0
107038,0,0,0,0,0
48482,0,0,0,0,0
70621,0,0,0,0,0
18681,0,0,0,0,0
49592,0,0,0,0,0
94390,0,0,0,0,0
118466,0,0,0,0,0
104120,0,0,0,0,0
18698,0,0,0,0,0
37877,0,0,0,0,0
111357,0,0,0,0,0
61257,0,0,0,0,0
21279,0,0,0,0,0
23400,0,0,0,0,0
109108,0,0,0,0,0
3081,0,0,0,0,0
85288,0,0,0,0,0
29660,0,0,0,0,0
97728,0,0,0,0,0
114471,0,0,0,0,0
56320,0,0,0,0,0
71788,0,0,0,0,0
36421,0,0,0,0,0
4677,0,0,0,0,0
113941,0,0,0,0,0
3885,0,0,0,0,0
43856,0,0,0,0,0
94600,0,0,0,0,0
115892,0,0,0,0,0
94154,0,0,0,0,0
60319,0,0,0,0,0
111192,0,0,0,0,0
31354,0,0,0,0,0
30647,0,0,0,0,0
105255,0,0,0,0,0
56898,0,0,0,0,0
59452,0,0,0,0,0
40540,0,0,0,0,0
56466,0,0,0,0,0
111399,0,0,0,0,0
84764,0,0,0,0,0
52325,0,0,0,0,0
3693,1,1,1,0,0
6781,0,0,0,0,0
67746,0,0,0,0,0
34245,0,0,0,0,0
15881,0,0,0,0,0
97826,0,0,0,0,0
26505,0,0,0,0,0
105479,0,0,0,0,0
33191,0,0,0,0,0
111065,0,0,0,0,0
112833,0,0,0,0,0
67046,3,3,3,0,0
104731,0,0,0,0,0
14863,0,0,0,0,0
74027,0,0,0,0,0
119972,0,0,0,0,0
48270,0,0,0,0,0
115590,0,0,0,0,0
42206,0,0,0,0,0
115580,0,0,0,0,0
7484,0,0,0,0,0
47907,0,0,0,0,0
5510,0,0,0,0,0
117445,0,0,0,0,0
26729,0,0,0,0,0
54311,0,0,0,0,0
19253,0,0,0,0,0
72277,0,0,0,0,0
103425,0,0,0,0,0
58448,0,0,0,0,0
117698,0,0,0,0,0
2332,0,0,0,0,0
5980,0,0,0,0,0
95568,0,0,0,0,0
68416,0,0,0,0,0
101905,0,0,0,0,0
106635,0,0,0,0,0
67565,0,0,0,0,0
118534,0,0,0,0,0
56163,0,0,0,0,0
56173,0,0,0,0,0
5910,0,0,0,0,0
67159,0,0,0,0,0
7832,0,0,0,0,0
43035,0,0,0,0,0
43444,0,0,0,0,0
62977,0,0,0,0,0
69678,0,0,0,0,0
2349,0,0,0,0,0
54748,0,0,0,0,0
47441,0,0,0,0,0
13105,0,0,0,0,0
18684,0,0,0,0,0
14035,0,0,0,0,0
86642,0,0,0,0,0
92901,0,0,0,0,0
115052,0,0,0,0,0
62560,0,0,0,0,0
101769,0,0,0,0,0
83948,0,0,0,0,0
52481,0,0,0,0,0
77709,0,0,0,0,0
109912,0,0,0,0,0
60725,0,0,0,0,0
34232,0,0,0,0,0
117914,0,0,0,0,0
41241,0,0,0,0,0
119887,0,0,0,0,0
55862,0,0,0,0,0
42125,0,0,0,0,0
110444,0,0,0,0,0
104718,0,0,0,0,0
72696,0,0,0,0,0
54801,0,0,0,0,0
22674,0,0,0,0,0
60962,0,0,0,0,0
9602,0,0,0,0,0
39031,0,0,0,0,0
59396,0,0,0,0,0
107229,0,0,0,0,0
65207,0,0,0,0,0
107014,0,0,0,0,0
46621,0,0,0,0,0
83659,0,0,0,0,0
11455,0,0,0,0,0
66665,0,0,0,0,0
28264,0,0,0,0,0
5385,0,0,0,0,0
109124,0,0,0,0,0
9181,0,0,0,0,0
58965,0,0,0,0,0
44033,0,0,0,0,0
83024,0,0,0,0,0
107885,1,1,1,0,0
102644,0,0,0,0,0
1984,0,0,0,0,0
96095,0,0,0,0,0
76608,0,0,0,0,0
84064,0,0,0,0,0
59277,0,0,0,0,0
114422,0,0,0,0,0
99249,0,0,0,0,0
111248,0,0,0,0,0
8571,0,0,0,0,0
90499,0,0,0,0,0
38602,0,0,0,0,0
104065,0,0,0,0,0
97640,0,0,0,0,0
98016,0,0,0,0,0
30336,0,0,0,0,0
95752,0,0,0,0,0
21317,0,0,0,0,0
33126,0,0,0,0,0
48666,0,0,0,0,0
58578,0,0,0,0,0
71854,0,0,0,0,0
32250,0,0,0,0,0
91115,0,0,0,0,0
113545,0,0,0,0,0
113170,0,0,0,0,0
66724,0,0,0,0,0
43040,0,0,0,0,0
70036,0,0,0,0,0
46126,0,0,0,0,0
10862,0,0,0,0,0
68979,0,0,0,0,0
61745,0,0,0,0,0
18384,0,0,0,0,0
39933,0,0,0,0,0
51438,0,0,0,0,0
19929,0,0,0,0,0
1707,0,0,0,0,0
119883,0,0,0,0,0
45527,0,0,0,0,0
21570,0,0,0,0,0
86242,0,0,0,0,0
64616,0,0,0,0,0
1811,0,0,0,0,0
20577,0,0,0,0,0
76917,0,0,0,0,0
1914,0,0,0,0,0
117243,0,0,0,0,0
100922,0,0,0,0,0
88856,0,0,0,0,0
102326,0,0,0,0,0
92917,0,0,0,0,0
961,0,0,0,0,0
100576,0,0,0,0,0
34915,0,0,0,0,0
12633,0,0,0,0,0
28326,0,0,0,0,0
91034,0,0,0,0,0
1361,0,0,0,0,0
114279,0,0,0,0,0
69102,0,0,0,0,0
66062,0,0,0,0,0
114341,2,2,2,0,0
10260,0,0,0,0,0
57206,0,0,0,0,0
28663,0,0,0,0,0
55007,0,0,0,0,0
69264,0,0,0,0,0
105058,0,0,0,0,0
73436,0,0,0,0,0
87771,0,0,0,0,0
83977,0,0,0,0,0
44904,0,0,0,0,0
115478,0,0,0,0,0
26839,0,0,0,0,0
68324,0,0,0,0,0
60627,0,0,0,0,0
111562,0,0,0,0,0
33032,0,0,0,0,0
16976,0,0,0,0,0
116077,0,0,0,0,0
37370,0,0,0,0,0
86873,0,0,0,0,0
93014,0,0,0,0,0
110030,0,0,0,0,0
91972,0,0,0,0,0
95164,0,0,0,0,0
1685,0,0,0,0,0
2561,0,0,0,0,0
9099,0,0,0,0,0
4309,1,1,1,0,0
92132,0,0,0,0,0
11276,0,0,0,0,0
72481,0,0,0,0,0
97055,0,0,0,0,0
115613,0,0,0,0,0
84178,0,0,0,0,0
92507,0,0,0,0,0
41088,0,0,0,0,0
69436,0,0,0,0,0
26670,0,0,0,0,0
8438,0,0,0,0,0
59587,0,0,0,0,0
104678,1,1,1,0,0
80591,0,0,0,0,0
13565,0,0,0,0,0
120102,0,0,0,0,0
86828,0,0,0,0,0
85867,0,0,0,0,0
51832,0,0,0,0,0
114428,0,0,0,0,0
67944,0,0,0,0,0
38797,0,0,0,0,0
1938,0,0,0,0,0
65222,0,0,0,0,0
56429,0,0,0,0,0
23796,0,0,0,0,0
86787,0,0,0,0,0
21941,0,0,0,0,0
57359,0,0,0,0,0
31459,0,0,0,0,0
55047,0,0,0,0,0
107516,0,0,0,0,0
24347,0,0,0,0,0
93038,0,0,0,0,0
65300,0,0,0,0,0
99141,0,0,0,0,0
28939,0,0,0,0,0
42346,0,0,0,0,0
72336,0,0,0,0,0
62625,0,0,0,0,0
37476,0,0,0,0,0
62391,0,0,0,0,0
22153,0,0,0,0,0
24962,0,0,0,0,0
104552,0,0,0,0,0
94858,0,0,0,0,0
103685,0,0,0,0,0
32880,0,0,0,0,0
11898,0,0,0,0,0
75991,0,0,0,0,0
111775,0,0,0,0,0
32257,0,0,0,0,0
98662,0,0,0,0,0
14052,0,0,0,0,0
80904,0,0,0,0,0
93950,0,0,0,0,0
73682,0,0,0,0,0
23222,0,0,0,0,0
103961,0,0,0,0,0
17840,0,0,0,0,0
119735,0,0,0,0,0
119302,0,0,0,0,0
74245,0,0,0,0,0
96865,0,0,0,0,0
77288,0,0,0,0,0
111840,0,0,0,0,0
18167,0,0,0,0,0
116769,0,0,0,0,0
112038,0,0,0,0,0
113537,0,0,0,0,0
108986,0,0,0,0,0
27130,0,0,0,0,0
5279,0,0,0,0,0
107674,0,0,0,0,0
97847,0,0,0,0,0
45754,0,0,0,0,0
21388,0,0,0,0,0
55567,0,0,0,0,0
5326,0,0,0,0,0
72784,0,0,0,0,0
43460,0,0,0,0,0
118986,0,0,0,0,0
93433,0,0,0,0,0
108912,1,1,1,0,0
86634,0,0,0,0,0
89162,0,0,0,0,0
4661,0,0,0,0,0
29767,0,0,0,0,0
108265,0,0,0,0,0
50410,0,0,0,0,0
6909,0,0,0,0,0
73852,0,0,0,0,0
58387,0,0,0,0,0
22617,0,0,0,0,0
13369,2,2,2,0,0
1951,0,0,0,0,0
54654,0,0,0,0,0
98628,0,0,0,0,0
10612,0,0,0,0,0
21719,0,0,0,0,0
85705,0,0,0,0,0
34430,0,0,0,0,0
19633,0,0,0,0,0
119795,0,0,0,0,0
46893,0,0,0,0,0
29716,0,0,0,0,0
99885,0,0,0,0,0
12040,0,0,0,0,0
62477,0,0,0,0,0
57781,0,0,0,0,0
47284,0,0,0,0,0
157,0,0,0,0,0
82803,0,0,0,0,0
119506,0,0,0,0,0
99499,0,0,0,0,0
94210,0,0,0,0,0
40525,0,0,0,0,0
28809,0,0,0,0,0
28437,0,0,0,0,0
53070,0,0,0,0,0
13454,0,0,0,0,0
92249,0,0,0,0,0
30082,0,0,0,0,0
60818,0,0,0,0,0
65575,0,0,0,0,0
64560,0,0,0,0,0
117608,0,0,0,0,0
111954,0,0,0,0,0
6887,0,0,0,0,0
98199,0,0,0,0,0
21190,0,0,0,0,0
40418,0,0,0,0,0
59613,0,0,0,0,0
30560,0,0,0,0,0
45307,0,0,0,0,0
90145,0,0,0,0,0
12859,0,0,0,0,0
73563,0,0,0,0,0
11970,0,0,0,0,0
70250,0,0,0,0,0
109404,0,0,0,0,0
76864,0,0,0,0,0
58486,0,0,0,0,0
42249,0,0,0,0,0
72700,0,0,0,0,0
67364,0,0,0,0,0
15038,0,0,0,0,0
89555,0,0,0,0,0
54259,0,0,0,0,0
80014,0,0,0,0,0
68343,0,0,0,0,0
117889,0,0,0,0,0
36716,0,0,0,0,0
65516,0,0,0,0,0
91999,0,0,0,0,0
39163,0,0,0,0,0
30725,0,0,0,0,0
11828,0,0,0,0,0
113756,0,0,0,0,0
20555,0,0,0,0,0
40167,0,0,0,0,0
105993,0,0,0,0,0
92361,0,0,0,0,0
110598,0,0,0,0,0
4091,0,0,0,0,0
48284,0,0,0,0,0
2055,0,0,0,0,0
115251,0,0,0,0,0
51183,0,0,0,0,0
33501,0,0,0,0,0
32095,0,0,0,0,0
94468,0,0,0,0,0
84108,0,0,0,0,0
17376,0,0,0,0,0
71687,0,0,0,0,0
62966,0,0,0,0,0
84701,0,0,0,0,0
2020,0,0,0,0,0
55587,0,0,0,0,0
63450,0,0,0,0,0
25863,0,0,0,0,0
34276,0,0,0,0,0
46347,0,0,0,0,0
79375,0,0,0,0,0
89722,0,0,0,0,0
50182,0,0,0,0,0
38272,0,0,0,0,0
94332,0,0,0,0,0
96337,0,0,0,0,0
115303,0,0,0,0,0
118827,0,0,0,0,0
112162,0,0,0,0,0
61696,0,0,0,0,0
27250,0,0,0,0,0
64332,0,0,0,0,0
16136,4,4,4,0,0
51092,0,0,0,0,0
74990,0,0,0,0,0
26310,0,0,0,0,0
68484,0,0,0,0,0
74515,0,0,0,0,0
107136,0,0,0,0,0
90216,0,0,0,0,0
58632,0,0,0,0,0
120529,0,0,0,0,0
81070,0,0,0,0,0
44013,0,0,0,0,0
63410,0,0,0,0,0
81403,0,0,0,0,0
14975,0,0,0,0,0
47570,0,0,0,0,0
6173,0,0,0,0,0
97492,0,0,0,0,0
100914,0,0,0,0,0
97615,0,0,0,0,0
12295,0,0,0,0,0
84909,0,0,0,0,0
24034,0,0,0,0,0
78785,0,0,0,0,0
28919,0,0,0,0,0
93646,0,0,0,0,0
95422,2,2,2,0,0
104912,0,0,0,0,0
66364,0,0,0,0,0
7067,0,0,0,0,0
56380,0,0,0,0,0
29173,0,0,0,0,0
97101,0,0,0,0,0
12277,0,0,0,0,0
100158,0,0,0,0,0
108827,0,0,0,0,0
26111,0,0,0,0,0
57392,0,0,0,0,0
15883,3,3,3,0,0
3383,0,0,0,0,0
24663,0,0,0,0,0
58502,0,0,0,0,0
32266,0,0,0,0,0
98870,0,0,0,0,0
112610,0,0,0,0,0
74783,0,0,0,0,0
90793,0,0,0,0,0
114681,0,0,0,0,0
49518,0,0,0,0,0
40978,0,0,0,0,0
88845,2,2,2,0,0
74455,0,0,0,0,0
52480,0,0,0,0,0
69966,0,0,0,0,0
19273,0,0,0,0,0
151,0,0,0,0,0
62889,0,0,0,0,0
69462,0,0,0,0,0
30420,0,0,0,0,0
56514,0,0,0,0,0
18316,0,0,0,0,0
76633,0,0,0,0,0
120180,0,0,0,0,0
102577,0,0,0,0,0
30109,0,0,0,0,0
64872,0,0,0,0,0
24159,0,0,0,0,0
43045,0,0,0,0,0
17692,0,0,0,0,0
102645,0,0,0,0,0
28980,0,0,0,0,0
88315,0,0,0,0,0
13145,0,0,0,0,0
84798,0,0,0,0,0
27764,0,0,0,0,0
107324,0,0,0,0,0
512,0,0,0,0,0
111321,0,0,0,0,0
25497,0,0,0,0,0
86500,0,0,0,0,0
104352,0,0,0,0,0
47245,0,0,0,0,0
47731,0,0,0,0,0
120559,0,0,0,0,0
42268,0,0,0,0,0
9135,0,0,0,0,0
87550,0,0,0,0,0
59311,0,0,0,0,0
242,0,0,0,0,0
42930,0,0,0,0,0
77134,0,0,0,0,0
85499,0,0,0,0,0
61481,0,0,0,0,0
5806,0,0,0,0,0
11380,0,0,0,0,0
22599,0,0,0,0,0
49407,0,0,0,0,0
69367,0,0,0,0,0
31621,0,0,0,0,0
64162,0,0,0,0,0
10429,0,0,0,0,0
106346,0,0,0,0,0
25134,0,0,0,0,0
90440,0,0,0,0,0
75544,0,0,0,0,0
69424,0,0,0,0,0
87739,0,0,0,0,0
115814,0,0,0,0,0
62958,0,0,0,0,0
35455,0,0,0,0,0
31059,0,0,0,0,0
102525,0,0,0,0,0
24384,0,0,0,0,0
50287,0,0,0,0,0
95154,0,0,0,0,0
85224,0,0,0,0,0
1514,0,0,0,0,0
40446,0,0,0,0,0
36663,0,0,0,0,0
34375,0,0,0,0,0
93980,0,0,0,0,0
69566,0,0,0,0,0
64543,0,0,0,0,0
42791,0,0,0,0,0
637,0,0,0,0,0
29084,0,0,0,0,0
49396,0,0,0,0,0
69587,0,0,0,0,0
104043,0,0,0,0,0
51798,0,0,0,0,0
57231,0,0,0,0,0
41505,0,0,0,0,0
77568,0,0,0,0,0
67244,0,0,0,0,0
63488,0,0,0,0,0
76128,0,0,0,0,0
31381,0,0,0,0,0
116055,0,0,0,0,0
58335,0,0,0,0,0
108366,0,0,0,0,0
10652,0,0,0,0,0
36071,0,0,0,0,0
84124,0,0,0,0,0
9214,0,0,0,0,0
6905,0,0,0,0,0
77844,0,0,0,0,0
8263,0,0,0,0,0
105864,0,0,0,0,0
8497,0,0,0,0,0
80467,0,0,0,0,0
24430,0,0,0,0,0
30994,0,0,0,0,0
93381,0,0,0,0,0
26880,0,0,0,0,0
95607,0,0,0,0,0
25611,0,0,0,0,0
53050,0,0,0,0,0
80614,0,0,0,0,0
4449,0,0,0,0,0
8641,0,0,0,0,0
91498,0,0,0,0,0
51480,0,0,0,0,0
22546,0,0,0,0,0
51873,0,0,0,0,0
119730,0,0,0,0,0
61625,0,0,0,0,0
28470,0,0,0,0,0
98304,0,0,0,0,0
111624,0,0,0,0,0
3731,0,0,0,0,0
40375,0,0,0,0,0
60432,0,0,0,0,0
96016,0,0,0,0,0
67392,0,0,0,0,0
43109,0,0,0,0,0
64883,0,0,0,0,0
75909,0,0,0,0,0
87868,0,0,0,0,0
54321,0,0,0,0,0
68701,0,0,0,0,0
114732,0,0,0,0,0
17791,0,0,0,0,0
100331,0,0,0,0,0
96991,0,0,0,0,0
120066,1,1,1,0,0
95193,0,0,0,0,0
99060,0,0,0,0,0
98098,0,0,0,0,0
25326,0,0,0,0,0
38508,0,0,0,0,0
52445,0,0,0,0,0
75157,0,0,0,0,0
87767,2,2,2,0,0
117886,0,0,0,0,0
7243,0,0,0,0,0
77938,0,0,0,0,0
4429,0,0,0,0,0
16391,0,0,0,0,0
98233,0,0,0,0,0
82216,0,0,0,0,0
37558,0,0,0,0,0
36977,0,0,0,0,0
14108,0,0,0,0,0
30630,0,0,0,0,0
80210,0,0,0,0,0
106894,0,0,0,0,0
28177,0,0,0,0,0
63748,0,0,0,0,0
65741,0,0,0,0,0
28162,0,0,0,0,0
86881,0,0,0,0,0
66381,0,0,0,0,0
33110,0,0,0,0,0
110601,0,0,0,0,0
105694,0,0,0,0,0
68086,0,0,0,0,0
40679,0,0,0,0,0
78815,0,0,0,0,0
9649,0,0,0,0,0
57870,0,0,0,0,0
104851,0,0,0,0,0
95944,0,0,0,0,0
51222,0,0,0,0,0
92679,0,0,0,0,0
70295,0,0,0,0,0
31901,0,0,0,0,0
52385,0,0,0,0,0
115970,0,0,0,0,0
29677,0,0,0,0,0
47219,0,0,0,0,0
47039,0,0,0,0,0
82709,0,0,0,0,0
95057,0,0,0,0,0
35624,0,0,0,0,0
22532,0,0,0,0,0
1500,0,0,0,0,0
61116,0,0,0,0,0
33257,0,0,0,0,0
112784,0,0,0,0,0
9232,0,0,0,0,0
39223,0,0,0,0,0
24333,0,0,0,0,0
102878,0,0,0,0,0
110314,0,0,0,0,0
72576,0,0,0,0,0
56767,0,0,0,0,0
114084,0,0,0,0,0
46826,0,0,0,0,0
107009,0,0,0,0,0
72747,0,0,0,0,0
99058,0,0,0,0,0
3358,0,0,0,0,0
31214,0,0,0,0,0
106671,0,0,0,0,0
13280,0,0,0,0,0
112978,0,0,0,0,0
94511,0,0,0,0,0
5415,0,0,0,0,0
23327,0,0,0,0,0
73510,0,0,0,0,0
66211,0,0,0,0,0
35160,0,0,0,0,0
58972,0,0,0,0,0
68660,0,0,0,0,0
50695,0,0,0,0,0
119805,0,0,0,0,0
97073,0,0,0,0,0
33741,0,0,0,0,0
95311,0,0,0,0,0
9543,0,0,0,0,0
97470,0,0,0,0,0
52606,0,0,0,0,0
109669,0,0,0,0,0
50300,0,0,0,0,0
68737,0,0,0,0,0
23250,0,0,0,0,0
98437,0,0,0,0,0
71623,0,0,0,0,0
116879,0,0,0,0,0
92486,0,0,0,0,0
25080,0,0,0,0,0
2823,0,0,0,0,0
102707,0,0,0,0,0
89473,0,0,0,0,0
69262,0,0,0,0,0
73990,0,0,0,0,0
57505,2,2,2,0,0
13444,0,0,0,0,0
17423,0,0,0,0,0
102192,0,0,0,0,0
107492,0,0,0,0,0
10215,0,0,0,0,0
88974,0,0,0,0,0
18208,0,0,0,0,0
97673,0,0,0,0,0
43214,0,0,0,0,0
14734,0,0,0,0,0
100467,0,0,0,0,0
36583,0,0,0,0,0
67605,0,0,0,0,0
43977,0,0,0,0,0
95543,0,0,0,0,0
105838,0,0,0,0,0
98519,0,0,0,0,0
103919,0,0,0,0,0
71394,0,0,0,0,0
17315,0,0,0,0,0
100377,0,0,0,0,0
57054,0,0,0,0,0
72102,0,0,0,0,0
92161,0,0,0,0,0
12242,0,0,0,0,0
106564,0,0,0,0,0
46298,0,0,0,0,0
40041,0,0,0,0,0
90396,0,0,0,0,0
20517,0,0,0,0,0
52221,0,0,0,0,0
53319,0,0,0,0,0
54414,0,0,0,0,0
95142,0,0,0,0,0
4770,0,0,0,0,0
81269,0,0,0,0,0
62093,0,0,0,0,0
5592,0,0,0,0,0
71618,0,0,0,0,0
55375,0,0,0,0,0
91064,0,0,0,0,0
105676,0,0,0,0,0
104740,0,0,0,0,0
108526,0,0,0,0,0
88235,0,0,0,0,0
13181,0,0,0,0,0
87608,0,0,0,0,0
107140,0,0,0,0,0
104708,0,0,0,0,0
84538,0,0,0,0,0
84102,0,0,0,0,0
85677,0,0,0,0,0
72523,0,0,0,0,0
13716,0,0,0,0,0
2202,0,0,0,0,0
31357,0,0,0,0,0
90842,0,0,0,0,0
6490,0,0,0,0,0
69312,0,0,0,0,0
59909,0,0,0,0,0
56692,0,0,0,0,0
68540,1,1,1,0,0
32108,0,0,0,0,0
24144,0,0,0,0,0
46490,0,0,0,0,0
19205,0,0,0,0,0
1867,0,0,0,0,0
77333,0,0,0,0,0
77757,0,0,0,0,0
17038,0,0,0,0,0
80367,0,0,0,0,0
108659,0,0,0,0,0
95190,0,0,0,0,0
57593,0,0,0,0,0
101703,0,0,0,0,0
51691,0,0,0,0,0
71240,0,0,0,0,0
106779,0,0,0,0,0
75232,0,0,0,0,0
63434,0,0,0,0,0
117530,0,0,0,0,0
4540,0,0,0,0,0
38658,0,0,0,0,0
2636,0,0,0,0,0
102874,0,0,0,0,0
1443,0,0,0,0,0
49658,0,0,0,0,0
38064,1,1,1,0,0
56970,0,0,0,0,0
116725,0,0,0,0,0
37724,0,0,0,0,0
17915,0,0,0,0,0
71503,0,0,0,0,0
117511,0,0,0,0,0
1602,0,0,0,0,0
3057,0,0,0,0,0
116095,0,0,0,0,0
80957,0,0,0,0,0
29311,0,0,0,0,0
15904,0,0,0,0,0
10890,0,0,0,0,0
22089,0,0,0,0,0
11417,2,2,2,0,0
103585,7,7,7,0,0
61998,0,0,0,0,0
45567,0,0,0,0,0
55112,0,0,0,0,0
6426,0,0,0,0,0
118309,0,0,0,0,0
99327,0,0,0,0,0
64324,0,0,0,0,0
22889,0,0,0,0,0
695,0,0,0,0,0
92277,0,0,0,0,0
5202,0,0,0,0,0
54620,0,0,0,0,0
110890,0,0,0,0,0
100154,0,0,0,0,0
13578,0,0,0,0,0
111622,0,0,0,0,0
115723,0,0,0,0,0
90758,0,0,0,0,0
76056,0,0,0,0,0
113233,0,0,0,0,0
2620,0,0,0,0,0
16013,0,0,0,0,0
19768,0,0,0,0,0
27138,0,0,0,0,0
104386,0,0,0,0,0
37163,0,0,0,0,0
54614,0,0,0,0,0
117866,0,0,0,0,0
109833,0,0,0,0,0
42287,0,0,0,0,0
60010,0,0,0,0,0
101294,0,0,0,0,0
90502,0,0,0,0,0
98426,0,0,0,0,0
36254,0,0,0,0,0
109935,0,0,0,0,0
11074,0,0,0,0,0
4507,0,0,0,0,0
69421,0,0,0,0,0
38219,0,0,0,0,0
31571,0,0,0,0,0
92633,0,0,0,0,0
28380,0,0,0,0,0
4923,0,0,0,0,0
41093,0,0,0,0,0
108511,0,0,0,0,0
104102,0,0,0,0,0
77101,0,0,0,0,0
91455,0,0,0,0,0
8628,0,0,0,0,0
31948,0,0,0,0,0
42238,0,0,0,0,0
103544,0,0,0,0,0
89866,0,0,0,0,0
48608,0,0,0,0,0
73439,0,0,0,0,0
90190,0,0,0,0,0
78340,0,0,0,0,0
93976,0,0,0,0,0
54884,0,0,0,0,0
64193,0,0,0,0,0
88578,0,0,0,0,0
6190,0,0,0,0,0
338,0,0,0,0,0
67873,0,0,0,0,0
24133,0,0,0,0,0
86515,0,0,0,0,0
40867,0,0,0,0,0
76626,0,0,0,0,0
66643,0,0,0,0,0
84362,0,0,0,0,0
72593,0,0,0,0,0
91231,0,0,0,0,0
43756,0,0,0,0,0
52800,0,0,0,0,0
37392,0,0,0,0,0
86087,0,0,0,0,0
78300,0,0,0,0,0
61934,0,0,0,0,0
4313,0,0,0,0,0
108039,0,0,0,0,0
119964,0,0,0,0,0
102264,3,3,3,0,0
70696,0,0,0,0,0
55316,0,0,0,0,0
88527,0,0,0,0,0
112834,0,0,0,0,0
8071,0,0,0,0,0
91567,4,4,4,0,0
60438,0,0,0,0,0
33347,0,0,0,0,0
45469,0,0,0,0,0
81142,0,0,0,0,0
119155,0,0,0,0,0
68909,0,0,0,0,0
91063,0,0,0,0,0
85384,0,0,0,0,0
110183,0,0,0,0,0
9503,0,0,0,0,0
6015,0,0,0,0,0
30956,0,0,0,0,0
95256,0,0,0,0,0
47447,0,0,0,0,0
37317,0,0,0,0,0
70050,0,0,0,0,0
109520,0,0,0,0,0
65408,0,0,0,0,0
89309,0,0,0,0,0
48787,0,0,0,0,0
15797,0,0,0,0,0
101144,0,0,0,0,0
50482,0,0,0,0,0
1167,0,0,0,0,0
9074,0,0,0,0,0
35567,0,0,0,0,0
118372,0,0,0,0,0
119615,0,0,0,0,0
73227,0,0,0,0,0
98516,0,0,0,0,0
38550,0,0,0,0,0
36040,0,0,0,0,0
113329,0,0,0,0,0
22142,0,0,0,0,0
54933,0,0,0,0,0
106866,0,0,0,0,0
41527,0,0,0,0,0
79511,0,0,0,0,0
96254,0,0,0,0,0
67987,0,0,0,0,0
73532,0,0,0,0,0
99886,0,0,0,0,0
37643,0,0,0,0,0
33477,0,0,0,0,0
6668,0,0,0,0,0
37298,0,0,0,0,0
63047,0,0,0,0,0
7989,0,0,0,0,0
23079,0,0,0,0,0
10765,0,0,0,0,0
30104,0,0,0,0,0
95673,0,0,0,0,0
80820,0,0,0,0,0
7753,0,0,0,0,0
48187,0,0,0,0,0
21406,0,0,0,0,0
87721,0,0,0,0,0
82922,0,0,0,0,0
70199,0,0,0,0,0
117357,0,0,0,0,0
51430,0,0,0,0,0
81779,0,0,0,0,0
81098,0,0,0,0,0
77190,0,0,0,0,0
35527,0,0,0,0,0
50739,0,0,0,0,0
35741,0,0,0,0,0
57771,0,0,0,0,0
103874,0,0,0,0,0
67338,1,1,1,0,0
94981,0,0,0,0,0
74295,0,0,0,0,0
81766,0,0,0,0,0
110461,0,0,0,0,0
38532,0,0,0,0,0
85004,0,0,0,0,0
43930,0,0,0,0,0
114816,0,0,0,0,0
111120,0,0,0,0,0
34806,0,0,0,0,0
75371,0,0,0,0,0
114456,0,0,0,0,0
97308,0,0,0,0,0
66625,0,0,0,0,0
37759,1,1,1,0,0
63872,0,0,0,0,0
6746,0,0,0,0,0
44313,0,0,0,0,0
87974,0,0,0,0,0
48943,0,0,0,0,0
112848,0,0,0,0,0
57469,0,0,0,0,0
26189,0,0,0,0,0
76206,0,0,0,0,0
73556,0,0,0,0,0
81890,0,0,0,0,0
102888,0,0,0,0,0
85467,0,0,0,0,0
66854,0,0,0,0,0
28197,0,0,0,0,0
84791,0,0,0,0,0
96052,0,0,0,0,0
68842,0,0,0,0,0
106846,0,0,0,0,0
80064,0,0,0,0,0
19509,0,0,0,0,0
47227,0,0,0,0,0
18039,0,0,0,0,0
83466,0,0,0,0,0
61612,0,0,0,0,0
21460,0,0,0,0,0
44596,0,0,0,0,0
10918,0,0,0,0,0
53202,0,0,0,0,0
17905,0,0,0,0,0
44681,0,0,0,0,0
78872,0,0,0,0,0
102194,0,0,0,0,0
109693,1,1,1,0,0
108390,0,0,0,0,0
33731,0,0,0,0,0
44993,0,0,0,0,0
2891,0,0,0,0,0
102536,0,0,0,0,0
13136,0,0,0,0,0
38101,0,0,0,0,0
62956,0,0,0,0,0
49623,0,0,0,0,0
112069,0,0,0,0,0
69441,0,0,0,0,0
7825,0,0,0,0,0
16758,0,0,0,0,0
106616,0,0,0,0,0
73555,0,0,0,0,0
20663,0,0,0,0,0
51072,0,0,0,0,0
77526,0,0,0,0,0
50124,0,0,0,0,0
32361,0,0,0,0,0
18061,0,0,0,0,0
89215,0,0,0,0,0
81945,0,0,0,0,0
87111,0,0,0,0,0
9741,0,0,0,0,0
54204,0,0,0,0,0
23118,0,0,0,0,0
111275,0,0,0,0,0
75820,0,0,0,0,0
39950,0,0,0,0,0
66982,0,0,0,0,0
47207,0,0,0,0,0
4888,0,0,0,0,0
17741,0,0,0,0,0
6151,0,0,0,0,0
43358,0,0,0,0,0
5680,0,0,0,0,0
38701,0,0,0,0,0
32065,0,0,0,0,0
55780,0,0,0,0,0
101527,0,0,0,0,0
49752,0,0,0,0,0
7686,0,0,0,0,0
83646,0,0,0,0,0
61737,0,0,0,0,0
57780,0,0,0,0,0
54158,0,0,0,0,0
86731,0,0,0,0,0
38671,0,0,0,0,0
42697,0,0,0,0,0
117245,0,0,0,0,0
40740,0,0,0,0,0
3624,0,0,0,0,0
4951,0,0,0,0,0
99322,0,0,0,0,0
98371,0,0,0,0,0
70458,0,0,0,0,0
54481,0,0,0,0,0
46691,0,0,0,0,0
66032,0,0,0,0,0
60945,0,0,0,0,0
90121,0,0,0,0,0
567,0,0,0,0,0
5286,0,0,0,0,0
73303,0,0,0,0,0
95660,0,0,0,0,0
110356,0,0,0,0,0
46367,0,0,0,0,0
57541,0,0,0,0,0
111847,0,0,0,0,0
77448,0,0,0,0,0
111384,0,0,0,0,0
93157,0,0,0,0,0
110982,0,0,0,0,0
23987,0,0,0,0,0
72466,0,0,0,0,0
3710,0,0,0,0,0
63540,0,0,0,0,0
3863,0,0,0,0,0
101955,0,0,0,0,0
110472,0,0,0,0,0
24021,0,0,0,0,0
63333,0,0,0,0,0
113655,0,0,0,0,0
104199,0,0,0,0,0
62654,0,0,0,0,0
112637,0,0,0,0,0
28089,0,0,0,0,0
29319,0,0,0,0,0
63861,0,0,0,0,0
79864,0,0,0,0,0
83997,0,0,0,0,0
9330,0,0,0,0,0
49482,0,0,0,0,0
7784,0,0,0,0,0
101421,0,0,0,0,0
91865,0,0,0,0,0
34223,0,0,0,0,0
47116,0,0,0,0,0
52225,0,0,0,0,0
73951,0,0,0,0,0
96669,0,0,0,0,0
81645,0,0,0,0,0
59369,0,0,0,0,0
91683,0,0,0,0,0
26836,0,0,0,0,0
21765,0,0,0,0,0
63723,0,0,0,0,0
23625,0,0,0,0,0
112304,0,0,0,0,0
46736,0,0,0,0,0
53860,0,0,0,0,0
7716,0,0,0,0,0
32195,0,0,0,0,0
85829,0,0,0,0,0
92331,0,0,0,0,0
98339,0,0,0,0,0
91636,0,0,0,0,0
53568,0,0,0,0,0
8129,0,0,0,0,0
66680,0,0,0,0,0
2765,0,0,0,0,0
4842,0,0,0,0,0
3724,0,0,0,0,0
25985,0,0,0,0,0
15651,0,0,0,0,0
71963,0,0,0,0,0
20688,0,0,0,0,0
320,0,0,0,0,0
74190,0,0,0,0,0
119063,0,0,0,0,0
115264,0,0,0,0,0
1715,0,0,0,0,0
46460,0,0,0,0,0
61633,0,0,0,0,0
92239,0,0,0,0,0
48910,0,0,0,0,0
87309,0,0,0,0,0
57720,0,0,0,0,0
46242,0,0,0,0,0
1559,0,0,0,0,0
71125,0,0,0,0,0
15673,0,0,0,0,0
634,0,0,0,0,0
55040,0,0,0,0,0
73966,0,0,0,0,0
44019,0,0,0,0,0
10662,0,0,0,0,0
45004,0,0,0,0,0
76907,0,0,0,0,0
7910,0,0,0,0,0
25369,0,0,0,0,0
2988,0,0,0,0,0
5203,0,0,0,0,0
57470,0,0,0,0,0
118680,0,0,0,0,0
14815,0,0,0,0,0
54213,0,0,0,0,0
58065,0,0,0,0,0
37517,0,0,0,0,0
51308,0,0,0,0,0
305,0,0,0,0,0
81684,0,0,0,0,0
104413,0,0,0,0,0
68545,0,0,0,0,0
38175,0,0,0,0,0
68976,0,0,0,0,0
106729,0,0,0,0,0
25233,0,0,0,0,0
190,0,0,0,0,0
49508,0,0,0,0,0
22808,0,0,0,0,0
105828,0,0,0,0,0
49499,0,0,0,0,0
64548,0,0,0,0,0
65687,0,0,0,0,0
26197,0,0,0,0,0
35028,0,0,0,0,0
19529,0,0,0,0,0
59036,0,0,0,0,0
27381,0,0,0,0,0
14028,0,0,0,0,0
91018,0,0,0,0,0
48839,0,0,0,0,0
8672,0,0,0,0,0
23682,0,0,0,0,0
105608,0,0,0,0,0
13882,0,0,0,0,0
78829,0,0,0,0,0
60058,0,0,0,0,0
47087,0,0,0,0,0
8391,0,0,0,0,0
94037,0,0,0,0,0
120588,0,0,0,0,0
37200,0,0,0,0,0
51989,0,0,0,0,0
59603,0,0,0,0,0
91360,0,0,0,0,0
12402,0,0,0,0,0
13538,0,0,0,0,0
28891,0,0,0,0,0
57607,1,1,1,0,0
72506,0,0,0,0,0
29000,0,0,0,0,0
91681,0,0,0,0,0
712,0,0,0,0,0
26301,0,0,0,0,0
107887,0,0,0,0,0
24484,0,0,0,0,0
42612,0,0,0,0,0
107279,0,0,0,0,0
94000,0,0,0,0,0
72417,0,0,0,0,0
7203,0,0,0,0,0
52855,2,2,2,0,0
82648,0,0,0,0,0
59661,0,0,0,0,0
9136,0,0,0,0,0
97968,0,0,0,0,0
92681,0,0,0,0,0
28654,0,0,0,0,0
56110,0,0,0,0,0
25308,0,0,0,0,0
52930,0,0,0,0,0
15722,0,0,0,0,0
42136,0,0,0,0,0
48503,0,0,0,0,0
111338,0,0,0,0,0
105800,0,0,0,0,0
57731,0,0,0,0,0
17285,0,0,0,0,0
55915,0,0,0,0,0
61981,0,0,0,0,0
22814,0,0,0,0,0
73919,0,0,0,0,0
60112,0,0,0,0,0
2356,0,0,0,0,0
11258,0,0,0,0,0
27922,0,0,0,0,0
78292,0,0,0,0,0
79031,0,0,0,0,0
55188,0,0,0,0,0
9335,0,0,0,0,0
14663,0,0,0,0,0
38171,0,0,0,0,0
88165,0,0,0,0,0
18130,0,0,0,0,0
63969,0,0,0,0,0
109982,0,0,0,0,0
33410,0,0,0,0,0
39662,0,0,0,0,0
42813,0,0,0,0,0
80147,0,0,0,0,0
40748,0,0,0,0,0
68346,0,0,0,0,0
24604,0,0,0,0,0
28962,0,0,0,0,0
59825,0,0,0,0,0
32807,0,0,0,0,0
51561,0,0,0,0,0
61200,0,0,0,0,0
75494,0,0,0,0,0
35663,0,0,0,0,0
65281,0,0,0,0,0
44751,0,0,0,0,0
61250,0,0,0,0,0
103904,0,0,0,0,0
92293,0,0,0,0,0
101036,0,0,0,0,0
96442,0,0,0,0,0
33971,0,0,0,0,0
44025,0,0,0,0,0
60596,0,0,0,0,0
74053,0,0,0,0,0
61041,0,0,0,0,0
38048,0,0,0,0,0
44146,0,0,0,0,0
19272,0,0,0,0,0
120520,0,0,0,0,0
29143,0,0,0,0,0
66454,0,0,0,0,0
116600,0,0,0,0,0
78330,0,0,0,0,0
70443,0,0,0,0,0
3773,0,0,0,0,0
61421,0,0,0,0,0
32333,0,0,0,0,0
99584,0,0,0,0,0
15836,0,0,0,0,0
60228,0,0,0,0,0
110899,0,0,0,0,0
72684,0,0,0,0,0
1263,0,0,0,0,0
109670,0,0,0,0,0
108531,0,0,0,0,0
86014,0,0,0,0,0
27634,0,0,0,0,0
19695,0,0,0,0,0
31539,0,0,0,0,0
30510,0,0,0,0,0
90356,0,0,0,0,0
88604,0,0,0,0,0
74170,1,1,1,0,0
100356,0,0,0,0,0
29180,0,0,0,0,0
114532,0,0,0,0,0
2038,0,0,0,0,0
28152,0,0,0,0,0
16303,0,0,0,0,0
105718,0,0,0,0,0
98953,0,0,0,0,0
88092,0,0,0,0,0
52906,0,0,0,0,0
115041,0,0,0,0,0
60653,1,1,1,0,0
70805,0,0,0,0,0
28580,0,0,0,0,0
16955,0,0,0,0,0
69474,0,0,0,0,0
78915,0,0,0,0,0
39731,0,0,0,0,0
111049,0,0,0,0,0
64834,0,0,0,0,0
4425,0,0,0,0,0
50372,3,3,3,0,0
101457,0,0,0,0,0
36586,0,0,0,0,0
45962,0,0,0,0,0
1774,0,0,0,0,0
19189,0,0,0,0,0
93140,0,0,0,0,0
9400,0,0,0,0,0
26910,0,0,0,0,0
14692,0,0,0,0,0
31932,0,0,0,0,0
25699,0,0,0,0,0
118816,0,0,0,0,0
4022,0,0,0,0,0
89892,0,0,0,0,0
19079,0,0,0,0,0
43067,0,0,0,0,0
5627,0,0,0,0,0
7218,0,0,0,0,0
112310,0,0,0,0,0
46130,0,0,0,0,0
55370,0,0,0,0,0
45109,0,0,0,0,0
61413,0,0,0,0,0
83128,0,0,0,0,0
100426,5,5,5,0,0
72139,0,0,0,0,0
76683,0,0,0,0,0
36046,0,0,0,0,0
28004,0,0,0,0,0
97499,0,0,0,0,0
55278,0,0,0,0,0
66124,0,0,0,0,0
13721,0,0,0,0,0
72947,0,0,0,0,0
117833,0,0,0,0,0
109708,0,0,0,0,0
78769,0,0,0,0,0
99115,0,0,0,0,0
19998,0,0,0,0,0
95850,0,0,0,0,0
94778,0,0,0,0,0
16131,0,0,0,0,0
46150,0,0,0,0,0
66975,0,0,0,0,0
32320,0,0,0,0,0
91443,0,0,0,0,0
92824,0,0,0,0,0
90893,0,0,0,0,0
16948,0,0,0,0,0
31942,0,0,0,0,0
94366,0,0,0,0,0
66079,0,0,0,0,0
91473,0,0,0,0,0
56011,0,0,0,0,0
108236,0,0,0,0,0
71537,1,1,1,0,0
22697,0,0,0,0,0
2080,0,0,0,0,0
72677,0,0,0,0,0
13825,0,0,0,0,0
90103,0,0,0,0,0
11049,0,0,0,0,0
11766,0,0,0,0,0
104418,0,0,0,0,0
94558,0,0,0,0,0
22396,0,0,0,0,0
105775,0,0,0,0,0
7286,0,0,0,0,0
119407,0,0,0,0,0
107310,0,0,0,0,0
93751,0,0,0,0,0
68718,0,0,0,0,0
32366,0,0,0,0,0
108984,0,0,0,0,0
90366,0,0,0,0,0
26175,0,0,0,0,0
58797,0,0,0,0,0
39297,0,0,0,0,0
98274,0,0,0,0,0
65319,0,0,0,0,0
117276,0,0,0,0,0
102806,0,0,0,0,0
30789,0,0,0,0,0
59075,0,0,0,0,0
73029,0,0,0,0,0
36164,0,0,0,0,0
80968,0,0,0,0,0
94906,0,0,0,0,0
47953,0,0,0,0,0
65649,0,0,0,0,0
103820,0,0,0,0,0
108054,0,0,0,0,0
15382,0,0,0,0,0
85980,0,0,0,0,0
32026,0,0,0,0,0
82171,0,0,0,0,0
119803,0,0,0,0,0
110412,0,0,0,0,0
18588,0,0,0,0,0
89656,0,0,0,0,0
94441,0,0,0,0,0
62593,0,0,0,0,0
34454,0,0,0,0,0
90553,0,0,0,0,0
83651,0,0,0,0,0
101684,0,0,0,0,0
5189,0,0,0,0,0
80919,0,0,0,0,0
32658,0,0,0,0,0
21595,0,0,0,0,0
82766,0,0,0,0,0
58113,0,0,0,0,0
76080,0,0,0,0,0
119785,0,0,0,0,0
105574,0,0,0,0,0
59694,0,0,0,0,0
48585,0,0,0,0,0
29227,0,0,0,0,0
26322,0,0,0,0,0
35784,0,0,0,0,0
102595,0,0,0,0,0
70535,0,0,0,0,0
63860,0,0,0,0,0
102004,0,0,0,0,0
101068,0,0,0,0,0
84009,0,0,0,0,0
16385,0,0,0,0,0
32365,0,0,0,0,0
56772,2,2,2,0,0
93979,0,0,0,0,0
59104,0,0,0,0,0
18568,0,0,0,0,0
38442,0,0,0,0,0
37141,0,0,0,0,0
59354,0,0,0,0,0
92115,0,0,0,0,0
25089,0,0,0,0,0
35341,0,0,0,0,0
88151,0,0,0,0,0
76017,0,0,0,0,0
22240,0,0,0,0,0
17785,0,0,0,0,0
67768,0,0,0,0,0
30656,0,0,0,0,0
48836,2,2,2,0,0
13696,0,0,0,0,0
32198,0,0,0,0,0
11893,0,0,0,0,0
53320,0,0,0,0,0
59393,0,0,0,0,0
44828,0,0,0,0,0
38007,0,0,0,0,0
111168,0,0,0,0,0
78150,0,0,0,0,0
71169,0,0,0,0,0
96313,0,0,0,0,0
36832,0,0,0,0,0
26776,0,0,0,0,0
13689,0,0,0,0,0
104064,0,0,0,0,0
104033,0,0,0,0,0
117924,0,0,0,0,0
27816,0,0,0,0,0
11381,0,0,0,0,0
70402,0,0,0,0,0
57335,0,0,0,0,0
68774,0,0,0,0,0
120385,0,0,0,0,0
86841,0,0,0,0,0
87466,0,0,0,0,0
54951,0,0,0,0,0
66186,0,0,0,0,0
108183,0,0,0,0,0
19530,0,0,0,0,0
13426,0,0,0,0,0
1940,0,0,0,0,0
118979,0,0,0,0,0
34951,0,0,0,0,0
116787,0,0,0,0,0
96876,0,0,0,0,0
13620,0,0,0,0,0
3364,0,0,0,0,0
8848,0,0,0,0,0
30611,0,0,0,0,0
114248,0,0,0,0,0
12726,0,0,0,0,0
115297,0,0,0,0,0
20302,0,0,0,0,0
21365,0,0,0,0,0
90576,0,0,0,0,0
3672,0,0,0,0,0
103288,0,0,0,0,0
79880,0,0,0,0,0
5058,0,0,0,0,0
67387,0,0,0,0,0
52949,0,0,0,0,0
20034,0,0,0,0,0
94240,0,0,0,0,0
119830,0,0,0,0,0
57531,0,0,0,0,0
57060,0,0,0,0,0
66249,0,0,0,0,0
110189,0,0,0,0,0
100060,0,0,0,0,0
51675,0,0,0,0,0
106963,0,0,0,0,0
6464,0,0,0,0,0
102457,0,0,0,0,0
72173,0,0,0,0,0
99427,0,0,0,0,0
92060,0,0,0,0,0
98001,0,0,0,0,0
101552,0,0,0,0,0
52189,0,0,0,0,0
10992,0,0,0,0,0
61856,0,0,0,0,0
106783,0,0,0,0,0
42150,0,0,0,0,0
14673,0,0,0,0,0
52615,0,0,0,0,0
110647,0,0,0,0,0
104815,0,0,0,0,0
111110,0,0,0,0,0
78763,0,0,0,0,0
86081,0,0,0,0,0
62749,0,0,0,0,0
118860,3,3,3,0,0
44421,0,0,0,0,0
7754,0,0,0,0,0
47855,0,0,0,0,0
61115,10,10,10,0,0
29841,0,0,0,0,0
94690,0,0,0,0,0
10472,0,0,0,0,0
62974,0,0,0,0,0
8393,0,0,0,0,0
90451,0,0,0,0,0
102599,0,0,0,0,0
60221,0,0,0,0,0
45902,0,0,0,0,0
20474,0,0,0,0,0
63384,0,0,0,0,0
78471,0,0,0,0,0
102709,0,0,0,0,0
937,0,0,0,0,0
3745,0,0,0,0,0
24720,0,0,0,0,0
13458,0,0,0,0,0
8904,0,0,0,0,0
12155,0,0,0,0,0
21066,0,0,0,0,0
84950,0,0,0,0,0
115037,0,0,0,0,0
77409,0,0,0,0,0
7713,0,0,0,0,0
365,0,0,0,0,0
16167,0,0,0,0,0
15075,0,0,0,0,0
90365,0,0,0,0,0
87483,0,0,0,0,0
35153,0,0,0,0,0
49065,0,0,0,0,0
62034,0,0,0,0,0
76939,0,0,0,0,0
62026,0,0,0,0,0
41985,0,0,0,0,0
61316,0,0,0,0,0
56511,0,0,0,0,0
63209,0,0,0,0,0
79159,4,4,4,0,0
1480,0,0,0,0,0
24125,0,0,0,0,0
34048,0,0,0,0,0
110493,0,0,0,0,0
101017,0,0,0,0,0
43426,0,0,0,0,0
108314,0,0,0,0,0
54435,0,0,0,0,0
43325,0,0,0,0,0
114585,0,0,0,0,0
32607,1,1,1,0,0
90524,0,0,0,0,0
26814,0,0,0,0,0
51965,0,0,0,0,0
35342,0,0,0,0,0
9983,0,0,0,0,0
78842,0,0,0,0,0
16950,0,0,0,0,0
73042,0,0,0,0,0
84044,0,0,0,0,0
8884,0,0,0,0,0
32707,0,0,0,0,0
107475,0,0,0,0,0
103411,0,0,0,0,0
78370,0,0,0,0,0
70540,0,0,0,0,0
79520,0,0,0,0,0
78608,0,0,0,0,0
48635,0,0,0,0,0
104910,0,0,0,0,0
98291,0,0,0,0,0
98716,0,0,0,0,0
77411,0,0,0,0,0
24233,0,0,0,0,0
81810,0,0,0,0,0
93408,0,0,0,0,0
64484,0,0,0,0,0
40536,0,0,0,0,0
1711,0,0,0,0,0
31279,0,0,0,0,0
27010,0,0,0,0,0
219,0,0,0,0,0
14051,0,0,0,0,0
103364,0,0,0,0,0
119460,1,1,1,0,0
76490,0,0,0,0,0
78674,0,0,0,0,0
7958,0,0,0,0,0
9246,0,0,0,0,0
103325,0,0,0,0,0
9113,0,0,0,0,0
69466,0,0,0,0,0
46005,0,0,0,0,0
18397,0,0,0,0,0
105699,1,1,1,0,0
92148,0,0,0,0,0
22360,0,0,0,0,0
845,0,0,0,0,0
3613,0,0,0,0,0
111529,0,0,0,0,0
46053,0,0,0,0,0
11647,0,0,0,0,0
86052,0,0,0,0,0
86750,0,0,0,0,0
55959,0,0,0,0,0
45442,0,0,0,0,0
109137,0,0,0,0,0
92865,0,0,0,0,0
1962,0,0,0,0,0
92398,0,0,0,0,0
85377,0,0,0,0,0
55407,0,0,0,0,0
53049,0,0,0,0,0
59099,0,0,0,0,0
56122,0,0,0,0,0
38397,0,0,0,0,0
20941,0,0,0,0,0
104868,0,0,0,0,0
5735,0,0,0,0,0
99593,0,0,0,0,0
309,0,0,0,0,0
5883,0,0,0,0,0
119219,0,0,0,0,0
62670,0,0,0,0,0
67117,0,0,0,0,0
8520,0,0,0,0,0
87729,0,0,0,0,0
62702,0,0,0,0,0
26498,0,0,0,0,0
95874,0,0,0,0,0
92976,0,0,0,0,0
80872,0,0,0,0,0
40636,0,0,0,0,0
41454,0,0,0,0,0
49904,0,0,0,0,0
102700,0,0,0,0,0
105248,0,0,0,0,0
120496,0,0,0,0,0
120237,1,1,1,0,0
114947,0,0,0,0,0
62730,0,0,0,0,0
78500,0,0,0,0,0
45423,0,0,0,0,0
54154,0,0,0,0,0
2967,0,0,0,0,0
22350,0,0,0,0,0
58095,0,0,0,0,0
52165,0,0,0,0,0
79047,0,0,0,0,0
46975,0,0,0,0,0
112372,0,0,0,0,0
106149,0,0,0,0,0
36436,0,0,0,0,0
80606,0,0,0,0,0
39386,0,0,0,0,0
17229,0,0,0,0,0
92733,0,0,0,0,0
52678,0,0,0,0,0
63433,0,0,0,0,0
33194,0,0,0,0,0
87296,0,0,0,0,0
18454,0,0,0,0,0
30851,0,0,0,0,0
97763,0,0,0,0,0
58936,0,0,0,0,0
55840,0,0,0,0,0
75428,0,0,0,0,0
104363,0,0,0,0,0
85364,0,0,0,0,0
964,0,0,0,0,0
27713,0,0,0,0,0
11496,0,0,0,0,0
84677,0,0,0,0,0
78937,0,0,0,0,0
19802,0,0,0,0,0
29634,0,0,0,0,0
8774,0,0,0,0,0
56402,0,0,0,0,0
3726,0,0,0,0,0
25731,0,0,0,0,0
62425,0,0,0,0,0
70789,0,0,0,0,0
82617,0,0,0,0,0
6611,0,0,0,0,0
91950,0,0,0,0,0
59859,0,0,0,0,0
79324,0,0,0,0,0
14739,0,0,0,0,0
73892,0,0,0,0,0
11136,0,0,0,0,0
2424,0,0,0,0,0
46976,0,0,0,0,0
64047,0,0,0,0,0
88089,0,0,0,0,0
106834,0,0,0,0,0
64042,0,0,0,0,0
78917,0,0,0,0,0
65712,0,0,0,0,0
108386,0,0,0,0,0
106222,0,0,0,0,0
106363,0,0,0,0,0
41387,0,0,0,0,0
8519,0,0,0,0,0
86486,0,0,0,0,0
108725,0,0,0,0,0
78200,0,0,0,0,0
19599,0,0,0,0,0
72803,0,0,0,0,0
8493,0,0,0,0,0
18541,0,0,0,0,0
49404,0,0,0,0,0
43646,0,0,0,0,0
83050,0,0,0,0,0
33445,0,0,0,0,0
75988,0,0,0,0,0
45763,0,0,0,0,0
119058,0,0,0,0,0
100046,0,0,0,0,0
53413,0,0,0,0,0
29619,0,0,0,0,0
18770,0,0,0,0,0
93286,0,0,0,0,0
31912,0,0,0,0,0
39794,0,0,0,0,0
86285,0,0,0,0,0
54431,0,0,0,0,0
23200,0,0,0,0,0
34509,0,0,0,0,0
4400,0,0,0,0,0
107097,1,1,1,0,0
33066,0,0,0,0,0
120433,0,0,0,0,0
64861,0,0,0,0,0
120134,0,0,0,0,0
26730,0,0,0,0,0
17459,0,0,0,0,0
3546,0,0,0,0,0
105588,0,0,0,0,0
107053,0,0,0,0,0
83712,0,0,0,0,0
34402,0,0,0,0,0
116746,0,0,0,0,0
45775,0,0,0,0,0
80413,0,0,0,0,0
58357,0,0,0,0,0
88673,0,0,0,0,0
28864,0,0,0,0,0
92844,0,0,0,0,0
105617,0,0,0,0,0
4280,0,0,0,0,0
108087,0,0,0,0,0
83427,0,0,0,0,0
94296,0,0,0,0,0
75993,0,0,0,0,0
84359,0,0,0,0,0
21131,0,0,0,0,0
53348,0,0,0,0,0
26234,0,0,0,0,0
52719,0,0,0,0,0
61893,0,0,0,0,0
101692,0,0,0,0,0
35775,0,0,0,0,0
82327,0,0,0,0,0
111360,0,0,0,0,0
115309,0,0,0,0,0
89747,0,0,0,0,0
46699,0,0,0,0,0
72150,0,0,0,0,0
79291,0,0,0,0,0
51482,0,0,0,0,0
1821,0,0,0,0,0
111143,0,0,0,0,0
67754,0,0,0,0,0
110696,0,0,0,0,0
59109,0,0,0,0,0
93667,0,0,0,0,0
20901,0,0,0,0,0
7468,0,0,0,0,0
61195,0,0,0,0,0
115920,0,0,0,0,0
6819,0,0,0,0,0
91259,0,0,0,0,0
56121,0,0,0,0,0
74377,0,0,0,0,0
18785,0,0,0,0,0
109353,0,0,0,0,0
36923,0,0,0,0,0
18765,0,0,0,0,0
4416,0,0,0,0,0
62389,0,0,0,0,0
25476,0,0,0,0,0
71083,0,0,0,0,0
38012,0,0,0,0,0
110311,0,0,0,0,0
90384,0,0,0,0,0
104809,0,0,0,0,0
30565,0,0,0,0,0
47319,0,0,0,0,0
925,0,0,0,0,0
119676,0,0,0,0,0
12719,0,0,0,0,0
96128,0,0,0,0,0
12713,0,0,0,0,0
76227,0,0,0,0,0
5719,0,0,0,0,0
85011,0,0,0,0,0
48886,0,0,0,0,0
103146,0,0,0,0,0
89778,0,0,0,0,0
62972,0,0,0,0,0
22443,0,0,0,0,0
53169,0,0,0,0,0
18102,0,0,0,0,0
65889,0,0,0,0,0
29314,0,0,0,0,0
22287,2,2,2,0,0
5749,0,0,0,0,0
54255,0,0,0,0,0
24516,0,0,0,0,0
97845,0,0,0,0,0
98402,0,0,0,0,0
12032,0,0,0,0,0
26398,0,0,0,0,0
119178,0,0,0,0,0
93204,0,0,0,0,0
35632,0,0,0,0,0
69292,0,0,0,0,0
16097,4,4,4,0,0
90439,0,0,0,0,0
75237,0,0,0,0,0
79357,0,0,0,0,0
19531,0,0,0,0,0
90178,0,0,0,0,0
112767,0,0,0,0,0
112799,0,0,0,0,0
59544,0,0,0,0,0
77418,0,0,0,0,0
69172,0,0,0,0,0
85177,0,0,0,0,0
82794,0,0,0,0,0
110390,0,0,0,0,0
12365,0,0,0,0,0
105861,0,0,0,0,0
53494,0,0,0,0,0
7676,0,0,0,0,0
21717,0,0,0,0,0
30442,0,0,0,0,0
52413,0,0,0,0,0
59914,0,0,0,0,0
66746,0,0,0,0,0
23521,0,0,0,0,0
18725,0,0,0,0,0
43432,0,0,0,0,0
116100,1,1,1,0,0
57806,0,0,0,0,0
83473,0,0,0,0,0
118221,0,0,0,0,0
82409,0,0,0,0,0
55359,0,0,0,0,0
82198,0,0,0,0,0
35298,0,0,0,0,0
67002,0,0,0,0,0
19385,0,0,0,0,0
113525,0,0,0,0,0
73342,0,0,0,0,0
21687,0,0,0,0,0
120317,0,0,0,0,0
82143,0,0,0,0,0
64947,0,0,0,0,0
52068,0,0,0,0,0
16313,0,0,0,0,0
71890,0,0,0,0,0
37331,0,0,0,0,0
84686,0,0,0,0,0
99535,0,0,0,0,0
10383,0,0,0,0,0
70084,0,0,0,0,0
13149,0,0,0,0,0
107707,0,0,0,0,0
40368,0,0,0,0,0
18726,0,0,0,0,0
96384,0,0,0,0,0
59206,0,0,0,0,0
52705,0,0,0,0,0
80798,0,0,0,0,0
72454,0,0,0,0,0
38677,0,0,0,0,0
14483,0,0,0,0,0
29829,0,0,0,0,0
15201,0,0,0,0,0
55163,0,0,0,0,0
81680,0,0,0,0,0
108597,0,0,0,0,0
25772,0,0,0,0,0
24591,0,0,0,0,0
85492,0,0,0,0,0
41789,0,0,0,0,0
97262,1,1,1,0,0
45060,0,0,0,0,0
8578,0,0,0,0,0
33536,0,0,0,0,0
118607,0,0,0,0,0
39003,0,0,0,0,0
105192,0,0,0,0,0
33934,0,0,0,0,0
97935,0,0,0,0,0
90277,0,0,0,0,0
56901,0,0,0,0,0
94678,0,0,0,0,0
22780,0,0,0,0,0
99749,0,0,0,0,0
86795,0,0,0,0,0
71440,0,0,0,0,0
27776,0,0,0,0,0
75602,0,0,0,0,0
52876,0,0,0,0,0
6092,0,0,0,0,0
41025,0,0,0,0,0
31981,0,0,0,0,0
31462,0,0,0,0,0
96544,0,0,0,0,0
52635,0,0,0,0,0
24359,0,0,0,0,0
35650,0,0,0,0,0
98785,0,0,0,0,0
30407,0,0,0,0,0
26823,0,0,0,0,0
37039,0,0,0,0,0
98239,0,0,0,0,0
107534,0,0,0,0,0
84548,0,0,0,0,0
37758,0,0,0,0,0
119244,0,0,0,0,0
111237,3,3,3,0,0
47820,0,0,0,0,0
65247,0,0,0,0,0
2526,0,0,0,0,0
51,0,0,0,0,0
10139,0,0,0,0,0
87599,0,0,0,0,0
56690,0,0,0,0,0
16868,0,0,0,0,0
34584,0,0,0,0,0
97716,0,0,0,0,0
52908,0,0,0,0,0
99272,0,0,0,0,0
60463,0,0,0,0,0
66575,0,0,0,0,0
49834,0,0,0,0,0
40739,0,0,0,0,0
72441,0,0,0,0,0
40438,0,0,0,0,0
42511,0,0,0,0,0
68038,0,0,0,0,0
1083,0,0,0,0,0
588,0,0,0,0,0
24001,0,0,0,0,0
67209,0,0,0,0,0
51653,0,0,0,0,0
61910,0,0,0,0,0
13919,0,0,0,0,0
87844,0,0,0,0,0
100064,0,0,0,0,0
119544,0,0,0,0,0
63796,0,0,0,0,0
91785,0,0,0,0,0
50991,0,0,0,0,0
6236,0,0,0,0,0
112968,0,0,0,0,0
55257,0,0,0,0,0
64273,0,0,0,0,0
36545,0,0,0,0,0
39402,0,0,0,0,0
47690,0,0,0,0,0
103458,0,0,0,0,0
28211,0,0,0,0,0
97177,0,0,0,0,0
23316,0,0,0,0,0
117132,0,0,0,0,0
5477,0,0,0,0,0
96492,0,0,0,0,0
94479,0,0,0,0,0
6107,0,0,0,0,0
22648,0,0,0,0,0
61229,0,0,0,0,0
10622,0,0,0,0,0
36371,0,0,0,0,0
101381,0,0,0,0,0
216,0,0,0,0,0
109711,0,0,0,0,0
30580,0,0,0,0,0
84348,0,0,0,0,0
33975,0,0,0,0,0
14416,0,0,0,0,0
6119,0,0,0,0,0
67558,0,0,0,0,0
1197,0,0,0,0,0
25569,0,0,0,0,0
45831,0,0,0,0,0
8640,0,0,0,0,0
106243,0,0,0,0,0
108752,0,0,0,0,0
13759,0,0,0,0,0
70635,0,0,0,0,0
31892,0,0,0,0,0
48362,0,0,0,0,0
91108,0,0,0,0,0
96940,0,0,0,0,0
4439,0,0,0,0,0
24194,0,0,0,0,0
36636,0,0,0,0,0
87949,0,0,0,0,0
51667,0,0,0,0,0
53685,0,0,0,0,0
40711,0,0,0,0,0
103921,0,0,0,0,0
31185,0,0,0,0,0
54804,0,0,0,0,0
61702,0,0,0,0,0
20493,0,0,0,0,0
110376,0,0,0,0,0
64794,0,0,0,0,0
4644,0,0,0,0,0
48145,0,0,0,0,0
75283,0,0,0,0,0
76988,4,4,4,0,0
81631,0,0,0,0,0
109798,0,0,0,0,0
22046,0,0,0,0,0
6073,0,0,0,0,0
117253,0,0,0,0,0
93330,0,0,0,0,0
106503,0,0,0,0,0
58511,0,0,0,0,0
4042,0,0,0,0,0
65518,0,0,0,0,0
37808,0,0,0,0,0
29593,0,0,0,0,0
47636,0,0,0,0,0
46279,0,0,0,0,0
102362,0,0,0,0,0
97114,0,0,0,0,0
67730,0,0,0,0,0
98123,0,0,0,0,0
12222,0,0,0,0,0
89888,0,0,0,0,0
109582,0,0,0,0,0
99139,0,0,0,0,0
71088,0,0,0,0,0
105822,0,0,0,0,0
29215,0,0,0,0,0
51666,0,0,0,0,0
103045,0,0,0,0,0
58263,0,0,0,0,0
41147,0,0,0,0,0
18412,0,0,0,0,0
102793,0,0,0,0,0
109245,0,0,0,0,0
81320,4,4,4,0,0
88862,0,0,0,0,0
63356,1,1,1,0,0
67823,0,0,0,0,0
31194,0,0,0,0,0
20376,0,0,0,0,0
109788,0,0,0,0,0
94110,0,0,0,0,0
43745,0,0,0,0,0
101026,0,0,0,0,0
52692,1,1,1,0,0
54645,0,0,0,0,0
16406,0,0,0,0,0
40152,0,0,0,0,0
106634,0,0,0,0,0
20499,0,0,0,0,0
33777,0,0,0,0,0
47122,0,0,0,0,0
56399,0,0,0,0,0
40969,0,0,0,0,0
45720,0,0,0,0,0
87160,0,0,0,0,0
116397,2,2,2,0,0
47865,0,0,0,0,0
19154,0,0,0,0,0
105743,0,0,0,0,0
44408,0,0,0,0,0
101805,0,0,0,0,0
1691,0,0,0,0,0
22573,0,0,0,0,0
28835,0,0,0,0,0
11563,0,0,0,0,0
80846,0,0,0,0,0
76220,0,0,0,0,0
96456,0,0,0,0,0
56947,0,0,0,0,0
49998,0,0,0,0,0
77264,0,0,0,0,0
115323,0,0,0,0,0
101644,2,2,2,0,0
63777,0,0,0,0,0
45082,0,0,0,0,0
88442,0,0,0,0,0
103394,0,0,0,0,0
48052,0,0,0,0,0
120382,0,0,0,0,0
39333,0,0,0,0,0
42366,0,0,0,0,0
38856,0,0,0,0,0
76984,0,0,0,0,0
59935,0,0,0,0,0
32066,0,0,0,0,0
20679,0,0,0,0,0
95475,0,0,0,0,0
12164,0,0,0,0,0
54597,0,0,0,0,0
10851,0,0,0,0,0
67403,0,0,0,0,0
76303,0,0,0,0,0
45827,0,0,0,0,0
76307,0,0,0,0,0
119025,0,0,0,0,0
33002,0,0,0,0,0
93837,0,0,0,0,0
48275,0,0,0,0,0
78820,0,0,0,0,0
16793,0,0,0,0,0
79579,0,0,0,0,0
110065,0,0,0,0,0
101206,0,0,0,0,0
58877,0,0,0,0,0
56635,0,0,0,0,0
25399,0,0,0,0,0
48357,0,0,0,0,0
9258,0,0,0,0,0
110904,0,0,0,0,0
12585,0,0,0,0,0
65960,0,0,0,0,0
45971,0,0,0,0,0
55970,0,0,0,0,0
17266,0,0,0,0,0
34763,0,0,0,0,0
33429,0,0,0,0,0
70767,0,0,0,0,0
26253,0,0,0,0,0
30939,0,0,0,0,0
16587,0,0,0,0,0
78944,0,0,0,0,0
71542,0,0,0,0,0
111595,0,0,0,0,0
40737,0,0,0,0,0
34576,0,0,0,0,0
113852,0,0,0,0,0
65890,0,0,0,0,0
114035,0,0,0,0,0
111172,0,0,0,0,0
97992,0,0,0,0,0
115832,0,0,0,0,0
79543,0,0,0,0,0
28778,0,0,0,0,0
34886,0,0,0,0,0
116605,0,0,0,0,0
62483,0,0,0,0,0
114467,0,0,0,0,0
78943,0,0,0,0,0
89768,0,0,0,0,0
7580,0,0,0,0,0
94939,0,0,0,0,0
81747,0,0,0,0,0
20386,0,0,0,0,0
232,0,0,0,0,0
93184,0,0,0,0,0
22414,0,0,0,0,0
120531,0,0,0,0,0
78866,0,0,0,0,0
21236,0,0,0,0,0
94577,0,0,0,0,0
97629,0,0,0,0,0
101921,0,0,0,0,0
76397,0,0,0,0,0
117870,0,0,0,0,0
35457,0,0,0,0,0
51439,0,0,0,0,0
106589,0,0,0,0,0
118941,0,0,0,0,0
18893,0,0,0,0,0
78971,0,0,0,0,0
64386,0,0,0,0,0
82000,0,0,0,0,0
72365,0,0,0,0,0
49887,0,0,0,0,0
48517,0,0,0,0,0
18820,0,0,0,0,0
91978,0,0,0,0,0
60704,0,0,0,0,0
11748,0,0,0,0,0
69873,0,0,0,0,0
17768,0,0,0,0,0
92525,0,0,0,0,0
41772,0,0,0,0,0
64178,0,0,0,0,0
53091,0,0,0,0,0
84654,0,0,0,0,0
97842,0,0,0,0,0
108354,0,0,0,0,0
52382,0,0,0,0,0
80580,0,0,0,0,0
85708,0,0,0,0,0
79643,0,0,0,0,0
6858,0,0,0,0,0
26196,0,0,0,0,0
105118,0,0,0,0,0
117199,0,0,0,0,0
66959,0,0,0,0,0
115412,0,0,0,0,0
67983,0,0,0,0,0
62797,0,0,0,0,0
42341,0,0,0,0,0
102144,0,0,0,0,0
5219,0,0,0,0,0
61680,0,0,0,0,0
82415,0,0,0,0,0
110497,0,0,0,0,0
109189,0,0,0,0,0
89131,1,1,1,0,0
30015,0,0,0,0,0
67059,0,0,0,0,0
90093,0,0,0,0,0
33482,0,0,0,0,0
48451,0,0,0,0,0
35123,0,0,0,0,0
101949,0,0,0,0,0
64149,0,0,0,0,0
111524,0,0,0,0,0
106917,0,0,0,0,0
55891,0,0,0,0,0
73206,0,0,0,0,0
15241,0,0,0,0,0
31220,0,0,0,0,0
85117,0,0,0,0,0
78595,0,0,0,0,0
77748,0,0,0,0,0
64124,0,0,0,0,0
82061,0,0,0,0,0
31331,0,0,0,0,0
56341,0,0,0,0,0
13323,0,0,0,0,0
45403,0,0,0,0,0
43340,0,0,0,0,0
64911,0,0,0,0,0
51817,0,0,0,0,0
30757,0,0,0,0,0
107378,0,0,0,0,0
67388,0,0,0,0,0
68973,0,0,0,0,0
67462,0,0,0,0,0
60121,0,0,0,0,0
91074,0,0,0,0,0
37430,0,0,0,0,0
73518,0,0,0,0,0
31748,0,0,0,0,0
65524,0,0,0,0,0
40436,0,0,0,0,0
17259,0,0,0,0,0
99031,0,0,0,0,0
107023,0,0,0,0,0
119398,0,0,0,0,0
112444,0,0,0,0,0
25684,0,0,0,0,0
66898,0,0,0,0,0
37153,0,0,0,0,0
79919,6,6,6,0,0
20224,0,0,0,0,0
32416,0,0,0,0,0
109999,0,0,0,0,0
117397,0,0,0,0,0
98643,0,0,0,0,0
105092,0,0,0,0,0
41166,0,0,0,0,0
49408,0,0,0,0,0
100883,0,0,0,0,0
100568,0,0,0,0,0
1490,0,0,0,0,0
89226,0,0,0,0,0
105100,0,0,0,0,0
60943,0,0,0,0,0
77289,0,0,0,0,0
30945,0,0,0,0,0
42107,0,0,0,0,0
69470,0,0,0,0,0
15522,0,0,0,0,0
73597,0,0,0,0,0
35107,0,0,0,0,0
19200,0,0,0,0,0
91892,0,0,0,0,0
58430,0,0,0,0,0
67967,0,0,0,0,0
78788,0,0,0,0,0
119078,0,0,0,0,0
43139,0,0,0,0,0
7194,0,0,0,0,0
77065,0,0,0,0,0
98624,0,0,0,0,0
99120,0,0,0,0,0
15585,0,0,0,0,0
119745,0,0,0,0,0
12206,0,0,0,0,0
73550,0,0,0,0,0
101461,0,0,0,0,0
94784,0,0,0,0,0
79620,0,0,0,0,0
85632,0,0,0,0,0
20626,0,0,0,0,0
28867,0,0,0,0,0
73044,0,0,0,0,0
4196,0,0,0,0,0
88108,0,0,0,0,0
100931,0,0,0,0,0
109820,0,0,0,0,0
89550,0,0,0,0,0
104857,0,0,0,0,0
11713,0,0,0,0,0
7048,0,0,0,0,0
88232,0,0,0,0,0
17450,0,0,0,0,0
99195,0,0,0,0,0
45222,0,0,0,0,0
79046,0,0,0,0,0
82575,0,0,0,0,0
108567,0,0,0,0,0
81109,0,0,0,0,0
117738,0,0,0,0,0
116668,0,0,0,0,0
43990,0,0,0,0,0
43307,0,0,0,0,0
50900,0,0,0,0,0
105547,0,0,0,0,0
14601,0,0,0,0,0
30271,0,0,0,0,0
108457,0,0,0,0,0
30928,0,0,0,0,0
90703,0,0,0,0,0
6770,0,0,0,0,0
108050,0,0,0,0,0
26040,0,0,0,0,0
25992,0,0,0,0,0
47542,0,0,0,0,0
57623,0,0,0,0,0
84778,0,0,0,0,0
50634,0,0,0,0,0
86735,0,0,0,0,0
28150,0,0,0,0,0
50689,0,0,0,0,0
10025,0,0,0,0,0
41766,0,0,0,0,0
62280,0,0,0,0,0
106559,0,0,0,0,0
85198,0,0,0,0,0
43719,0,0,0,0,0
46255,0,0,0,0,0
92964,0,0,0,0,0
50598,0,0,0,0,0
74321,0,0,0,0,0
32124,0,0,0,0,0
118259,0,0,0,0,0
79187,0,0,0,0,0
24164,0,0,0,0,0
114190,0,0,0,0,0
60920,0,0,0,0,0
62549,0,0,0,0,0
11965,0,0,0,0,0
9366,0,0,0,0,0
33763,0,0,0,0,0
110914,0,0,0,0,0
103834,0,0,0,0,0
66333,0,0,0,0,0
3596,0,0,0,0,0
103845,0,0,0,0,0
74226,0,0,0,0,0
54307,0,0,0,0,0
38106,0,0,0,0,0
119266,0,0,0,0,0
96862,0,0,0,0,0
6307,0,0,0,0,0
6259,0,0,0,0,0
97619,0,0,0,0,0
71110,0,0,0,0,0
75124,0,0,0,0,0
15678,0,0,0,0,0
74435,0,0,0,0,0
2611,0,0,0,0,0
18759,0,0,0,0,0
67856,0,0,0,0,0
34442,0,0,0,0,0
66707,0,0,0,0,0
51144,0,0,0,0,0
52372,0,0,0,0,0
89427,0,0,0,0,0
31976,0,0,0,0,0
55551,0,0,0,0,0
106629,0,0,0,0,0
48361,0,0,0,0,0
119549,0,0,0,0,0
112933,0,0,0,0,0
111922,0,0,0,0,0
76183,0,0,0,0,0
1648,0,0,0,0,0
9779,0,0,0,0,0
82674,0,0,0,0,0
18719,0,0,0,0,0
72539,0,0,0,0,0
52008,0,0,0,0,0
3508,0,0,0,0,0
47047,0,0,0,0,0
73983,0,0,0,0,0
110723,0,0,0,0,0
65895,0,0,0,0,0
29279,0,0,0,0,0
86503,0,0,0,0,0
119875,0,0,0,0,0
84847,0,0,0,0,0
101428,0,0,0,0,0
50288,0,0,0,0,0
104383,0,0,0,0,0
46926,0,0,0,0,0
37047,0,0,0,0,0
118777,0,0,0,0,0
62986,0,0,0,0,0
98560,0,0,0,0,0
87847,0,0,0,0,0
120508,0,0,0,0,0
63966,0,0,0,0,0
45183,0,0,0,0,0
51055,0,0,0,0,0
69209,0,0,0,0,0
117655,0,0,0,0,0
69756,0,0,0,0,0
48399,0,0,0,0,0
42982,0,0,0,0,0
51885,0,0,0,0,0
81743,0,0,0,0,0
26251,0,0,0,0,0
1502,0,0,0,0,0
74864,0,0,0,0,0
111848,0,0,0,0,0
113224,0,0,0,0,0
20343,0,0,0,0,0
92497,0,0,0,0,0
112746,0,0,0,0,0
31188,0,0,0,0,0
74968,0,0,0,0,0
60878,0,0,0,0,0
11145,0,0,0,0,0
117422,0,0,0,0,0
45018,0,0,0,0,0
103502,0,0,0,0,0
79057,0,0,0,0,0
86525,0,0,0,0,0
10844,0,0,0,0,0
4025,0,0,0,0,0
56029,0,0,0,0,0
74905,0,0,0,0,0
56731,0,0,0,0,0
54124,0,0,0,0,0
90901,0,0,0,0,0
8486,0,0,0,0,0
17077,0,0,0,0,0
55155,0,0,0,0,0
86497,0,0,0,0,0
57275,0,0,0,0,0
80836,0,0,0,0,0
78258,0,0,0,0,0
2951,0,0,0,0,0
35241,0,0,0,0,0
3043,0,0,0,0,0
89578,0,0,0,0,0
68619,0,0,0,0,0
109556,0,0,0,0,0
10294,0,0,0,0,0
19330,0,0,0,0,0
85832,0,0,0,0,0
2050,0,0,0,0,0
10333,0,0,0,0,0
85673,0,0,0,0,0
75381,0,0,0,0,0
33627,0,0,0,0,0
115059,0,0,0,0,0
117607,0,0,0,0,0
80784,0,0,0,0,0
62528,0,0,0,0,0
32915,0,0,0,0,0
82695,0,0,0,0,0
50453,0,0,0,0,0
61939,0,0,0,0,0
38265,0,0,0,0,0
31446,0,0,0,0,0
43192,0,0,0,0,0
31772,0,0,0,0,0
32839,0,0,0,0,0
116682,0,0,0,0,0
20059,0,0,0,0,0
108458,0,0,0,0,0
79671,0,0,0,0,0
11708,0,0,0,0,0
73051,0,0,0,0,0
89992,0,0,0,0,0
66692,0,0,0,0,0
11672,0,0,0,0,0
87810,0,0,0,0,0
28969,0,0,0,0,0
78675,0,0,0,0,0
79054,0,0,0,0,0
10377,0,0,0,0,0
73798,0,0,0,0,0
83229,0,0,0,0,0
79998,0,0,0,0,0
89074,0,0,0,0,0
116351,0,0,0,0,0
33590,0,0,0,0,0
11809,0,0,0,0,0
6048,0,0,0,0,0
35905,0,0,0,0,0
97565,0,0,0,0,0
66464,0,0,0,0,0
34907,0,0,0,0,0
4720,1,1,1,0,0
58549,0,0,0,0,0
28102,0,0,0,0,0
14093,0,0,0,0,0
57394,0,0,0,0,0
48415,0,0,0,0,0
115651,0,0,0,0,0
34693,0,0,0,0,0
105662,0,0,0,0,0
18086,0,0,0,0,0
107104,0,0,0,0,0
108823,0,0,0,0,0
81125,0,0,0,0,0
58349,0,0,0,0,0
16800,0,0,0,0,0
22968,0,0,0,0,0
109188,0,0,0,0,0
112904,0,0,0,0,0
50292,0,0,0,0,0
16564,0,0,0,0,0
24920,0,0,0,0,0
96288,0,0,0,0,0
82998,0,0,0,0,0
86806,0,0,0,0,0
9782,0,0,0,0,0
46624,0,0,0,0,0
43602,0,0,0,0,0
66990,0,0,0,0,0
72217,0,0,0,0,0
57707,0,0,0,0,0
120336,0,0,0,0,0
116389,0,0,0,0,0
79695,0,0,0,0,0
89465,0,0,0,0,0
32447,0,0,0,0,0
111136,0,0,0,0,0
99765,0,0,0,0,0
87046,0,0,0,0,0
43508,0,0,0,0,0
76301,3,3,3,0,0
118135,0,0,0,0,0
36577,0,0,0,0,0
85520,0,0,0,0,0
112300,0,0,0,0,0
45525,0,0,0,0,0
92004,0,0,0,0,0
56727,0,0,0,0,0
82314,0,0,0,0,0
101200,0,0,0,0,0
40406,0,0,0,0,0
40229,0,0,0,0,0
61246,0,0,0,0,0
53330,0,0,0,0,0
5395,0,0,0,0,0
32979,0,0,0,0,0
1238,0,0,0,0,0
11710,0,0,0,0,0
954,0,0,0,0,0
58103,0,0,0,0,0
44884,0,0,0,0,0
102285,0,0,0,0,0
106366,2,2,2,0,0
89166,0,0,0,0,0
35921,0,0,0,0,0
67932,0,0,0,0,0
97450,0,0,0,0,0
75616,0,0,0,0,0
103086,0,0,0,0,0
19735,0,0,0,0,0
108161,0,0,0,0,0
52823,0,0,0,0,0
92064,0,0,0,0,0
76224,0,0,0,0,0
72389,0,0,0,0,0
68929,0,0,0,0,0
56408,0,0,0,0,0
42564,0,0,0,0,0
62532,0,0,0,0,0
114643,0,0,0,0,0
14153,0,0,0,0,0
111950,0,0,0,0,0
65692,0,0,0,0,0
50722,0,0,0,0,0
17584,0,0,0,0,0
17561,0,0,0,0,0
10798,0,0,0,0,0
43524,0,0,0,0,0
89319,0,0,0,0,0
70162,0,0,0,0,0
20371,0,0,0,0,0
45011,0,0,0,0,0
35794,0,0,0,0,0
24779,0,0,0,0,0
83894,0,0,0,0,0
110078,0,0,0,0,0
42637,0,0,0,0,0
1477,0,0,0,0,0
78606,0,0,0,0,0
33642,0,0,0,0,0
49070,0,0,0,0,0
101539,0,0,0,0,0
37087,0,0,0,0,0
83851,0,0,0,0,0
81777,0,0,0,0,0
55899,0,0,0,0,0
45502,0,0,0,0,0
49936,0,0,0,0,0
34667,0,0,0,0,0
102015,0,0,0,0,0
54508,0,0,0,0,0
87161,0,0,0,0,0
48523,0,0,0,0,0
29188,0,0,0,0,0
64849,0,0,0,0,0
106452,0,0,0,0,0
29491,0,0,0,0,0
69329,0,0,0,0,0
63558,0,0,0,0,0
17607,0,0,0,0,0
66273,0,0,0,0,0
113030,0,0,0,0,0
21569,0,0,0,0,0
107644,0,0,0,0,0
52071,0,0,0,0,0
4511,0,0,0,0,0
19472,0,0,0,0,0
33516,0,0,0,0,0
22441,0,0,0,0,0
48855,0,0,0,0,0
37257,0,0,0,0,0
110756,0,0,0,0,0
100472,0,0,0,0,0
72325,0,0,0,0,0
65182,0,0,0,0,0
32739,0,0,0,0,0
99298,0,0,0,0,0
49969,0,0,0,0,0
3003,1,1,1,0,0
104204,0,0,0,0,0
64774,0,0,0,0,0
111042,0,0,0,0,0
107139,0,0,0,0,0
21392,0,0,0,0,0
71201,0,0,0,0,0
71478,1,1,1,0,0
52328,0,0,0,0,0
94181,0,0,0,0,0
62941,0,0,0,0,0
2034,0,0,0,0,0
109017,0,0,0,0,0
14644,0,0,0,0,0
2846,0,0,0,0,0
33915,0,0,0,0,0
64387,0,0,0,0,0
86426,0,0,0,0,0
78442,0,0,0,0,0
93120,0,0,0,0,0
86858,0,0,0,0,0
97849,0,0,0,0,0
77481,0,0,0,0,0
32247,0,0,0,0,0
110310,0,0,0,0,0
7413,0,0,0,0,0
29102,0,0,0,0,0
26557,0,0,0,0,0
12555,0,0,0,0,0
54815,0,0,0,0,0
51492,0,0,0,0,0
108811,0,0,0,0,0
20133,0,0,0,0,0
62274,0,0,0,0,0
51196,0,0,0,0,0
14710,0,0,0,0,0
33933,0,0,0,0,0
22195,0,0,0,0,0
82328,0,0,0,0,0
83589,0,0,0,0,0
70116,0,0,0,0,0
12468,0,0,0,0,0
113864,0,0,0,0,0
111032,0,0,0,0,0
26877,0,0,0,0,0
1006,0,0,0,0,0
118753,0,0,0,0,0
61794,0,0,0,0,0
78624,0,0,0,0,0
65384,0,0,0,0,0
115937,0,0,0,0,0
19425,0,0,0,0,0
32061,0,0,0,0,0
105391,0,0,0,0,0
54401,0,0,0,0,0
26737,0,0,0,0,0
32084,0,0,0,0,0
37310,0,0,0,0,0
10308,0,0,0,0,0
23689,0,0,0,0,0
18054,0,0,0,0,0
76607,0,0,0,0,0
106479,0,0,0,0,0
28679,0,0,0,0,0
58790,0,0,0,0,0
94272,0,0,0,0,0
4513,0,0,0,0,0
96079,0,0,0,0,0
51050,0,0,0,0,0
14973,0,0,0,0,0
71526,0,0,0,0,0
78774,0,0,0,0,0
87789,0,0,0,0,0
89749,0,0,0,0,0
110721,0,0,0,0,0
61322,0,0,0,0,0
78210,0,0,0,0,0
64079,0,0,0,0,0
11084,0,0,0,0,0
20170,0,0,0,0,0
48271,0,0,0,0,0
89948,0,0,0,0,0
47427,0,0,0,0,0
66084,0,0,0,0,0
51926,0,0,0,0,0
56929,0,0,0,0,0
53328,0,0,0,0,0
41329,0,0,0,0,0
60394,0,0,0,0,0
114135,0,0,0,0,0
3741,0,0,0,0,0
104303,0,0,0,0,0
109163,1,1,1,0,0
87850,0,0,0,0,0
21140,0,0,0,0,0
95313,0,0,0,0,0
56743,0,0,0,0,0
7890,0,0,0,0,0
106371,0,0,0,0,0
40490,0,0,0,0,0
104233,0,0,0,0,0
75669,0,0,0,0,0
30861,0,0,0,0,0
56327,0,0,0,0,0
21295,0,0,0,0,0
24205,0,0,0,0,0
108568,0,0,0,0,0
34468,0,0,0,0,0
80528,0,0,0,0,0
112927,0,0,0,0,0
88471,0,0,0,0,0
91275,0,0,0,0,0
107299,0,0,0,0,0
104754,0,0,0,0,0
64083,0,0,0,0,0
51617,0,0,0,0,0
10170,0,0,0,0,0
25300,0,0,0,0,0
90825,0,0,0,0,0
116533,0,0,0,0,0
65270,0,0,0,0,0
81860,0,0,0,0,0
49962,0,0,0,0,0
18845,0,0,0,0,0
59494,0,0,0,0,0
115794,0,0,0,0,0
50076,0,0,0,0,0
117583,0,0,0,0,0
62857,0,0,0,0,0
60485,0,0,0,0,0
82779,0,0,0,0,0
116754,2,2,2,0,0
47444,0,0,0,0,0
12796,0,0,0,0,0
34994,0,0,0,0,0
45436,0,0,0,0,0
77692,0,0,0,0,0
103201,0,0,0,0,0
115419,0,0,0,0,0
83785,0,0,0,0,0
22023,0,0,0,0,0
46538,0,0,0,0,0
118618,0,0,0,0,0
79815,0,0,0,0,0
110392,0,0,0,0,0
55169,0,0,0,0,0
102281,0,0,0,0,0
11603,0,0,0,0,0
65484,0,0,0,0,0
82536,0,0,0,0,0
106722,0,0,0,0,0
102755,0,0,0,0,0
69739,0,0,0,0,0
41933,0,0,0,0,0
81987,0,0,0,0,0
102481,0,0,0,0,0
46413,0,0,0,0,0
32339,0,0,0,0,0
19675,0,0,0,0,0
78470,0,0,0,0,0
90165,0,0,0,0,0
31600,3,3,3,0,0
103666,0,0,0,0,0
37623,0,0,0,0,0
93327,0,0,0,0,0
118128,0,0,0,0,0
96729,0,0,0,0,0
101775,0,0,0,0,0
92661,0,0,0,0,0
102808,0,0,0,0,0
78209,0,0,0,0,0
89043,0,0,0,0,0
106410,0,0,0,0,0
4516,0,0,0,0,0
94563,0,0,0,0,0
45388,0,0,0,0,0
22085,0,0,0,0,0
24640,0,0,0,0,0
85008,0,0,0,0,0
48,0,0,0,0,0
36460,0,0,0,0,0
81359,0,0,0,0,0
105592,0,0,0,0,0
18637,0,0,0,0,0
48531,2,2,2,0,0
55632,0,0,0,0,0
92765,0,0,0,0,0
11309,0,0,0,0,0
26002,0,0,0,0,0
61202,0,0,0,0,0
27465,0,0,0,0,0
118757,0,0,0,0,0
120371,0,0,0,0,0
117026,0,0,0,0,0
36476,0,0,0,0,0
32225,0,0,0,0,0
48925,0,0,0,0,0
14129,0,0,0,0,0
51499,0,0,0,0,0
95946,0,0,0,0,0
81447,0,0,0,0,0
39614,0,0,0,0,0
40403,0,0,0,0,0
95862,0,0,0,0,0
82477,0,0,0,0,0
26876,0,0,0,0,0
30361,0,0,0,0,0
20498,0,0,0,0,0
40332,0,0,0,0,0
82100,0,0,0,0,0
42751,0,0,0,0,0
57250,0,0,0,0,0
72569,0,0,0,0,0
43959,0,0,0,0,0
93255,0,0,0,0,0
97941,0,0,0,0,0
69617,0,0,0,0,0
81932,4,4,4,0,0
87411,0,0,0,0,0
36992,0,0,0,0,0
65595,0,0,0,0,0
97277,0,0,0,0,0
33207,0,0,0,0,0
31278,0,0,0,0,0
92590,0,0,0,0,0
90443,0,0,0,0,0
65091,0,0,0,0,0
47402,0,0,0,0,0
118376,0,0,0,0,0
31829,0,0,0,0,0
455,0,0,0,0,0
101881,0,0,0,0,0
95275,0,0,0,0,0
42066,0,0,0,0,0
51314,0,0,0,0,0
110975,0,0,0,0,0
8463,0,0,0,0,0
49294,0,0,0,0,0
52132,0,0,0,0,0
95125,0,0,0,0,0
88615,0,0,0,0,0
112575,0,0,0,0,0
79828,0,0,0,0,0
32890,0,0,0,0,0
46867,0,0,0,0,0
102848,0,0,0,0,0
34336,0,0,0,0,0
31151,0,0,0,0,0
104081,0,0,0,0,0
68993,0,0,0,0,0
106687,0,0,0,0,0
48183,0,0,0,0,0
95885,0,0,0,0,0
29250,0,0,0,0,0
44767,0,0,0,0,0
15496,0,0,0,0,0
117810,0,0,0,0,0
87179,0,0,0,0,0
41957,0,0,0,0,0
8250,0,0,0,0,0
84924,1,1,1,0,0
111223,0,0,0,0,0
99881,0,0,0,0,0
28866,0,0,0,0,0
15894,0,0,0,0,0
87575,0,0,0,0,0
83532,0,0,0,0,0
83244,0,0,0,0,0
15220,0,0,0,0,0
43362,0,0,0,0,0
109831,0,0,0,0,0
117570,0,0,0,0,0
9763,0,0,0,0,0
30799,0,0,0,0,0
54016,0,0,0,0,0
15490,0,0,0,0,0
45958,0,0,0,0,0
65766,0,0,0,0,0
11945,0,0,0,0,0
73740,0,0,0,0,0
90230,0,0,0,0,0
53482,0,0,0,0,0
110817,0,0,0,0,0
4292,0,0,0,0,0
95754,1,1,1,0,0
53686,0,0,0,0,0
27421,0,0,0,0,0
33700,0,0,0,0,0
77913,0,0,0,0,0
117604,0,0,0,0,0
62622,0,0,0,0,0
8609,0,0,0,0,0
10879,0,0,0,0,0
65539,0,0,0,0,0
112887,0,0,0,0,0
110642,0,0,0,0,0
111724,0,0,0,0,0
115520,0,0,0,0,0
74555,0,0,0,0,0
28908,0,0,0,0,0
3056,0,0,0,0,0
62990,0,0,0,0,0
107956,0,0,0,0,0
28730,0,0,0,0,0
623,0,0,0,0,0
25421,0,0,0,0,0
51189,0,0,0,0,0
46553,0,0,0,0,0
19236,0,0,0,0,0
104446,0,0,0,0,0
112650,0,0,0,0,0
42389,0,0,0,0,0
19600,0,0,0,0,0
81967,0,0,0,0,0
23518,0,0,0,0,0
87065,0,0,0,0,0
19842,0,0,0,0,0
110951,1,1,1,0,0
110761,0,0,0,0,0
56790,0,0,0,0,0
33952,0,0,0,0,0
9068,0,0,0,0,0
109508,0,0,0,0,0
114388,1,1,1,0,0
114507,0,0,0,0,0
14800,0,0,0,0,0
87257,0,0,0,0,0
61304,0,0,0,0,0
3322,0,0,0,0,0
17388,0,0,0,0,0
15339,0,0,0,0,0
116340,0,0,0,0,0
40250,0,0,0,0,0
75814,0,0,0,0,0
111031,0,0,0,0,0
33198,0,0,0,0,0
67365,0,0,0,0,0
46244,0,0,0,0,0
6368,0,0,0,0,0
29063,0,0,0,0,0
4943,0,0,0,0,0
12977,0,0,0,0,0
44999,0,0,0,0,0
19364,0,0,0,0,0
52653,0,0,0,0,0
17742,0,0,0,0,0
111161,0,0,0,0,0
57039,0,0,0,0,0
104534,0,0,0,0,0
84755,0,0,0,0,0
89061,0,0,0,0,0
70154,0,0,0,0,0
106398,0,0,0,0,0
86510,0,0,0,0,0
95146,0,0,0,0,0
64216,0,0,0,0,0
59474,0,0,0,0,0
39596,0,0,0,0,0
113374,0,0,0,0,0
14696,0,0,0,0,0
61326,0,0,0,0,0
93816,0,0,0,0,0
6377,0,0,0,0,0
91156,5,5,5,0,0
57930,0,0,0,0,0
11658,0,0,0,0,0
98756,0,0,0,0,0
28849,0,0,0,0,0
38355,0,0,0,0,0
68870,0,0,0,0,0
78320,0,0,0,0,0
30086,1,1,1,0,0
114786,0,0,0,0,0
91574,0,0,0,0,0
20920,0,0,0,0,0
30365,0,0,0,0,0
102226,0,0,0,0,0
62293,0,0,0,0,0
58012,0,0,0,0,0
31991,0,0,0,0,0
89868,0,0,0,0,0
4904,0,0,0,0,0
66358,0,0,0,0,0
97854,0,0,0,0,0
1808,0,0,0,0,0
99084,0,0,0,0,0
85679,0,0,0,0,0
26693,0,0,0,0,0
57183,0,0,0,0,0
46449,0,0,0,0,0
63236,0,0,0,0,0
93540,0,0,0,0,0
28055,0,0,0,0,0
106058,0,0,0,0,0
107783,0,0,0,0,0
71629,0,0,0,0,0
19065,0,0,0,0,0
117535,0,0,0,0,0
106414,0,0,0,0,0
81811,0,0,0,0,0
112593,0,0,0,0,0
81905,0,0,0,0,0
27963,0,0,0,0,0
68544,0,0,0,0,0
86189,0,0,0,0,0
30294,0,0,0,0,0
40242,0,0,0,0,0
6237,0,0,0,0,0
3019,0,0,0,0,0
28178,0,0,0,0,0
66765,0,0,0,0,0
98969,0,0,0,0,0
43981,0,0,0,0,0
6924,0,0,0,0,0
21357,0,0,0,0,0
40776,0,0,0,0,0
34786,0,0,0,0,0
78167,0,0,0,0,0
40769,0,0,0,0,0
113522,0,0,0,0,0
10426,0,0,0,0,0
64791,0,0,0,0,0
74379,0,0,0,0,0
101561,0,0,0,0,0
17153,0,0,0,0,0
47675,0,0,0,0,0
21935,0,0,0,0,0
90092,0,0,0,0,0
76677,0,0,0,0,0
11557,0,0,0,0,0
28999,0,0,0,0,0
80399,2,2,2,0,0
55773,0,0,0,0,0
83826,0,0,0,0,0
57342,0,0,0,0,0
117779,0,0,0,0,0
55293,0,0,0,0,0
90260,0,0,0,0,0
8646,0,0,0,0,0
44361,0,0,0,0,0
48377,0,0,0,0,0
77903,0,0,0,0,0
63317,0,0,0,0,0
100458,0,0,0,0,0
71937,0,0,0,0,0
103389,0,0,0,0,0
93482,0,0,0,0,0
8155,0,0,0,0,0
109061,0,0,0,0,0
18828,0,0,0,0,0
92732,0,0,0,0,0
35706,0,0,0,0,0
103675,0,0,0,0,0
59560,0,0,0,0,0
66314,0,0,0,0,0
72499,0,0,0,0,0
31057,0,0,0,0,0
100337,0,0,0,0,0
109278,0,0,0,0,0
28217,0,0,0,0,0
114620,0,0,0,0,0
111379,0,0,0,0,0
93421,0,0,0,0,0
82095,0,0,0,0,0
51323,0,0,0,0,0
104110,0,0,0,0,0
2935,0,0,0,0,0
95870,0,0,0,0,0
10891,0,0,0,0,0
118160,0,0,0,0,0
113168,0,0,0,0,0
82448,0,0,0,0,0
72656,0,0,0,0,0
118573,0,0,0,0,0
16009,0,0,0,0,0
11545,0,0,0,0,0
113122,0,0,0,0,0
89111,0,0,0,0,0
35161,0,0,0,0,0
36506,0,0,0,0,0
61769,1,1,1,0,0
54562,0,0,0,0,0
83040,0,0,0,0,0
32474,0,0,0,0,0
81889,0,0,0,0,0
8196,0,0,0,0,0
9314,0,0,0,0,0
29995,0,0,0,0,0
66151,0,0,0,0,0
115722,0,0,0,0,0
70369,0,0,0,0,0
82501,0,0,0,0,0
29281,0,0,0,0,0
54452,0,0,0,0,0
97867,0,0,0,0,0
76686,0,0,0,0,0
9080,0,0,0,0,0
2252,0,0,0,0,0
54875,0,0,0,0,0
88341,0,0,0,0,0
64397,0,0,0,0,0
68332,0,0,0,0,0
54563,0,0,0,0,0
4372,0,0,0,0,0
119191,0,0,0,0,0
78362,0,0,0,0,0
87682,0,0,0,0,0
44698,0,0,0,0,0
69650,0,0,0,0,0
11459,0,0,0,0,0
96989,0,0,0,0,0
16763,0,0,0,0,0
44527,0,0,0,0,0
109727,0,0,0,0,0
37498,0,0,0,0,0
8927,0,0,0,0,0
115054,0,0,0,0,0
24325,0,0,0,0,0
17071,0,0,0,0,0
86343,0,0,0,0,0
51795,0,0,0,0,0
76799,0,0,0,0,0
33543,0,0,0,0,0
75331,0,0,0,0,0
112911,0,0,0,0,0
115100,0,0,0,0,0
41602,0,0,0,0,0
47531,0,0,0,0,0
107688,0,0,0,0,0
40514,0,0,0,0,0
85119,0,0,0,0,0
96244,0,0,0,0,0
117517,0,0,0,0,0
8957,0,0,0,0,0
11312,0,0,0,0,0
96438,0,0,0,0,0
63346,0,0,0,0,0
117767,0,0,0,0,0
66756,0,0,0,0,0
99526,0,0,0,0,0
110453,0,0,0,0,0
8329,0,0,0,0,0
119300,0,0,0,0,0
41,0,0,0,0,0
81802,0,0,0,0,0
63301,0,0,0,0,0
83592,0,0,0,0,0
78998,0,0,0,0,0
101594,0,0,0,0,0
67549,0,0,0,0,0
98955,1,1,1,0,0
61177,0,0,0,0,0
13856,0,0,0,0,0
2787,0,0,0,0,0
15297,0,0,0,0,0
102156,0,0,0,0,0
73631,0,0,0,0,0
27949,0,0,0,0,0
28457,0,0,0,0,0
79765,0,0,0,0,0
115147,0,0,0,0,0
73309,0,0,0,0,0
26551,0,0,0,0,0
105204,0,0,0,0,0
82521,0,0,0,0,0
91470,0,0,0,0,0
96040,0,0,0,0,0
22807,1,1,1,0,0
69854,0,0,0,0,0
85347,0,0,0,0,0
112362,0,0,0,0,0
97861,0,0,0,0,0
101480,0,0,0,0,0
68156,0,0,0,0,0
96895,0,0,0,0,0
54881,0,0,0,0,0
97311,0,0,0,0,0
90918,0,0,0,0,0
75317,0,0,0,0,0
117056,0,0,0,0,0
7047,0,0,0,0,0
73839,0,0,0,0,0
23083,0,0,0,0,0
92612,0,0,0,0,0
13691,0,0,0,0,0
19936,0,0,0,0,0
100324,0,0,0,0,0
61972,0,0,0,0,0
101701,0,0,0,0,0
67495,0,0,0,0,0
120087,0,0,0,0,0
105359,0,0,0,0,0
63363,0,0,0,0,0
6145,0,0,0,0,0
11160,0,0,0,0,0
95857,0,0,0,0,0
60050,0,0,0,0,0
23929,0,0,0,0,0
100587,0,0,0,0,0
77438,0,0,0,0,0
46226,0,0,0,0,0
44938,0,0,0,0,0
32606,0,0,0,0,0
75930,0,0,0,0,0
23847,0,0,0,0,0
76141,0,0,0,0,0
47258,0,0,0,0,0
70279,0,0,0,0,0
75193,0,0,0,0,0
67706,0,0,0,0,0
41693,0,0,0,0,0
42902,0,0,0,0,0
75745,0,0,0,0,0
86868,0,0,0,0,0
78286,0,0,0,0,0
17458,0,0,0,0,0
76933,0,0,0,0,0
113548,0,0,0,0,0
29805,0,0,0,0,0
301,0,0,0,0,0
508,0,0,0,0,0
25529,0,0,0,0,0
11192,0,0,0,0,0
39550,0,0,0,0,0
76553,0,0,0,0,0
115713,0,0,0,0,0
99316,0,0,0,0,0
67273,0,0,0,0,0
25029,0,0,0,0,0
117743,0,0,0,0,0
29519,0,0,0,0,0
59598,0,0,0,0,0
62396,0,0,0,0,0
78141,0,0,0,0,0
20710,0,0,0,0,0
62555,0,0,0,0,0
94085,0,0,0,0,0
25663,0,0,0,0,0
14983,0,0,0,0,0
105540,0,0,0,0,0
101324,0,0,0,0,0
40532,0,0,0,0,0
11096,0,0,0,0,0
33904,0,0,0,0,0
62184,0,0,0,0,0
56871,0,0,0,0,0
28218,0,0,0,0,0
119882,0,0,0,0,0
23373,0,0,0,0,0
79680,0,0,0,0,0
14,0,0,0,0,0
107506,0,0,0,0,0
1319,0,0,0,0,0
57534,0,0,0,0,0
48345,0,0,0,0,0
118431,0,0,0,0,0
98708,0,0,0,0,0
3294,0,0,0,0,0
107272,0,0,0,0,0
8261,0,0,0,0,0
94582,0,0,0,0,0
18538,0,0,0,0,0
102415,0,0,0,0,0
22275,0,0,0,0,0
65580,0,0,0,0,0
105258,0,0,0,0,0
102569,0,0,0,0,0
59274,0,0,0,0,0
17694,1,1,1,0,0
118708,0,0,0,0,0
57282,0,0,0,0,0
76740,0,0,0,0,0
69826,0,0,0,0,0
88844,0,0,0,0,0
81230,0,0,0,0,0
81494,0,0,0,0,0
62735,0,0,0,0,0
87725,0,0,0,0,0
17761,0,0,0,0,0
76525,0,0,0,0,0
110303,0,0,0,0,0
2857,0,0,0,0,0
97417,0,0,0,0,0
57440,0,0,0,0,0
34569,0,0,0,0,0
82736,0,0,0,0,0
11568,0,0,0,0,0
119353,0,0,0,0,0
8586,0,0,0,0,0
101616,0,0,0,0,0
90661,0,0,0,0,0
76674,0,0,0,0,0
43190,0,0,0,0,0
53083,0,0,0,0,0
78532,4,4,4,0,0
21950,0,0,0,0,0
10234,0,0,0,0,0
45700,0,0,0,0,0
97388,1,1,1,0,0
4106,0,0,0,0,0
22480,0,0,0,0,0
13201,0,0,0,0,0
13520,0,0,0,0,0
31780,0,0,0,0,0
104317,0,0,0,0,0
100787,0,0,0,0,0
55848,0,0,0,0,0
16513,0,0,0,0,0
93100,0,0,0,0,0
13007,0,0,0,0,0
77964,0,0,0,0,0
94196,0,0,0,0,0
34012,0,0,0,0,0
100360,0,0,0,0,0
89190,0,0,0,0,0
77962,0,0,0,0,0
32145,0,0,0,0,0
64694,0,0,0,0,0
3609,0,0,0,0,0
22602,0,0,0,0,0
42618,0,0,0,0,0
55967,0,0,0,0,0
91450,0,0,0,0,0
85122,0,0,0,0,0
97352,0,0,0,0,0
5108,0,0,0,0,0
116573,0,0,0,0,0
102840,0,0,0,0,0
17316,0,0,0,0,0
19724,0,0,0,0,0
55068,0,0,0,0,0
112636,0,0,0,0,0
111747,0,0,0,0,0
1907,0,0,0,0,0
13067,0,0,0,0,0
77767,0,0,0,0,0
11932,0,0,0,0,0
56328,0,0,0,0,0
4895,0,0,0,0,0
6378,0,0,0,0,0
119085,0,0,0,0,0
25375,0,0,0,0,0
71433,0,0,0,0,0
60181,0,0,0,0,0
40674,0,0,0,0,0
1122,1,1,1,0,0
53287,0,0,0,0,0
68259,0,0,0,0,0
48062,0,0,0,0,0
108931,0,0,0,0,0
108092,0,0,0,0,0
75344,0,0,0,0,0
107835,0,0,0,0,0
84902,0,0,0,0,0
78428,0,0,0,0,0
11882,0,0,0,0,0
51022,0,0,0,0,0
115149,0,0,0,0,0
86769,0,0,0,0,0
36381,0,0,0,0,0
56735,0,0,0,0,0
60413,0,0,0,0,0
103557,0,0,0,0,0
70217,0,0,0,0,0
75824,0,0,0,0,0
111917,0,0,0,0,0
118577,0,0,0,0,0
33315,0,0,0,0,0
60524,0,0,0,0,0
93541,0,0,0,0,0
113553,0,0,0,0,0
37020,0,0,0,0,0
112247,0,0,0,0,0
52433,0,0,0,0,0
50377,0,0,0,0,0
79167,0,0,0,0,0
7032,0,0,0,0,0
81639,0,0,0,0,0
79926,0,0,0,0,0
60043,0,0,0,0,0
7776,0,0,0,0,0
52387,0,0,0,0,0
76426,0,0,0,0,0
117458,0,0,0,0,0
72841,0,0,0,0,0
88169,0,0,0,0,0
60495,0,0,0,0,0
38422,0,0,0,0,0
101425,0,0,0,0,0
13743,0,0,0,0,0
28648,0,0,0,0,0
40586,0,0,0,0,0
73146,0,0,0,0,0
81275,0,0,0,0,0
86389,0,0,0,0,0
14291,0,0,0,0,0
74815,0,0,0,0,0
42021,0,0,0,0,0
97299,1,1,1,0,0
48499,0,0,0,0,0
28593,0,0,0,0,0
68735,0,0,0,0,0
76497,0,0,0,0,0
72390,0,0,0,0,0
53748,0,0,0,0,0
9051,0,0,0,0,0
31954,0,0,0,0,0
46779,0,0,0,0,0
65046,0,0,0,0,0
34320,0,0,0,0,0
93155,0,0,0,0,0
100115,0,0,0,0,0
24221,0,0,0,0,0
57763,0,0,0,0,0
83881,0,0,0,0,0
117126,0,0,0,0,0
107391,0,0,0,0,0
49156,0,0,0,0,0
69747,0,0,0,0,0
89746,0,0,0,0,0
40273,0,0,0,0,0
46377,0,0,0,0,0
116328,0,0,0,0,0
28314,0,0,0,0,0
58607,0,0,0,0,0
90649,0,0,0,0,0
105008,0,0,0,0,0
77832,0,0,0,0,0
54457,0,0,0,0,0
80377,0,0,0,0,0
19857,0,0,0,0,0
100045,0,0,0,0,0
82809,0,0,0,0,0
117313,0,0,0,0,0
79109,0,0,0,0,0
81661,0,0,0,0,0
1220,3,3,3,0,0
29909,0,0,0,0,0
88127,0,0,0,0,0
52942,0,0,0,0,0
70170,0,0,0,0,0
58304,0,0,0,0,0
101662,0,0,0,0,0
77326,0,0,0,0,0
75089,0,0,0,0,0
2400,0,0,0,0,0
69489,0,0,0,0,0
58780,0,0,0,0,0
59014,1,1,1,0,0
3016,0,0,0,0,0
56414,0,0,0,0,0
15471,0,0,0,0,0
100792,0,0,0,0,0
65644,0,0,0,0,0
102673,0,0,0,0,0
53995,0,0,0,0,0
102249,0,0,0,0,0
44240,0,0,0,0,0
17885,0,0,0,0,0
104023,0,0,0,0,0
115648,0,0,0,0,0
53163,0,0,0,0,0
26618,0,0,0,0,0
107373,0,0,0,0,0
76703,0,0,0,0,0
79946,0,0,0,0,0
2973,0,0,0,0,0
74411,0,0,0,0,0
21736,0,0,0,0,0
26965,0,0,0,0,0
16579,0,0,0,0,0
90468,0,0,0,0,0
13296,0,0,0,0,0
22755,0,0,0,0,0
84926,0,0,0,0,0
64762,0,0,0,0,0
40644,0,0,0,0,0
40315,0,0,0,0,0
26091,0,0,0,0,0
89945,0,0,0,0,0
59221,0,0,0,0,0
28459,0,0,0,0,0
30106,0,0,0,0,0
77354,0,0,0,0,0
7921,0,0,0,0,0
119040,0,0,0,0,0
92460,0,0,0,0,0
66715,0,0,0,0,0
62553,0,0,0,0,0
34920,0,0,0,0,0
81874,0,0,0,0,0
92240,0,0,0,0,0
53084,0,0,0,0,0
62603,0,0,0,0,0
92773,0,0,0,0,0
2487,0,0,0,0,0
12496,0,0,0,0,0
526,0,0,0,0,0
114846,0,0,0,0,0
100335,0,0,0,0,0
14098,0,0,0,0,0
34602,4,4,4,0,0
84316,0,0,0,0,0
18146,0,0,0,0,0
97065,0,0,0,0,0
63286,0,0,0,0,0
98234,0,0,0,0,0
24929,0,0,0,0,0
45859,0,0,0,0,0
4356,0,0,0,0,0
36687,0,0,0,0,0
73797,0,0,0,0,0
44225,0,0,0,0,0
90213,0,0,0,0,0
116024,0,0,0,0,0
92160,0,0,0,0,0
97527,0,0,0,0,0
76023,0,0,0,0,0
47548,0,0,0,0,0
106272,0,0,0,0,0
75057,0,0,0,0,0
56334,0,0,0,0,0
2661,0,0,0,0,0
48771,0,0,0,0,0
55143,0,0,0,0,0
15807,0,0,0,0,0
89776,0,0,0,0,0
92554,0,0,0,0,0
74618,0,0,0,0,0
52392,0,0,0,0,0
30486,0,0,0,0,0
106684,0,0,0,0,0
119350,0,0,0,0,0
26950,0,0,0,0,0
16843,0,0,0,0,0
102295,3,3,3,0,0
48980,0,0,0,0,0
1155,0,0,0,0,0
77957,0,0,0,0,0
64523,0,0,0,0,0
39520,0,0,0,0,0
79623,0,0,0,0,0
40704,0,0,0,0,0
99299,0,0,0,0,0
9837,0,0,0,0,0
69916,0,0,0,0,0
83501,0,0,0,0,0
34188,0,0,0,0,0
7724,0,0,0,0,0
112306,0,0,0,0,0
63874,0,0,0,0,0
29991,0,0,0,0,0
19755,0,0,0,0,0
113004,0,0,0,0,0
119816,0,0,0,0,0
79624,0,0,0,0,0
38227,0,0,0,0,0
60450,0,0,0,0,0
90032,0,0,0,0,0
5517,0,0,0,0,0
3468,0,0,0,0,0
109379,0,0,0,0,0
117625,0,0,0,0,0
18079,0,0,0,0,0
109034,0,0,0,0,0
82248,0,0,0,0,0
37117,0,0,0,0,0
37838,0,0,0,0,0
32998,0,0,0,0,0
78529,0,0,0,0,0
87615,0,0,0,0,0
70072,0,0,0,0,0
19704,0,0,0,0,0
50348,0,0,0,0,0
15390,0,0,0,0,0
35323,0,0,0,0,0
42579,0,0,0,0,0
31050,0,0,0,0,0
97938,0,0,0,0,0
46968,0,0,0,0,0
2785,0,0,0,0,0
33339,0,0,0,0,0
21613,0,0,0,0,0
111002,0,0,0,0,0
42069,0,0,0,0,0
107996,0,0,0,0,0
72219,0,0,0,0,0
26198,0,0,0,0,0
29847,0,0,0,0,0
68017,0,0,0,0,0
30259,0,0,0,0,0
16450,0,0,0,0,0
30417,0,0,0,0,0
101504,0,0,0,0,0
102654,0,0,0,0,0
65193,0,0,0,0,0
47171,0,0,0,0,0
114885,0,0,0,0,0
46252,0,0,0,0,0
30515,0,0,0,0,0
63279,0,0,0,0,0
98,0,0,0,0,0
15664,0,0,0,0,0
55984,0,0,0,0,0
7849,0,0,0,0,0
50984,0,0,0,0,0
19978,0,0,0,0,0
94189,0,0,0,0,0
3834,0,0,0,0,0
83607,0,0,0,0,0
61662,0,0,0,0,0
86302,0,0,0,0,0
31171,0,0,0,0,0
85084,0,0,0,0,0
47762,0,0,0,0,0
8441,0,0,0,0,0
110838,0,0,0,0,0
86614,0,0,0,0,0
21154,0,0,0,0,0
86055,0,0,0,0,0
14089,0,0,0,0,0
8670,0,0,0,0,0
116313,0,0,0,0,0
23604,0,0,0,0,0
6783,0,0,0,0,0
104463,0,0,0,0,0
98436,3,3,3,0,0
89410,0,0,0,0,0
74578,0,0,0,0,0
29571,0,0,0,0,0
54262,0,0,0,0,0
56534,0,0,0,0,0
70681,0,0,0,0,0
77655,0,0,0,0,0
114895,0,0,0,0,0
41008,0,0,0,0,0
84033,0,0,0,0,0
44174,0,0,0,0,0
95640,0,0,0,0,0
41901,0,0,0,0,0
18563,0,0,0,0,0
89286,0,0,0,0,0
39804,0,0,0,0,0
70360,0,0,0,0,0
49119,0,0,0,0,0
45682,0,0,0,0,0
17234,0,0,0,0,0
115429,0,0,0,0,0
9207,0,0,0,0,0
23372,0,0,0,0,0
11955,0,0,0,0,0
77015,0,0,0,0,0
39339,0,0,0,0,0
49734,0,0,0,0,0
78731,0,0,0,0,0
91366,0,0,0,0,0
84757,5,5,5,0,0
22518,0,0,0,0,0
39144,0,0,0,0,0
30312,0,0,0,0,0
107348,0,0,0,0,0
3634,0,0,0,0,0
46440,0,0,0,0,0
38811,0,0,0,0,0
65285,0,0,0,0,0
5308,0,0,0,0,0
69092,0,0,0,0,0
32548,0,0,0,0,0
82678,0,0,0,0,0
56329,0,0,0,0,0
46830,0,0,0,0,0
23336,0,0,0,0,0
99251,0,0,0,0,0
86690,0,0,0,0,0
5794,0,0,0,0,0
104320,0,0,0,0,0
96319,0,0,0,0,0
8915,1,1,1,0,0
109636,0,0,0,0,0
35487,0,0,0,0,0
24519,0,0,0,0,0
68975,0,0,0,0,0
36068,0,0,0,0,0
93529,0,0,0,0,0
40953,0,0,0,0,0
100692,0,0,0,0,0
90523,0,0,0,0,0
31474,0,0,0,0,0
119132,0,0,0,0,0
1358,0,0,0,0,0
65999,0,0,0,0,0
106374,0,0,0,0,0
119117,0,0,0,0,0
114654,0,0,0,0,0
65052,0,0,0,0,0
21076,0,0,0,0,0
26774,0,0,0,0,0
79658,0,0,0,0,0
65341,0,0,0,0,0
20531,0,0,0,0,0
57931,0,0,0,0,0
84862,0,0,0,0,0
104086,0,0,0,0,0
27099,0,0,0,0,0
69886,0,0,0,0,0
61819,0,0,0,0,0
87617,0,0,0,0,0
42237,0,0,0,0,0
31907,0,0,0,0,0
41939,0,0,0,0,0
36788,0,0,0,0,0
109364,0,0,0,0,0
117573,0,0,0,0,0
86526,0,0,0,0,0
20794,0,0,0,0,0
78400,0,0,0,0,0
102657,0,0,0,0,0
55615,0,0,0,0,0
114222,0,0,0,0,0
16753,0,0,0,0,0
109762,0,0,0,0,0
62832,0,0,0,0,0
10278,0,0,0,0,0
61965,0,0,0,0,0
44725,0,0,0,0,0
64384,0,0,0,0,0
10657,0,0,0,0,0
63810,0,0,0,0,0
34621,0,0,0,0,0
76268,0,0,0,0,0
70603,0,0,0,0,0
8448,0,0,0,0,0
516,0,0,0,0,0
11252,0,0,0,0,0
75980,0,0,0,0,0
21149,0,0,0,0,0
57565,0,0,0,0,0
79945,0,0,0,0,0
87176,0,0,0,0,0
79816,0,0,0,0,0
18790,0,0,0,0,0
6436,0,0,0,0,0
33973,0,0,0,0,0
52310,0,0,0,0,0
49229,0,0,0,0,0
5815,0,0,0,0,0
110474,0,0,0,0,0
57908,0,0,0,0,0
39258,0,0,0,0,0
89485,0,0,0,0,0
57797,0,0,0,0,0
12141,0,0,0,0,0
43663,0,0,0,0,0
68387,0,0,0,0,0
81942,0,0,0,0,0
81855,0,0,0,0,0
24759,0,0,0,0,0
12501,0,0,0,0,0
38879,0,0,0,0,0
60908,0,0,0,0,0
117666,0,0,0,0,0
88207,0,0,0,0,0
112439,0,0,0,0,0
62999,0,0,0,0,0
6967,0,0,0,0,0
92926,0,0,0,0,0
41672,0,0,0,0,0
105975,0,0,0,0,0
89124,0,0,0,0,0
58268,0,0,0,0,0
56222,0,0,0,0,0
49111,0,0,0,0,0
104670,0,0,0,0,0
118104,0,0,0,0,0
15251,0,0,0,0,0
107437,0,0,0,0,0
76982,0,0,0,0,0
33022,0,0,0,0,0
113298,0,0,0,0,0
26188,0,0,0,0,0
119929,0,0,0,0,0
75129,0,0,0,0,0
44669,0,0,0,0,0
79440,0,0,0,0,0
119630,0,0,0,0,0
46857,0,0,0,0,0
100049,0,0,0,0,0
60194,0,0,0,0,0
69959,0,0,0,0,0
29133,0,0,0,0,0
59871,0,0,0,0,0
2001,0,0,0,0,0
6716,0,0,0,0,0
20153,0,0,0,0,0
37017,0,0,0,0,0
52220,0,0,0,0,0
119710,0,0,0,0,0
12559,0,0,0,0,0
38787,0,0,0,0,0
48582,0,0,0,0,0
19637,0,0,0,0,0
91601,1,1,1,0,0
90359,0,0,0,0,0
114488,0,0,0,0,0
7789,0,0,0,0,0
89092,0,0,0,0,0
43778,0,0,0,0,0
92266,0,0,0,0,0
54350,0,0,0,0,0
74955,0,0,0,0,0
56704,0,0,0,0,0
102564,0,0,0,0,0
27786,0,0,0,0,0
6846,2,2,2,0,0
69352,0,0,0,0,0
81861,0,0,0,0,0
100766,0,0,0,0,0
62367,0,0,0,0,0
23479,0,0,0,0,0
22280,0,0,0,0,0
47948,0,0,0,0,0
117148,0,0,0,0,0
99371,2,2,2,0,0
97853,0,0,0,0,0
108224,0,0,0,0,0
16832,0,0,0,0,0
25821,0,0,0,0,0
87265,0,0,0,0,0
101977,0,0,0,0,0
23145,0,0,0,0,0
116099,0,0,0,0,0
91981,0,0,0,0,0
64014,0,0,0,0,0
48151,0,0,0,0,0
92255,0,0,0,0,0
100844,0,0,0,0,0
26082,1,1,1,0,0
31104,0,0,0,0,0
98627,0,0,0,0,0
41450,0,0,0,0,0
103978,0,0,0,0,0
92929,0,0,0,0,0
22681,0,0,0,0,0
20815,0,0,0,0,0
87305,0,0,0,0,0
103777,0,0,0,0,0
51378,0,0,0,0,0
108247,0,0,0,0,0
32057,0,0,0,0,0
12388,0,0,0,0,0
23602,0,0,0,0,0
90062,0,0,0,0,0
107133,0,0,0,0,0
53222,0,0,0,0,0
32857,0,0,0,0,0
72278,0,0,0,0,0
66232,0,0,0,0,0
89090,0,0,0,0,0
77532,0,0,0,0,0
14482,0,0,0,0,0
70839,0,0,0,0,0
80082,0,0,0,0,0
100854,0,0,0,0,0
30071,0,0,0,0,0
101945,0,0,0,0,0
75618,0,0,0,0,0
61830,0,0,0,0,0
10007,0,0,0,0,0
107175,0,0,0,0,0
117873,0,0,0,0,0
78524,0,0,0,0,0
97586,0,0,0,0,0
95548,0,0,0,0,0
73385,0,0,0,0,0
27559,0,0,0,0,0
15561,0,0,0,0,0
107309,0,0,0,0,0
14903,0,0,0,0,0
63840,0,0,0,0,0
100824,0,0,0,0,0
25077,0,0,0,0,0
101857,0,0,0,0,0
36112,0,0,0,0,0
59341,0,0,0,0,0
58672,0,0,0,0,0
55853,0,0,0,0,0
65522,0,0,0,0,0
80488,0,0,0,0,0
23883,0,0,0,0,0
76867,0,0,0,0,0
120268,0,0,0,0,0
13694,0,0,0,0,0
34068,0,0,0,0,0
64085,0,0,0,0,0
10269,0,0,0,0,0
55170,0,0,0,0,0
60683,0,0,0,0,0
2426,0,0,0,0,0
51549,0,0,0,0,0
15184,0,0,0,0,0
90528,0,0,0,0,0
38627,0,0,0,0,0
108921,0,0,0,0,0
105898,0,0,0,0,0
106172,0,0,0,0,0
8164,0,0,0,0,0
49049,0,0,0,0,0
61919,0,0,0,0,0
73562,0,0,0,0,0
16656,0,0,0,0,0
50247,0,0,0,0,0
97069,0,0,0,0,0
104223,0,0,0,0,0
57891,0,0,0,0,0
12756,0,0,0,0,0
67302,0,0,0,0,0
68734,0,0,0,0,0
28704,0,0,0,0,0
88626,0,0,0,0,0
42778,0,0,0,0,0
81036,0,0,0,0,0
78655,0,0,0,0,0
108536,0,0,0,0,0
120409,0,0,0,0,0
18817,0,0,0,0,0
19576,0,0,0,0,0
104151,0,0,0,0,0
7773,0,0,0,0,0
79650,0,0,0,0,0
71191,0,0,0,0,0
93122,0,0,0,0,0
118014,1,1,1,0,0
104799,0,0,0,0,0
52798,0,0,0,0,0
115381,0,0,0,0,0
76432,0,0,0,0,0
74424,0,0,0,0,0
25783,0,0,0,0,0
27392,0,0,0,0,0
4117,0,0,0,0,0
111794,0,0,0,0,0
69358,0,0,0,0,0
112399,0,0,0,0,0
93477,0,0,0,0,0
43395,0,0,0,0,0
56945,0,0,0,0,0
42596,0,0,0,0,0
84318,0,0,0,0,0
54613,0,0,0,0,0
29647,0,0,0,0,0
51243,0,0,0,0,0
55260,0,0,0,0,0
12016,0,0,0,0,0
68165,0,0,0,0,0
11574,0,0,0,0,0
114213,0,0,0,0,0
22246,0,0,0,0,0
54587,0,0,0,0,0
103659,0,0,0,0,0
62091,0,0,0,0,0
18612,0,0,0,0,0
23846,0,0,0,0,0
118914,0,0,0,0,0
2576,0,0,0,0,0
80679,0,0,0,0,0
84972,0,0,0,0,0
84859,0,0,0,0,0
9648,0,0,0,0,0
66480,0,0,0,0,0
101205,0,0,0,0,0
99187,0,0,0,0,0
70624,0,0,0,0,0
40281,0,0,0,0,0
82986,1,1,1,0,0
98584,0,0,0,0,0
38059,0,0,0,0,0
79451,0,0,0,0,0
53321,0,0,0,0,0
10258,0,0,0,0,0
88462,0,0,0,0,0
75598,0,0,0,0,0
531,0,0,0,0,0
55734,0,0,0,0,0
105821,0,0,0,0,0
92499,0,0,0,0,0
33442,0,0,0,0,0
59952,1,1,1,0,0
56954,0,0,0,0,0
22461,0,0,0,0,0
14392,0,0,0,0,0
24986,0,0,0,0,0
15350,0,0,0,0,0
96361,0,0,0,0,0
43795,0,0,0,0,0
101138,0,0,0,0,0
43335,1,1,1,0,0
49108,0,0,0,0,0
48449,0,0,0,0,0
78023,0,0,0,0,0
2007,0,0,0,0,0
2638,1,1,1,0,0
40471,0,0,0,0,0
34981,0,0,0,0,0
98912,0,0,0,0,0
787,0,0,0,0,0
75998,0,0,0,0,0
32093,0,0,0,0,0
14613,0,0,0,0,0
50821,0,0,0,0,0
97142,0,0,0,0,0
107435,0,0,0,0,0
27653,0,0,0,0,0
37048,0,0,0,0,0
35450,0,0,0,0,0
111998,2,2,2,0,0
103588,0,0,0,0,0
60417,0,0,0,0,0
85320,0,0,0,0,0
106386,0,0,0,0,0
61359,0,0,0,0,0
47974,0,0,0,0,0
44821,0,0,0,0,0
103137,0,0,0,0,0
53536,0,0,0,0,0
62871,0,0,0,0,0
13912,0,0,0,0,0
112354,0,0,0,0,0
29823,0,0,0,0,0
21301,0,0,0,0,0
108365,0,0,0,0,0
52895,0,0,0,0,0
56905,0,0,0,0,0
64371,0,0,0,0,0
86773,0,0,0,0,0
6469,0,0,0,0,0
46467,0,0,0,0,0
45415,0,0,0,0,0
17639,0,0,0,0,0
92017,0,0,0,0,0
115226,0,0,0,0,0
72900,0,0,0,0,0
41120,0,0,0,0,0
41632,0,0,0,0,0
52295,0,0,0,0,0
6289,0,0,0,0,0
21185,0,0,0,0,0
53634,0,0,0,0,0
65481,0,0,0,0,0
21459,0,0,0,0,0
54777,0,0,0,0,0
74732,0,0,0,0,0
43402,0,0,0,0,0
119356,0,0,0,0,0
28010,0,0,0,0,0
41114,0,0,0,0,0
18929,0,0,0,0,0
118334,0,0,0,0,0
68237,0,0,0,0,0
77841,0,0,0,0,0
13968,0,0,0,0,0
58314,0,0,0,0,0
21926,0,0,0,0,0
91969,0,0,0,0,0
25937,0,0,0,0,0
92230,0,0,0,0,0
20930,0,0,0,0,0
66420,0,0,0,0,0
85742,0,0,0,0,0
7330,0,0,0,0,0
96073,0,0,0,0,0
13054,0,0,0,0,0
76492,0,0,0,0,0
19060,0,0,0,0,0
94780,0,0,0,0,0
79573,0,0,0,0,0
49031,0,0,0,0,0
12687,0,0,0,0,0
29141,0,0,0,0,0
34359,0,0,0,0,0
64568,0,0,0,0,0
95484,0,0,0,0,0
98606,0,0,0,0,0
41092,0,0,0,0,0
106277,0,0,0,0,0
86835,0,0,0,0,0
76292,0,0,0,0,0
2071,0,0,0,0,0
101804,0,0,0,0,0
26243,0,0,0,0,0
106168,0,0,0,0,0
64024,0,0,0,0,0
88727,0,0,0,0,0
8319,0,0,0,0,0
93658,0,0,0,0,0
71547,0,0,0,0,0
32507,0,0,0,0,0
22037,0,0,0,0,0
110184,0,0,0,0,0
44404,0,0,0,0,0
113264,0,0,0,0,0
26585,0,0,0,0,0
37881,3,3,3,0,0
3772,0,0,0,0,0
85458,0,0,0,0,0
5424,0,0,0,0,0
39249,0,0,0,0,0
16033,0,0,0,0,0
87823,0,0,0,0,0
81929,0,0,0,0,0
94007,0,0,0,0,0
65038,0,0,0,0,0
102826,0,0,0,0,0
54188,0,0,0,0,0
66365,0,0,0,0,0
110964,0,0,0,0,0
110954,0,0,0,0,0
44869,0,0,0,0,0
117186,0,0,0,0,0
2884,0,0,0,0,0
77900,0,0,0,0,0
96860,0,0,0,0,0
33624,0,0,0,0,0
36242,0,0,0,0,0
42556,0,0,0,0,0
3414,0,0,0,0,0
104322,3,3,3,0,0
90858,0,0,0,0,0
36495,0,0,0,0,0
32067,0,0,0,0,0
114420,0,0,0,0,0
76360,0,0,0,0,0
101246,0,0,0,0,0
20161,0,0,0,0,0
13428,0,0,0,0,0
105198,0,0,0,0,0
34957,0,0,0,0,0
60313,0,0,0,0,0
106023,0,0,0,0,0
2574,0,0,0,0,0
54245,0,0,0,0,0
99293,0,0,0,0,0
5160,0,0,0,0,0
61382,0,0,0,0,0
91676,0,0,0,0,0
78999,0,0,0,0,0
88882,0,0,0,0,0
118738,0,0,0,0,0
106633,0,0,0,0,0
47360,0,0,0,0,0
23286,0,0,0,0,0
86915,0,0,0,0,0
43660,0,0,0,0,0
79592,0,0,0,0,0
69465,0,0,0,0,0
98494,0,0,0,0,0
109522,0,0,0,0,0
82499,0,0,0,0,0
112690,0,0,0,0,0
56476,0,0,0,0,0
105438,0,0,0,0,0
70499,0,0,0,0,0
25944,1,1,1,0,0
5573,0,0,0,0,0
79124,0,0,0,0,0
111349,0,0,0,0,0
92972,0,0,0,0,0
31832,0,0,0,0,0
96163,0,0,0,0,0
1223,0,0,0,0,0
63939,0,0,0,0,0
6071,0,0,0,0,0
23698,0,0,0,0,0
58584,1,1,1,0,0
80492,0,0,0,0,0
89412,0,0,0,0,0
99568,0,0,0,0,0
98427,0,0,0,0,0
74894,0,0,0,0,0
64032,0,0,0,0,0
99066,0,0,0,0,0
91648,0,0,0,0,0
23090,0,0,0,0,0
19731,0,0,0,0,0
9274,0,0,0,0,0
77839,0,0,0,0,0
49458,1,1,1,0,0
108162,0,0,0,0,0
44816,0,0,0,0,0
6371,0,0,0,0,0
6450,0,0,0,0,0
70139,0,0,0,0,0
38600,0,0,0,0,0
45519,0,0,0,0,0
117121,0,0,0,0,0
69548,0,0,0,0,0
111814,0,0,0,0,0
35056,0,0,0,0,0
7642,0,0,0,0,0
29385,0,0,0,0,0
15752,0,0,0,0,0
20946,0,0,0,0,0
69836,0,0,0,0,0
114832,0,0,0,0,0
85920,0,0,0,0,0
94302,0,0,0,0,0
60601,0,0,0,0,0
112940,0,0,0,0,0
18915,0,0,0,0,0
4992,0,0,0,0,0
2767,0,0,0,0,0
115089,0,0,0,0,0
106079,0,0,0,0,0
17878,0,0,0,0,0
63787,0,0,0,0,0
2896,0,0,0,0,0
109854,0,0,0,0,0
29465,0,0,0,0,0
105124,0,0,0,0,0
19362,0,0,0,0,0
14058,0,0,0,0,0
986,0,0,0,0,0
10300,0,0,0,0,0
107537,0,0,0,0,0
19177,0,0,0,0,0
24045,0,0,0,0,0
120359,0,0,0,0,0
72461,0,0,0,0,0
113310,0,0,0,0,0
34942,0,0,0,0,0
81489,0,0,0,0,0
98654,0,0,0,0,0
12694,0,0,0,0,0
13134,0,0,0,0,0
64271,0,0,0,0,0
111725,0,0,0,0,0
98834,0,0,0,0,0
102722,0,0,0,0,0
115659,0,0,0,0,0
70224,0,0,0,0,0
101454,0,0,0,0,0
198,0,0,0,0,0
116090,0,0,0,0,0
59988,0,0,0,0,0
53069,2,2,2,0,0
52970,0,0,0,0,0
9699,0,0,0,0,0
31417,0,0,0,0,0
1069,0,0,0,0,0
72899,0,0,0,0,0
71308,0,0,0,0,0
94038,0,0,0,0,0
77062,0,0,0,0,0
1623,0,0,0,0,0
49368,3,3,3,0,0
50422,0,0,0,0,0
75134,0,0,0,0,0
32203,0,0,0,0,0
3893,0,0,0,0,0
74107,0,0,0,0,0
94300,0,0,0,0,0
78298,0,0,0,0,0
75681,0,0,0,0,0
110427,0,0,0,0,0
68238,0,0,0,0,0
103526,0,0,0,0,0
54485,0,0,0,0,0
24794,0,0,0,0,0
100137,0,0,0,0,0
63627,0,0,0,0,0
101048,0,0,0,0,0
23671,0,0,0,0,0
87898,0,0,0,0,0
68563,0,0,0,0,0
44005,0,0,0,0,0
27458,5,5,5,0,0
35030,0,0,0,0,0
85046,0,0,0,0,0
81672,0,0,0,0,0
89293,0,0,0,0,0
13699,0,0,0,0,0
9406,0,0,0,0,0
43875,0,0,0,0,0
92290,0,0,0,0,0
40376,0,0,0,0,0
16129,0,0,0,0,0
58442,0,0,0,0,0
106510,0,0,0,0,0
39857,0,0,0,0,0
34168,0,0,0,0,0
24934,0,0,0,0,0
85949,0,0,0,0,0
42284,0,0,0,0,0
119634,0,0,0,0,0
35537,0,0,0,0,0
55490,0,0,0,0,0
109613,0,0,0,0,0
81657,0,0,0,0,0
58900,0,0,0,0,0
9658,0,0,0,0,0
39800,0,0,0,0,0
56893,0,0,0,0,0
65625,1,1,1,0,0
8564,0,0,0,0,0
21742,0,0,0,0,0
4345,0,0,0,0,0
78882,0,0,0,0,0
68212,0,0,0,0,0
21009,0,0,0,0,0
112533,0,0,0,0,0
68436,0,0,0,0,0
53025,0,0,0,0,0
55550,0,0,0,0,0
79548,0,0,0,0,0
97165,0,0,0,0,0
16095,0,0,0,0,0
64111,0,0,0,0,0
88361,0,0,0,0,0
1763,0,0,0,0,0
3930,4,4,4,0,0
65172,0,0,0,0,0
104960,0,0,0,0,0
88557,0,0,0,0,0
107766,0,0,0,0,0
13305,0,0,0,0,0
37014,0,0,0,0,0
37811,0,0,0,0,0
51541,0,0,0,0,0
4357,0,0,0,0,0
55509,0,0,0,0,0
89937,0,0,0,0,0
15875,0,0,0,0,0
109019,0,0,0,0,0
13448,0,0,0,0,0
76021,0,0,0,0,0
11984,0,0,0,0,0
114296,0,0,0,0,0
72473,0,0,0,0,0
26628,0,0,0,0,0
49882,0,0,0,0,0
98932,0,0,0,0,0
34126,0,0,0,0,0
59419,0,0,0,0,0
2278,0,0,0,0,0
32426,0,0,0,0,0
101372,0,0,0,0,0
35692,0,0,0,0,0
2201,0,0,0,0,0
45923,0,0,0,0,0
10157,0,0,0,0,0
61197,0,0,0,0,0
94310,0,0,0,0,0
26738,0,0,0,0,0
106312,0,0,0,0,0
22698,0,0,0,0,0
46593,0,0,0,0,0
77163,0,0,0,0,0
103406,1,1,1,0,0
111166,0,0,0,0,0
33197,0,0,0,0,0
44319,0,0,0,0,0
69345,0,0,0,0,0
116297,0,0,0,0,0
57085,0,0,0,0,0
110338,0,0,0,0,0
113381,0,0,0,0,0
111638,0,0,0,0,0
59547,0,0,0,0,0
67955,0,0,0,0,0
6797,0,0,0,0,0
80730,0,0,0,0,0
88402,0,0,0,0,0
14618,0,0,0,0,0
111094,0,0,0,0,0
91907,0,0,0,0,0
21083,1,1,1,0,0
76895,0,0,0,0,0
28191,0,0,0,0,0
84098,0,0,0,0,0
92252,0,0,0,0,0
74850,0,0,0,0,0
25018,0,0,0,0,0
83220,0,0,0,0,0
11240,0,0,0,0,0
69376,0,0,0,0,0
86082,0,0,0,0,0
105476,0,0,0,0,0
60423,0,0,0,0,0
102253,0,0,0,0,0
62851,0,0,0,0,0
41837,0,0,0,0,0
112907,0,0,0,0,0
115844,0,0,0,0,0
30062,0,0,0,0,0
32590,0,0,0,0,0
79457,0,0,0,0,0
39360,0,0,0,0,0
21137,0,0,0,0,0
10336,0,0,0,0,0
117024,0,0,0,0,0
111285,4,4,4,0,0
115764,0,0,0,0,0
29184,0,0,0,0,0
6012,0,0,0,0,0
79699,0,0,0,0,0
69134,0,0,0,0,0
48890,0,0,0,0,0
98650,0,0,0,0,0
96905,0,0,0,0,0
84480,0,0,0,0,0
26030,0,0,0,0,0
40575,0,0,0,0,0
65266,0,0,0,0,0
52488,0,0,0,0,0
119597,0,0,0,0,0
91667,0,0,0,0,0
96048,0,0,0,0,0
13963,0,0,0,0,0
15133,0,0,0,0,0
43525,0,0,0,0,0
7572,0,0,0,0,0
73456,0,0,0,0,0
102766,0,0,0,0,0
45161,0,0,0,0,0
47362,0,0,0,0,0
39350,0,0,0,0,0
113607,0,0,0,0,0
111390,0,0,0,0,0
97279,0,0,0,0,0
5231,0,0,0,0,0
41436,0,0,0,0,0
24381,0,0,0,0,0
63780,0,0,0,0,0
3849,0,0,0,0,0
60000,0,0,0,0,0
23811,0,0,0,0,0
117874,0,0,0,0,0
81735,0,0,0,0,0
96816,0,0,0,0,0
34764,0,0,0,0,0
879,0,0,0,0,0
102375,0,0,0,0,0
119621,0,0,0,0,0
113610,0,0,0,0,0
118236,0,0,0,0,0
90240,0,0,0,0,0
9691,0,0,0,0,0
49206,0,0,0,0,0
46525,0,0,0,0,0
56950,0,0,0,0,0
413,0,0,0,0,0
81530,0,0,0,0,0
72792,4,4,4,0,0
102988,0,0,0,0,0
68693,0,0,0,0,0
44935,0,0,0,0,0
17356,0,0,0,0,0
96258,0,0,0,0,0
23301,0,0,0,0,0
11778,0,0,0,0,0
43476,0,0,0,0,0
4552,0,0,0,0,0
2900,0,0,0,0,0
17638,0,0,0,0,0
15060,0,0,0,0,0
66674,0,0,0,0,0
20204,0,0,0,0,0
20798,0,0,0,0,0
81041,0,0,0,0,0
101899,0,0,0,0,0
116222,0,0,0,0,0
43472,0,0,0,0,0
94926,0,0,0,0,0
54722,0,0,0,0,0
83513,0,0,0,0,0
119568,0,0,0,0,0
111093,0,0,0,0,0
110778,0,0,0,0,0
62780,0,0,0,0,0
43101,0,0,0,0,0
84703,0,0,0,0,0
49036,0,0,0,0,0
68460,0,0,0,0,0
40268,0,0,0,0,0
40336,0,0,0,0,0
62411,0,0,0,0,0
3570,0,0,0,0,0
79175,0,0,0,0,0
109634,0,0,0,0,0
77160,0,0,0,0,0
73677,0,0,0,0,0
35066,0,0,0,0,0
37399,0,0,0,0,0
12592,0,0,0,0,0
30651,0,0,0,0,0
27076,0,0,0,0,0
2030,0,0,0,0,0
28213,0,0,0,0,0
97096,0,0,0,0,0
98028,0,0,0,0,0
66826,0,0,0,0,0
112010,0,0,0,0,0
77860,0,0,0,0,0
22930,0,0,0,0,0
34125,0,0,0,0,0
3126,0,0,0,0,0
111382,0,0,0,0,0
111523,0,0,0,0,0
23317,0,0,0,0,0
117118,0,0,0,0,0
107346,0,0,0,0,0
54472,0,0,0,0,0
77861,0,0,0,0,0
27987,0,0,0,0,0
62272,0,0,0,0,0
56460,1,1,1,0,0
3163,0,0,0,0,0
53979,0,0,0,0,0
85432,0,0,0,0,0
39305,0,0,0,0,0
15492,0,0,0,0,0
66357,0,0,0,0,0
2842,0,0,0,0,0
47558,0,0,0,0,0
111132,1,1,1,0,0
78730,0,0,0,0,0
104671,0,0,0,0,0
30957,0,0,0,0,0
97432,0,0,0,0,0
105735,0,0,0,0,0
10029,0,0,0,0,0
101593,0,0,0,0,0
17914,0,0,0,0,0
18016,0,0,0,0,0
1649,0,0,0,0,0
87152,0,0,0,0,0
64161,0,0,0,0,0
90624,0,0,0,0,0
6167,0,0,0,0,0
117644,0,0,0,0,0
95563,0,0,0,0,0
26588,0,0,0,0,0
4296,0,0,0,0,0
1341,0,0,0,0,0
12470,0,0,0,0,0
75914,0,0,0,0,0
83547,0,0,0,0,0
16617,0,0,0,0,0
38525,0,0,0,0,0
32289,0,0,0,0,0
28989,0,0,0,0,0
40244,0,0,0,0,0
92777,0,0,0,0,0
38476,0,0,0,0,0
38869,0,0,0,0,0
5214,0,0,0,0,0
57340,0,0,0,0,0
31553,0,0,0,0,0
9567,0,0,0,0,0
46992,0,0,0,0,0
37004,0,0,0,0,0
52114,0,0,0,0,0
112275,0,0,0,0,0
68959,0,0,0,0,0
88669,0,0,0,0,0
55385,0,0,0,0,0
13714,0,0,0,0,0
100601,0,0,0,0,0
70530,0,0,0,0,0
73409,0,0,0,0,0
87194,0,0,0,0,0
94198,0,0,0,0,0
26321,0,0,0,0,0
39355,0,0,0,0,0
119764,0,0,0,0,0
60676,0,0,0,0,0
114393,0,0,0,0,0
71670,0,0,0,0,0
6595,0,0,0,0,0
25615,0,0,0,0,0
698,0,0,0,0,0
20637,0,0,0,0,0
118907,0,0,0,0,0
45572,0,0,0,0,0
86427,0,0,0,0,0
26689,0,0,0,0,0
16815,0,0,0,0,0
79346,0,0,0,0,0
17506,0,0,0,0,0
61547,0,0,0,0,0
89274,0,0,0,0,0
54769,0,0,0,0,0
116850,0,0,0,0,0
27144,0,0,0,0,0
30995,0,0,0,0,0
9393,0,0,0,0,0
39595,0,0,0,0,0
27512,0,0,0,0,0
31227,0,0,0,0,0
29899,0,0,0,0,0
30917,0,0,0,0,0
9747,0,0,0,0,0
100907,0,0,0,0,0
34521,0,0,0,0,0
114377,0,0,0,0,0
107035,0,0,0,0,0
87203,0,0,0,0,0
55949,0,0,0,0,0
104969,0,0,0,0,0
86830,0,0,0,0,0
119860,0,0,0,0,0
107686,0,0,0,0,0
21399,0,0,0,0,0
115533,0,0,0,0,0
6701,0,0,0,0,0
42036,0,0,0,0,0
113949,0,0,0,0,0
81834,1,1,1,0,0
6723,0,0,0,0,0
113014,0,0,0,0,0
60315,0,0,0,0,0
99997,0,0,0,0,0
79942,0,0,0,0,0
109665,0,0,0,0,0
12002,0,0,0,0,0
8627,0,0,0,0,0
22691,0,0,0,0,0
85284,0,0,0,0,0
1023,0,0,0,0,0
51923,0,0,0,0,0
62281,0,0,0,0,0
88485,0,0,0,0,0
27490,0,0,0,0,0
102937,0,0,0,0,0
112596,0,0,0,0,0
28018,0,0,0,0,0
24524,0,0,0,0,0
69779,1,1,1,0,0
11205,0,0,0,0,0
91033,0,0,0,0,0
30990,0,0,0,0,0
34694,0,0,0,0,0
93839,0,0,0,0,0
41824,0,0,0,0,0
31608,0,0,0,0,0
41864,0,0,0,0,0
12414,0,0,0,0,0
101935,0,0,0,0,0
15745,0,0,0,0,0
103333,0,0,0,0,0
40039,0,0,0,0,0
26912,0,0,0,0,0
16532,0,0,0,0,0
32334,0,0,0,0,0
70049,0,0,0,0,0
7456,0,0,0,0,0
52916,0,0,0,0,0
87467,0,0,0,0,0
32430,8,8,8,0,0
73209,0,0,0,0,0
58284,0,0,0,0,0
33373,0,0,0,0,0
90282,0,0,0,0,0
41978,0,0,0,0,0
84771,0,0,0,0,0
116764,0,0,0,0,0
100243,0,0,0,0,0
75473,0,0,0,0,0
62590,0,0,0,0,0
104656,0,0,0,0,0
38703,0,0,0,0,0
5935,0,0,0,0,0
17223,0,0,0,0,0
79705,0,0,0,0,0
57630,0,0,0,0,0
4150,0,0,0,0,0
61001,0,0,0,0,0
9726,0,0,0,0,0
22378,0,0,0,0,0
65088,0,0,0,0,0
98651,0,0,0,0,0
51757,0,0,0,0,0
92298,0,0,0,0,0
102122,0,0,0,0,0
42682,0,0,0,0,0
22955,0,0,0,0,0
111873,0,0,0,0,0
24284,0,0,0,0,0
80226,0,0,0,0,0
87788,0,0,0,0,0
69561,0,0,0,0,0
98675,0,0,0,0,0
112936,0,0,0,0,0
70526,0,0,0,0,0
103514,0,0,0,0,0
82089,0,0,0,0,0
84707,0,0,0,0,0
114040,0,0,0,0,0
101209,0,0,0,0,0
64623,0,0,0,0,0
42611,0,0,0,0,0
76508,0,0,0,0,0
113350,0,0,0,0,0
51020,0,0,0,0,0
88241,0,0,0,0,0
108981,0,0,0,0,0
93535,0,0,0,0,0
2634,0,0,0,0,0
67953,0,0,0,0,0
72646,0,0,0,0,0
101267,0,0,0,0,0
64482,0,0,0,0,0
108621,0,0,0,0,0
13091,0,0,0,0,0
33589,0,0,0,0,0
85904,0,0,0,0,0
95532,0,0,0,0,0
57885,0,0,0,0,0
102688,0,0,0,0,0
22821,0,0,0,0,0
11681,0,0,0,0,0
11217,0,0,0,0,0
82222,0,0,0,0,0
20175,0,0,0,0,0
99562,0,0,0,0,0
115903,0,0,0,0,0
19832,0,0,0,0,0
13292,0,0,0,0,0
10808,0,0,0,0,0
41479,0,0,0,0,0
38968,0,0,0,0,0
72050,0,0,0,0,0
20455,0,0,0,0,0
30058,0,0,0,0,0
102612,0,0,0,0,0
96371,0,0,0,0,0
112945,0,0,0,0,0
26217,0,0,0,0,0
101249,0,0,0,0,0
49833,0,0,0,0,0
104807,0,0,0,0,0
45863,0,0,0,0,0
120357,0,0,0,0,0
57668,0,0,0,0,0
82356,0,0,0,0,0
52788,0,0,0,0,0
120447,0,0,0,0,0
62155,0,0,0,0,0
110421,0,0,0,0,0
19430,0,0,0,0,0
93661,0,0,0,0,0
64454,0,0,0,0,0
58189,0,0,0,0,0
40516,0,0,0,0,0
39525,0,0,0,0,0
99728,0,0,0,0,0
21479,0,0,0,0,0
76865,0,0,0,0,0
50389,0,0,0,0,0
71894,0,0,0,0,0
32595,0,0,0,0,0
19054,0,0,0,0,0
52010,0,0,0,0,0
4567,2,2,2,0,0
76542,0,0,0,0,0
66584,0,0,0,0,0
3933,0,0,0,0,0
72670,0,0,0,0,0
117072,0,0,0,0,0
120129,0,0,0,0,0
36811,0,0,0,0,0
8652,0,0,0,0,0
97882,0,0,0,0,0
17283,0,0,0,0,0
20629,0,0,0,0,0
86472,0,0,0,0,0
47434,0,0,0,0,0
51025,0,0,0,0,0
69992,0,0,0,0,0
49400,0,0,0,0,0
49106,0,0,0,0,0
43929,0,0,0,0,0
75703,0,0,0,0,0
44333,0,0,0,0,0
110342,0,0,0,0,0
89870,0,0,0,0,0
84676,0,0,0,0,0
92632,0,0,0,0,0
69361,0,0,0,0,0
87505,0,0,0,0,0
5353,0,0,0,0,0
100024,0,0,0,0,0
95876,0,0,0,0,0
119579,0,0,0,0,0
90349,0,0,0,0,0
80123,0,0,0,0,0
49552,0,0,0,0,0
35518,0,0,0,0,0
107281,0,0,0,0,0
75889,0,0,0,0,0
74878,0,0,0,0,0
106174,0,0,0,0,0
21490,0,0,0,0,0
111081,0,0,0,0,0
64263,0,0,0,0,0
99229,0,0,0,0,0
44781,0,0,0,0,0
58367,0,0,0,0,0
37745,0,0,0,0,0
29238,0,0,0,0,0
99213,0,0,0,0,0
59327,0,0,0,0,0
80322,0,0,0,0,0
8660,0,0,0,0,0
83661,0,0,0,0,0
38438,0,0,0,0,0
46542,0,0,0,0,0
60230,0,0,0,0,0
68946,0,0,0,0,0
13439,0,0,0,0,0
98806,0,0,0,0,0
39871,0,0,0,0,0
71042,0,0,0,0,0
118231,0,0,0,0,0
59616,0,0,0,0,0
105637,0,0,0,0,0
62269,0,0,0,0,0
6123,0,0,0,0,0
112820,0,0,0,0,0
85614,0,0,0,0,0
19914,0,0,0,0,0
116320,0,0,0,0,0
10354,0,0,0,0,0
99627,0,0,0,0,0
102842,0,0,0,0,0
100714,0,0,0,0,0
96908,0,0,0,0,0
16337,0,0,0,0,0
118272,0,0,0,0,0
94109,0,0,0,0,0
86275,1,1,1,0,0
74635,0,0,0,0,0
73514,5,5,5,0,0
17971,0,0,0,0,0
43662,0,0,0,0,0
72949,0,0,0,0,0
77346,0,0,0,0,0
28691,0,0,0,0,0
111203,0,0,0,0,0
92292,0,0,0,0,0
69073,0,0,0,0,0
16562,0,0,0,0,0
67658,0,0,0,0,0
108520,0,0,0,0,0
97022,0,0,0,0,0
43260,0,0,0,0,0
10929,0,0,0,0,0
106039,0,0,0,0,0
108111,0,0,0,0,0
119099,0,0,0,0,0
98313,0,0,0,0,0
28498,0,0,0,0,0
69901,0,0,0,0,0
74104,0,0,0,0,0
33246,0,0,0,0,0
18190,0,0,0,0,0
19658,0,0,0,0,0
35046,0,0,0,0,0
101917,0,0,0,0,0
65757,0,0,0,0,0
10564,0,0,0,0,0
58656,0,0,0,0,0
86262,0,0,0,0,0
65171,1,1,1,0,0
42649,0,0,0,0,0
1493,0,0,0,0,0
98422,0,0,0,0,0
84830,0,0,0,0,0
53252,0,0,0,0,0
87703,0,0,0,0,0
11271,0,0,0,0,0
95658,0,0,0,0,0
74003,0,0,0,0,0
22646,0,0,0,0,0
115111,0,0,0,0,0
53397,0,0,0,0,0
37110,0,0,0,0,0
15225,0,0,0,0,0
10623,0,0,0,0,0
31139,0,0,0,0,0
112565,0,0,0,0,0
105925,0,0,0,0,0
79495,0,0,0,0,0
77588,0,0,0,0,0
58409,0,0,0,0,0
94459,0,0,0,0,0
44598,0,0,0,0,0
2584,0,0,0,0,0
67061,0,0,0,0,0
3237,0,0,0,0,0
57000,0,0,0,0,0
114590,0,0,0,0,0
57413,0,0,0,0,0
33346,0,0,0,0,0
104813,0,0,0,0,0
26513,0,0,0,0,0
92653,0,0,0,0,0
94795,0,0,0,0,0
85477,0,0,0,0,0
59538,0,0,0,0,0
84865,0,0,0,0,0
58087,0,0,0,0,0
56168,0,0,0,0,0
88857,0,0,0,0,0
4128,0,0,0,0,0
119861,0,0,0,0,0
101222,0,0,0,0,0
9416,0,0,0,0,0
27665,0,0,0,0,0
60674,0,0,0,0,0
62131,0,0,0,0,0
25454,0,0,0,0,0
33866,0,0,0,0,0
104928,0,0,0,0,0
4690,0,0,0,0,0
109979,0,0,0,0,0
101475,0,0,0,0,0
42705,0,0,0,0,0
29486,0,0,0,0,0
77527,0,0,0,0,0
109011,0,0,0,0,0
51385,0,0,0,0,0
54771,0,0,0,0,0
24839,0,0,0,0,0
101173,0,0,0,0,0
66784,0,0,0,0,0
76710,0,0,0,0,0
29067,0,0,0,0,0
27639,0,0,0,0,0
61669,0,0,0,0,0
92405,0,0,0,0,0
67108,0,0,0,0,0
74357,0,0,0,0,0
56391,0,0,0,0,0
104063,0,0,0,0,0
72639,0,0,0,0,0
18947,0,0,0,0,0
79463,0,0,0,0,0
5513,0,0,0,0,0
57722,0,0,0,0,0
79622,0,0,0,0,0
27228,0,0,0,0,0
113839,0,0,0,0,0
117378,0,0,0,0,0
18712,0,0,0,0,0
2954,0,0,0,0,0
87654,0,0,0,0,0
28606,0,0,0,0,0
55761,0,0,0,0,0
15311,0,0,0,0,0
65499,0,0,0,0,0
30430,0,0,0,0,0
82495,0,0,0,0,0
20192,0,0,0,0,0
111270,0,0,0,0,0
53467,0,0,0,0,0
107455,0,0,0,0,0
15276,0,0,0,0,0
47785,0,0,0,0,0
37572,0,0,0,0,0
44212,0,0,0,0,0
83347,0,0,0,0,0
85406,0,0,0,0,0
11518,0,0,0,0,0
105991,0,0,0,0,0
72476,0,0,0,0,0
79480,0,0,0,0,0
103022,0,0,0,0,0
50373,0,0,0,0,0
72572,0,0,0,0,0
94068,0,0,0,0,0
2703,0,0,0,0,0
101489,0,0,0,0,0
89734,0,0,0,0,0
13787,0,0,0,0,0
1870,0,0,0,0,0
14821,0,0,0,0,0
104997,0,0,0,0,0
80737,0,0,0,0,0
35212,0,0,0,0,0
12642,0,0,0,0,0
39875,0,0,0,0,0
32115,0,0,0,0,0
44445,0,0,0,0,0
19118,0,0,0,0,0
115981,0,0,0,0,0
2099,0,0,0,0,0
574,0,0,0,0,0
107029,0,0,0,0,0
106688,0,0,0,0,0
35842,0,0,0,0,0
119689,0,0,0,0,0
17565,0,0,0,0,0
95462,0,0,0,0,0
109538,0,0,0,0,0
46353,0,0,0,0,0
101134,0,0,0,0,0
39769,0,0,0,0,0
9234,0,0,0,0,0
95296,0,0,0,0,0
106266,0,0,0,0,0
49595,0,0,0,0,0
4346,0,0,0,0,0
94691,0,0,0,0,0
94918,0,0,0,0,0
89516,0,0,0,0,0
103188,0,0,0,0,0
57777,0,0,0,0,0
81981,0,0,0,0,0
118891,0,0,0,0,0
29287,0,0,0,0,0
32802,0,0,0,0,0
21161,0,0,0,0,0
67988,0,0,0,0,0
82647,0,0,0,0,0
87082,0,0,0,0,0
93187,0,0,0,0,0
11849,0,0,0,0,0
27386,0,0,0,0,0
42762,0,0,0,0,0
54102,0,0,0,0,0
1657,0,0,0,0,0
61945,0,0,0,0,0
111105,0,0,0,0,0
11364,0,0,0,0,0
12678,0,0,0,0,0
2525,0,0,0,0,0
11819,0,0,0,0,0
101502,0,0,0,0,0
24370,0,0,0,0,0
26408,0,0,0,0,0
107387,0,0,0,0,0
98144,0,0,0,0,0
45820,0,0,0,0,0
119681,0,0,0,0,0
33221,0,0,0,0,0
74985,0,0,0,0,0
70415,0,0,0,0,0
101446,0,0,0,0,0
19938,0,0,0,0,0
52758,0,0,0,0,0
115728,0,0,0,0,0
30394,0,0,0,0,0
68067,0,0,0,0,0
59920,0,0,0,0,0
93769,0,0,0,0,0
60257,0,0,0,0,0
13029,0,0,0,0,0
30712,0,0,0,0,0
103679,0,0,0,0,0
42764,0,0,0,0,0
108766,0,0,0,0,0
85688,0,0,0,0,0
16175,0,0,0,0,0
22158,0,0,0,0,0
28485,0,0,0,0,0
84981,0,0,0,0,0
100250,0,0,0,0,0
84527,0,0,0,0,0
24525,0,0,0,0,0
47753,0,0,0,0,0
12321,0,0,0,0,0
17505,0,0,0,0,0
83191,0,0,0,0,0
80450,0,0,0,0,0
51735,0,0,0,0,0
84476,0,0,0,0,0
92436,0,0,0,0,0
30649,0,0,0,0,0
18584,0,0,0,0,0
76519,0,0,0,0,0
20216,0,0,0,0,0
68388,0,0,0,0,0
114154,0,0,0,0,0
109370,0,0,0,0,0
82875,0,0,0,0,0
101820,0,0,0,0,0
58944,0,0,0,0,0
24302,0,0,0,0,0
17195,0,0,0,0,0
63480,0,0,0,0,0
100340,0,0,0,0,0
11745,0,0,0,0,0
54936,1,1,1,0,0
60350,0,0,0,0,0
11987,0,0,0,0,0
7715,0,0,0,0,0
14428,2,2,2,0,0
20576,0,0,0,0,0
1828,0,0,0,0,0
47199,0,0,0,0,0
68130,0,0,0,0,0
19481,0,0,0,0,0
90508,0,0,0,0,0
116655,0,0,0,0,0
4236,1,1,1,0,0
69273,0,0,0,0,0
90212,0,0,0,0,0
49148,0,0,0,0,0
29366,0,0,0,0,0
112719,0,0,0,0,0
14910,0,0,0,0,0
7523,0,0,0,0,0
372,0,0,0,0,0
49260,0,0,0,0,0
84474,0,0,0,0,0
103203,0,0,0,0,0
102589,0,0,0,0,0
7838,0,0,0,0,0
94482,0,0,0,0,0
51167,0,0,0,0,0
77777,0,0,0,0,0
55571,0,0,0,0,0
57212,0,0,0,0,0
87151,0,0,0,0,0
95120,0,0,0,0,0
69824,0,0,0,0,0
102275,0,0,0,0,0
117435,0,0,0,0,0
30284,0,0,0,0,0
35597,0,0,0,0,0
105060,0,0,0,0,0
28550,0,0,0,0,0
18679,0,0,0,0,0
101287,0,0,0,0,0
25623,0,0,0,0,0
68428,0,0,0,0,0
68639,0,0,0,0,0
104187,0,0,0,0,0
4391,0,0,0,0,0
4438,0,0,0,0,0
58310,0,0,0,0,0
33542,0,0,0,0,0
11005,0,0,0,0,0
70294,0,0,0,0,0
89844,0,0,0,0,0
8961,0,0,0,0,0
84309,0,0,0,0,0
78405,0,0,0,0,0
15901,0,0,0,0,0
27435,0,0,0,0,0
46847,0,0,0,0,0
6067,0,0,0,0,0
17374,0,0,0,0,0
46932,0,0,0,0,0
36590,0,0,0,0,0
63658,0,0,0,0,0
65061,0,0,0,0,0
17965,0,0,0,0,0
106592,0,0,0,0,0
98294,0,0,0,0,0
44324,0,0,0,0,0
45243,0,0,0,0,0
19894,0,0,0,0,0
54131,0,0,0,0,0
38855,0,0,0,0,0
62475,0,0,0,0,0
50835,0,0,0,0,0
62220,0,0,0,0,0
36617,0,0,0,0,0
88190,0,0,0,0,0
45908,0,0,0,0,0
106959,1,1,1,0,0
111711,0,0,0,0,0
38291,0,0,0,0,0
69850,0,0,0,0,0
81878,0,0,0,0,0
55236,0,0,0,0,0
26394,0,0,0,0,0
27657,0,0,0,0,0
23085,0,0,0,0,0
58938,0,0,0,0,0
40722,0,0,0,0,0
48580,0,0,0,0,0
57204,0,0,0,0,0
19068,0,0,0,0,0
49436,0,0,0,0,0
72082,0,0,0,0,0
89004,0,0,0,0,0
27249,0,0,0,0,0
5248,0,0,0,0,0
112561,0,0,0,0,0
101995,4,4,4,0,0
120048,0,0,0,0,0
48298,0,0,0,0,0
73545,0,0,0,0,0
13590,0,0,0,0,0
102290,0,0,0,0,0
7726,0,0,0,0,0
6343,0,0,0,0,0
36245,0,0,0,0,0
33338,0,0,0,0,0
57634,0,0,0,0,0
64358,0,0,0,0,0
3084,3,3,3,0,0
106776,0,0,0,0,0
119143,0,0,0,0,0
100724,0,0,0,0,0
21002,0,0,0,0,0
87462,0,0,0,0,0
109082,0,0,0,0,0
1474,0,0,0,0,0
86805,0,0,0,0,0
118313,0,0,0,0,0
58204,0,0,0,0,0
113442,0,0,0,0,0
95963,0,0,0,0,0
78312,0,0,0,0,0
94726,0,0,0,0,0
932,0,0,0,0,0
13639,0,0,0,0,0
111098,0,0,0,0,0
80219,0,0,0,0,0
95288,0,0,0,0,0
107487,0,0,0,0,0
36945,0,0,0,0,0
23561,0,0,0,0,0
18144,0,0,0,0,0
116119,0,0,0,0,0
101916,0,0,0,0,0
119206,0,0,0,0,0
109542,0,0,0,0,0
36840,0,0,0,0,0
78464,0,0,0,0,0
31406,0,0,0,0,0
71972,0,0,0,0,0
61653,0,0,0,0,0
79839,0,0,0,0,0
4167,0,0,0,0,0
92956,8,8,8,0,0
56747,0,0,0,0,0
50344,0,0,0,0,0
38638,0,0,0,0,0
53162,0,0,0,0,0
112351,0,0,0,0,0
79808,0,0,0,0,0
59453,0,0,0,0,0
63124,0,0,0,0,0
55668,0,0,0,0,0
77846,0,0,0,0,0
96696,0,0,0,0,0
102780,0,0,0,0,0
27169,0,0,0,0,0
85093,0,0,0,0,0
5567,0,0,0,0,0
89284,0,0,0,0,0
98925,0,0,0,0,0
60287,0,0,0,0,0
100394,0,0,0,0,0
25947,0,0,0,0,0
18824,0,0,0,0,0
55419,0,0,0,0,0
109850,1,1,1,0,0
16931,0,0,0,0,0
57189,0,0,0,0,0
25051,0,0,0,0,0
114993,0,0,0,0,0
29201,0,0,0,0,0
89575,0,0,0,0,0
35581,0,0,0,0,0
28620,0,0,0,0,0
24815,0,0,0,0,0
72345,0,0,0,0,0
39023,0,0,0,0,0
14201,0,0,0,0,0
96111,3,3,3,0,0
34583,0,0,0,0,0
8849,0,0,0,0,0
61284,0,0,0,0,0
26017,0,0,0,0,0
45210,0,0,0,0,0
97370,0,0,0,0,0
61295,0,0,0,0,0
44042,0,0,0,0,0
89972,0,0,0,0,0
53566,0,0,0,0,0
103927,0,0,0,0,0
14791,0,0,0,0,0
116200,0,0,0,0,0
111243,0,0,0,0,0
107390,0,0,0,0,0
20151,0,0,0,0,0
98805,0,0,0,0,0
10436,0,0,0,0,0
109588,3,3,3,0,0
58096,0,0,0,0,0
28408,0,0,0,0,0
32776,0,0,0,0,0
79419,0,0,0,0,0
51969,0,0,0,0,0
109283,0,0,0,0,0
51548,0,0,0,0,0
96506,0,0,0,0,0
35565,0,0,0,0,0
62892,0,0,0,0,0
25120,0,0,0,0,0
36159,0,0,0,0,0
116324,0,0,0,0,0
108138,0,0,0,0,0
25537,0,0,0,0,0
94129,0,0,0,0,0
74319,0,0,0,0,0
78135,0,0,0,0,0
73312,0,0,0,0,0
43082,0,0,0,0,0
109271,0,0,0,0,0
17770,0,0,0,0,0
89488,0,0,0,0,0
87870,0,0,0,0,0
79119,0,0,0,0,0
72019,0,0,0,0,0
36106,0,0,0,0,0
72074,0,0,0,0,0
33942,0,0,0,0,0
10186,0,0,0,0,0
829,0,0,0,0,0
117200,0,0,0,0,0
20306,0,0,0,0,0
90532,1,1,1,0,0
63802,0,0,0,0,0
55977,0,0,0,0,0
35970,0,0,0,0,0
105868,0,0,0,0,0
669,0,0,0,0,0
20152,0,0,0,0,0
29858,0,0,0,0,0
111059,0,0,0,0,0
16845,0,0,0,0,0
382,0,0,0,0,0
82997,0,0,0,0,0
112896,0,0,0,0,0
114293,0,0,0,0,0
27879,0,0,0,0,0
60819,0,0,0,0,0
64736,0,0,0,0,0
1971,0,0,0,0,0
90967,0,0,0,0,0
88723,0,0,0,0,0
39138,0,0,0,0,0
101056,0,0,0,0,0
86543,0,0,0,0,0
65474,0,0,0,0,0
116294,0,0,0,0,0
36852,0,0,0,0,0
110692,0,0,0,0,0
105947,0,0,0,0,0
42599,0,0,0,0,0
94654,0,0,0,0,0
20014,0,0,0,0,0
89968,0,0,0,0,0
71119,0,0,0,0,0
69350,0,0,0,0,0
89216,0,0,0,0,0
99037,0,0,0,0,0
79254,0,0,0,0,0
78616,0,0,0,0,0
20491,0,0,0,0,0
51377,0,0,0,0,0
47036,0,0,0,0,0
50457,0,0,0,0,0
54474,0,0,0,0,0
93114,2,2,2,0,0
55144,0,0,0,0,0
1641,0,0,0,0,0
85719,0,0,0,0,0
22259,0,0,0,0,0
64107,0,0,0,0,0
56677,0,0,0,0,0
74522,0,0,0,0,0
43259,0,0,0,0,0
36576,1,1,1,0,0
28278,0,0,0,0,0
43234,0,0,0,0,0
10106,0,0,0,0,0
61453,0,0,0,0,0
58527,0,0,0,0,0
16677,0,0,0,0,0
17290,0,0,0,0,0
105110,0,0,0,0,0
82294,0,0,0,0,0
20243,0,0,0,0,0
107138,0,0,0,0,0
91770,0,0,0,0,0
59113,0,0,0,0,0
73503,0,0,0,0,0
11852,0,0,0,0,0
61896,0,0,0,0,0
71741,0,0,0,0,0
53039,0,0,0,0,0
56608,0,0,0,0,0
47165,0,0,0,0,0
64264,0,0,0,0,0
14097,0,0,0,0,0
27962,0,0,0,0,0
62520,0,0,0,0,0
89060,0,0,0,0,0
5081,0,0,0,0,0
29307,0,0,0,0,0
68684,0,0,0,0,0
69014,0,0,0,0,0
113521,0,0,0,0,0
70349,0,0,0,0,0
70542,0,0,0,0,0
108287,0,0,0,0,0
15460,0,0,0,0,0
22403,0,0,0,0,0
32541,0,0,0,0,0
115858,0,0,0,0,0
72399,0,0,0,0,0
30357,0,0,0,0,0
32969,0,0,0,0,0
119170,0,0,0,0,0
77760,0,0,0,0,0
82912,0,0,0,0,0
28015,0,0,0,0,0
46838,0,0,0,0,0
57653,0,0,0,0,0
12526,0,0,0,0,0
25818,0,0,0,0,0
116440,0,0,0,0,0
80456,0,0,0,0,0
73466,0,0,0,0,0
97633,0,0,0,0,0
109483,0,0,0,0,0
15622,0,0,0,0,0
102058,0,0,0,0,0
97517,0,0,0,0,0
80000,0,0,0,0,0
28355,0,0,0,0,0
108590,0,0,0,0,0
81321,0,0,0,0,0
72766,0,0,0,0,0
90834,0,0,0,0,0
54159,0,0,0,0,0
105506,0,0,0,0,0
67530,0,0,0,0,0
53701,0,0,0,0,0
68583,0,0,0,0,0
90796,0,0,0,0,0
119994,0,0,0,0,0
31292,0,0,0,0,0
61692,0,0,0,0,0
89826,0,0,0,0,0
117971,0,0,0,0,0
43382,0,0,0,0,0
92980,0,0,0,0,0
49483,0,0,0,0,0
28477,0,0,0,0,0
5320,2,2,2,0,0
32193,0,0,0,0,0
34235,0,0,0,0,0
118924,0,0,0,0,0
110795,0,0,0,0,0
113200,0,0,0,0,0
117668,0,0,0,0,0
12274,0,0,0,0,0
24668,0,0,0,0,0
108106,0,0,0,0,0
28324,0,0,0,0,0
54042,0,0,0,0,0
52897,0,0,0,0,0
98188,0,0,0,0,0
9833,0,0,0,0,0
45411,0,0,0,0,0
16669,0,0,0,0,0
39990,0,0,0,0,0
84718,0,0,0,0,0
16864,0,0,0,0,0
22742,0,0,0,0,0
120045,0,0,0,0,0
2148,0,0,0,0,0
83866,0,0,0,0,0
98911,0,0,0,0,0
119869,0,0,0,0,0
115440,0,0,0,0,0
111373,0,0,0,0,0
68341,0,0,0,0,0
3520,0,0,0,0,0
18843,0,0,0,0,0
14403,0,0,0,0,0
60756,0,0,0,0,0
92868,0,0,0,0,0
99103,0,0,0,0,0
44662,0,0,0,0,0
99818,0,0,0,0,0
75304,0,0,0,0,0
26987,0,0,0,0,0
53439,0,0,0,0,0
24247,0,0,0,0,0
77446,0,0,0,0,0
114664,0,0,0,0,0
79807,0,0,0,0,0
47933,0,0,0,0,0
119397,0,0,0,0,0
3478,0,0,0,0,0
96828,2,2,2,0,0
26593,0,0,0,0,0
15575,0,0,0,0,0
58226,0,0,0,0,0
89832,0,0,0,0,0
118593,0,0,0,0,0
16757,0,0,0,0,0
26803,0,0,0,0,0
71031,0,0,0,0,0
89737,0,0,0,0,0
27159,0,0,0,0,0
22730,0,0,0,0,0
83452,0,0,0,0,0
12761,0,0,0,0,0
91439,0,0,0,0,0
11753,0,0,0,0,0
36384,0,0,0,0,0
24061,0,0,0,0,0
25672,0,0,0,0,0
75412,0,0,0,0,0
97547,0,0,0,0,0
59138,0,0,0,0,0
36475,0,0,0,0,0
6968,0,0,0,0,0
14268,0,0,0,0,0
92469,0,0,0,0,0
98631,0,0,0,0,0
26964,0,0,0,0,0
8130,0,0,0,0,0
46626,0,0,0,0,0
17348,0,0,0,0,0
120166,0,0,0,0,0
89098,0,0,0,0,0
65665,0,0,0,0,0
54206,0,0,0,0,0
19951,0,0,0,0,0
46155,0,0,0,0,0
101599,0,0,0,0,0
64018,0,0,0,0,0
59182,0,0,0,0,0
41128,0,0,0,0,0
7170,0,0,0,0,0
48816,0,0,0,0,0
12385,0,0,0,0,0
1628,0,0,0,0,0
84667,0,0,0,0,0
36510,0,0,0,0,0
89554,0,0,0,0,0
4771,0,0,0,0,0
49193,0,0,0,0,0
111489,0,0,0,0,0
73378,0,0,0,0,0
64343,0,0,0,0,0
52284,0,0,0,0,0
66071,0,0,0,0,0
28372,0,0,0,0,0
118385,0,0,0,0,0
97904,0,0,0,0,0
100687,0,0,0,0,0
106335,0,0,0,0,0
81467,0,0,0,0,0
67243,0,0,0,0,0
98961,0,0,0,0,0
35074,0,0,0,0,0
100877,0,0,0,0,0
31529,0,0,0,0,0
55814,0,0,0,0,0
60609,0,0,0,0,0
114123,0,0,0,0,0
52402,0,0,0,0,0
33612,0,0,0,0,0
26791,1,1,1,0,0
101182,0,0,0,0,0
31849,0,0,0,0,0
35534,0,0,0,0,0
39261,0,0,0,0,0
72153,0,0,0,0,0
25587,0,0,0,0,0
27705,0,0,0,0,0
96942,0,0,0,0,0
13641,0,0,0,0,0
73605,0,0,0,0,0
60065,0,0,0,0,0
37244,0,0,0,0,0
89242,0,0,0,0,0
55863,0,0,0,0,0
106420,0,0,0,0,0
44988,0,0,0,0,0
56761,0,0,0,0,0
25728,0,0,0,0,0
67557,0,0,0,0,0
15292,0,0,0,0,0
74108,0,0,0,0,0
16110,3,3,3,0,0
118848,0,0,0,0,0
53068,0,0,0,0,0
43944,2,2,2,0,0
25528,0,0,0,0,0
61759,0,0,0,0,0
104824,0,0,0,0,0
29636,0,0,0,0,0
60824,6,6,6,0,0
116975,0,0,0,0,0
65811,0,0,0,0,0
10452,0,0,0,0,0
116747,0,0,0,0,0
40544,0,0,0,0,0
1386,0,0,0,0,0
63753,0,0,0,0,0
43591,0,0,0,0,0
67482,0,0,0,0,0
98107,0,0,0,0,0
94137,0,0,0,0,0
74281,0,0,0,0,0
3966,0,0,0,0,0
2840,0,0,0,0,0
102933,0,0,0,0,0
103789,0,0,0,0,0
84998,0,0,0,0,0
36298,0,0,0,0,0
51584,0,0,0,0,0
15024,0,0,0,0,0
63036,0,0,0,0,0
68527,0,0,0,0,0
3985,0,0,0,0,0
93099,0,0,0,0,0
80364,0,0,0,0,0
27172,0,0,0,0,0
103762,0,0,0,0,0
27795,0,0,0,0,0
19147,0,0,0,0,0
184,0,0,0,0,0
98211,0,0,0,0,0
42279,0,0,0,0,0
91228,0,0,0,0,0
31579,0,0,0,0,0
33169,0,0,0,0,0
17420,0,0,0,0,0
100130,0,0,0,0,0
9858,0,0,0,0,0
47127,0,0,0,0,0
22117,0,0,0,0,0
85789,0,0,0,0,0
115202,0,0,0,0,0
101032,0,0,0,0,0
19420,0,0,0,0,0
86282,0,0,0,0,0
41539,0,0,0,0,0
67807,0,0,0,0,0
114424,0,0,0,0,0
1469,0,0,0,0,0
90130,0,0,0,0,0
61271,0,0,0,0,0
72431,0,0,0,0,0
31062,0,0,0,0,0
12202,0,0,0,0,0
38810,0,0,0,0,0
24350,0,0,0,0,0
56070,0,0,0,0,0
115855,0,0,0,0,0
45206,0,0,0,0,0
28702,0,0,0,0,0
82391,0,0,0,0,0
45299,0,0,0,0,0
96390,0,0,0,0,0
82047,0,0,0,0,0
59956,0,0,0,0,0
113498,0,0,0,0,0
38049,0,0,0,0,0
88817,0,0,0,0,0
101496,0,0,0,0,0
80773,0,0,0,0,0
31106,0,0,0,0,0
60917,0,0,0,0,0
24229,0,0,0,0,0
74119,0,0,0,0,0
16144,0,0,0,0,0
91688,0,0,0,0,0
86505,0,0,0,0,0
22107,0,0,0,0,0
40751,0,0,0,0,0
11872,0,0,0,0,0
3329,0,0,0,0,0
81338,0,0,0,0,0
108710,0,0,0,0,0
107205,0,0,0,0,0
39476,0,0,0,0,0
85091,0,0,0,0,0
72625,0,0,0,0,0
72224,0,0,0,0,0
91420,0,0,0,0,0
57927,0,0,0,0,0
76513,0,0,0,0,0
45587,0,0,0,0,0
120298,0,0,0,0,0
45895,0,0,0,0,0
56906,0,0,0,0,0
82406,0,0,0,0,0
39846,0,0,0,0,0
115638,0,0,0,0,0
91878,0,0,0,0,0
70782,0,0,0,0,0
7199,0,0,0,0,0
65304,0,0,0,0,0
115890,0,0,0,0,0
90873,0,0,0,0,0
45671,0,0,0,0,0
28556,0,0,0,0,0
82882,0,0,0,0,0
76376,0,0,0,0,0
74021,0,0,0,0,0
99390,0,0,0,0,0
4419,0,0,0,0,0
17734,0,0,0,0,0
71436,0,0,0,0,0
75958,0,0,0,0,0
427,0,0,0,0,0
61395,0,0,0,0,0
28072,0,0,0,0,0
56523,0,0,0,0,0
96426,0,0,0,0,0
16743,0,0,0,0,0
88496,0,0,0,0,0
117797,0,0,0,0,0
97336,0,0,0,0,0
91693,0,0,0,0,0
115950,4,4,4,0,0
16710,3,3,3,0,0
74083,0,0,0,0,0
3786,0,0,0,0,0
80221,0,0,0,0,0
51866,0,0,0,0,0
67627,0,0,0,0,0
119373,0,0,0,0,0
13770,0,0,0,0,0
41160,0,0,0,0,0
49120,0,0,0,0,0
57119,0,0,0,0,0
7282,0,0,0,0,0
13536,0,0,0,0,0
40007,0,0,0,0,0
94022,0,0,0,0,0
35139,0,0,0,0,0
55124,0,0,0,0,0
115718,0,0,0,0,0
92441,0,0,0,0,0
96197,0,0,0,0,0
107815,0,0,0,0,0
23598,0,0,0,0,0
113656,0,0,0,0,0
70149,0,0,0,0,0
30474,0,0,0,0,0
22077,0,0,0,0,0
7141,0,0,0,0,0
84431,0,0,0,0,0
59790,0,0,0,0,0
75062,0,0,0,0,0
112093,0,0,0,0,0
593,0,0,0,0,0
41656,0,0,0,0,0
17803,0,0,0,0,0
84773,0,0,0,0,0
3437,0,0,0,0,0
26810,0,0,0,0,0
8793,0,0,0,0,0
53790,0,0,0,0,0
99318,0,0,0,0,0
109270,0,0,0,0,0
50985,0,0,0,0,0
78837,0,0,0,0,0
385,0,0,0,0,0
77200,0,0,0,0,0
90536,0,0,0,0,0
35414,0,0,0,0,0
51310,0,0,0,0,0
45466,0,0,0,0,0
1487,0,0,0,0,0
98571,0,0,0,0,0
65787,0,0,0,0,0
31728,0,0,0,0,0
40997,0,0,0,0,0
97448,0,0,0,0,0
35094,0,0,0,0,0
81108,0,0,0,0,0
67250,0,0,0,0,0
95648,0,0,0,0,0
6817,0,0,0,0,0
28636,0,0,0,0,0
39120,0,0,0,0,0
107406,0,0,0,0,0
105756,0,0,0,0,0
103196,0,0,0,0,0
81291,0,0,0,0,0
65305,0,0,0,0,0
57461,0,0,0,0,0
24057,0,0,0,0,0
87854,0,0,0,0,0
29176,0,0,0,0,0
9607,0,0,0,0,0
66285,0,0,0,0,0
112789,0,0,0,0,0
104140,0,0,0,0,0
117166,0,0,0,0,0
58614,0,0,0,0,0
102947,0,0,0,0,0
77533,0,0,0,0,0
109923,0,0,0,0,0
88065,0,0,0,0,0
28997,0,0,0,0,0
34945,0,0,0,0,0
40186,0,0,0,0,0
38004,0,0,0,0,0
44847,0,0,0,0,0
96231,1,1,1,0,0
50883,0,0,0,0,0
100632,0,0,0,0,0
22473,0,0,0,0,0
70053,0,0,0,0,0
73184,0,0,0,0,0
58073,0,0,0,0,0
5769,0,0,0,0,0
91853,0,0,0,0,0
43372,0,0,0,0,0
7576,0,0,0,0,0
63979,0,0,0,0,0
57315,0,0,0,0,0
38319,0,0,0,0,0
109925,0,0,0,0,0
105361,0,0,0,0,0
13234,0,0,0,0,0
59745,0,0,0,0,0
17966,0,0,0,0,0
112886,0,0,0,0,0
67769,0,0,0,0,0
54123,0,0,0,0,0
3026,0,0,0,0,0
96170,0,0,0,0,0
62229,0,0,0,0,0
5041,0,0,0,0,0
48488,0,0,0,0,0
32667,0,0,0,0,0
17890,0,0,0,0,0
84252,0,0,0,0,0
5782,0,0,0,0,0
31493,0,0,0,0,0
3039,0,0,0,0,0
48255,0,0,0,0,0
49288,0,0,0,0,0
4647,0,0,0,0,0
7239,0,0,0,0,0
105039,0,0,0,0,0
2598,1,1,1,0,0
13461,0,0,0,0,0
23969,0,0,0,0,0
108797,0,0,0,0,0
54461,0,0,0,0,0
6753,0,0,0,0,0
19790,0,0,0,0,0
87570,0,0,0,0,0
45304,0,0,0,0,0
91962,1,1,1,0,0
79745,0,0,0,0,0
7397,0,0,0,0,0
9745,0,0,0,0,0
74155,0,0,0,0,0
49377,0,0,0,0,0
72999,0,0,0,0,0
54225,0,0,0,0,0
75409,0,0,0,0,0
94991,0,0,0,0,0
69628,0,0,0,0,0
103837,0,0,0,0,0
33113,0,0,0,0,0
95273,0,0,0,0,0
54567,0,0,0,0,0
41185,0,0,0,0,0
80046,0,0,0,0,0
69802,0,0,0,0,0
110800,0,0,0,0,0
90192,0,0,0,0,0
33146,0,0,0,0,0
10046,0,0,0,0,0
120393,0,0,0,0,0
115398,0,0,0,0,0
55625,0,0,0,0,0
115161,0,0,0,0,0
100523,0,0,0,0,0
11233,0,0,0,0,0
35693,0,0,0,0,0
61449,0,0,0,0,0
64035,0,0,0,0,0
109562,0,0,0,0,0
33077,0,0,0,0,0
68177,0,0,0,0,0
113394,0,0,0,0,0
59006,0,0,0,0,0
85990,0,0,0,0,0
62068,0,0,0,0,0
88285,0,0,0,0,0
42436,0,0,0,0,0
66983,0,0,0,0,0
28269,0,0,0,0,0
107314,0,0,0,0,0
65225,0,0,0,0,0
72313,0,0,0,0,0
23412,0,0,0,0,0
23454,0,0,0,0,0
107156,0,0,0,0,0
75274,0,0,0,0,0
111347,0,0,0,0,0
45571,0,0,0,0,0
54458,0,0,0,0,0
90125,0,0,0,0,0
111762,0,0,0,0,0
51784,0,0,0,0,0
41148,0,0,0,0,0
29621,0,0,0,0,0
56975,0,0,0,0,0
20830,0,0,0,0,0
65119,0,0,0,0,0
72836,0,0,0,0,0
6558,0,0,0,0,0
43705,0,0,0,0,0
102958,0,0,0,0,0
76463,0,0,0,0,0
10711,0,0,0,0,0
64102,0,0,0,0,0
49142,0,0,0,0,0
89627,0,0,0,0,0
64823,0,0,0,0,0
24727,0,0,0,0,0
64941,0,0,0,0,0
56684,0,0,0,0,0
50271,2,2,2,0,0
10129,0,0,0,0,0
91160,0,0,0,0,0
87241,0,0,0,0,0
116173,0,0,0,0,0
1129,0,0,0,0,0
8258,0,0,0,0,0
80199,0,0,0,0,0
97324,0,0,0,0,0
25049,0,0,0,0,0
93481,0,0,0,0,0
110620,0,0,0,0,0
89577,0,0,0,0,0
119348,0,0,0,0,0
9994,0,0,0,0,0
27594,0,0,0,0,0
21441,0,0,0,0,0
68797,0,0,0,0,0
118015,0,0,0,0,0
73023,0,0,0,0,0
56141,0,0,0,0,0
55102,0,0,0,0,0
71833,0,0,0,0,0
114317,0,0,0,0,0
24899,0,0,0,0,0
29254,0,0,0,0,0
8731,0,0,0,0,0
25509,0,0,0,0,0
97239,0,0,0,0,0
17870,0,0,0,0,0
5532,0,0,0,0,0
73580,0,0,0,0,0
102762,0,0,0,0,0
25164,0,0,0,0,0
90490,0,0,0,0,0
97936,0,0,0,0,0
71356,0,0,0,0,0
92892,0,0,0,0,0
14872,0,0,0,0,0
40359,0,0,0,0,0
6354,0,0,0,0,0
25270,0,0,0,0,0
16978,0,0,0,0,0
11224,0,0,0,0,0
114018,0,0,0,0,0
34439,0,0,0,0,0
37603,0,0,0,0,0
24981,0,0,0,0,0
113844,0,0,0,0,0
65498,2,2,2,0,0
91852,0,0,0,0,0
110387,0,0,0,0,0
85802,0,0,0,0,0
28796,0,0,0,0,0
81702,0,0,0,0,0
82217,0,0,0,0,0
53300,0,0,0,0,0
28131,0,0,0,0,0
111138,0,0,0,0,0
75793,0,0,0,0,0
31497,0,0,0,0,0
109170,0,0,0,0,0
77439,0,0,0,0,0
58608,0,0,0,0,0
77148,0,0,0,0,0
30185,0,0,0,0,0
71569,0,0,0,0,0
114397,0,0,0,0,0
31485,0,0,0,0,0
17865,0,0,0,0,0
16990,0,0,0,0,0
100228,0,0,0,0,0
46920,0,0,0,0,0
37486,0,0,0,0,0
11502,0,0,0,0,0
109295,0,0,0,0,0
72600,0,0,0,0,0
73799,0,0,0,0,0
60301,0,0,0,0,0
75817,0,0,0,0,0
115099,0,0,0,0,0
105711,0,0,0,0,0
3487,0,0,0,0,0
89191,0,0,0,0,0
77898,0,0,0,0,0
60765,0,0,0,0,0
68652,0,0,0,0,0
6219,0,0,0,0,0
88310,0,0,0,0,0
5528,0,0,0,0,0
116436,0,0,0,0,0
111640,2,2,2,0,0
29484,0,0,0,0,0
59131,0,0,0,0,0
46228,0,0,0,0,0
2192,0,0,0,0,0
77680,0,0,0,0,0
64495,0,0,0,0,0
43718,0,0,0,0,0
4684,0,0,0,0,0
120521,0,0,0,0,0
55406,0,0,0,0,0
90228,0,0,0,0,0
49425,0,0,0,0,0
99307,0,0,0,0,0
1448,0,0,0,0,0
18616,0,0,0,0,0
98987,0,0,0,0,0
24968,0,0,0,0,0
25722,0,0,0,0,0
2672,0,0,0,0,0
64414,0,0,0,0,0
71378,0,0,0,0,0
87513,0,0,0,0,0
16679,0,0,0,0,0
36263,0,0,0,0,0
94623,0,0,0,0,0
7946,0,0,0,0,0
63307,0,0,0,0,0
49905,0,0,0,0,0
97752,0,0,0,0,0
3853,0,0,0,0,0
86423,0,0,0,0,0
28175,0,0,0,0,0
58850,0,0,0,0,0
34990,0,0,0,0,0
14105,0,0,0,0,0
82656,0,0,0,0,0
2669,0,0,0,0,0
16769,0,0,0,0,0
114252,0,0,0,0,0
109299,0,0,0,0,0
21358,0,0,0,0,0
40728,0,0,0,0,0
8937,0,0,0,0,0
41110,0,0,0,0,0
45703,0,0,0,0,0
90491,0,0,0,0,0
723,0,0,0,0,0
109403,0,0,0,0,0
27937,0,0,0,0,0
65554,0,0,0,0,0
39477,0,0,0,0,0
115411,0,0,0,0,0
13653,0,0,0,0,0
23297,0,0,0,0,0
18507,0,0,0,0,0
50845,0,0,0,0,0
31353,0,0,0,0,0
86888,0,0,0,0,0
55376,0,0,0,0,0
80158,0,0,0,0,0
14407,0,0,0,0,0
25910,0,0,0,0,0
111509,0,0,0,0,0
57098,0,0,0,0,0
6166,0,0,0,0,0
91102,0,0,0,0,0
100133,0,0,0,0,0
78375,0,0,0,0,0
35809,0,0,0,0,0
31709,0,0,0,0,0
90436,0,0,0,0,0
19070,0,0,0,0,0
17074,0,0,0,0,0
41252,0,0,0,0,0
10214,0,0,0,0,0
93473,0,0,0,0,0
105350,0,0,0,0,0
18595,0,0,0,0,0
53835,0,0,0,0,0
119442,0,0,0,0,0
77878,0,0,0,0,0
120304,0,0,0,0,0
95289,0,0,0,0,0
61516,0,0,0,0,0
42023,0,0,0,0,0
36428,0,0,0,0,0
11152,0,0,0,0,0
112280,0,0,0,0,0
83717,0,0,0,0,0
51531,0,0,0,0,0
43391,0,0,0,0,0
47144,0,0,0,0,0
28449,0,0,0,0,0
108847,0,0,0,0,0
57942,0,0,0,0,0
2936,0,0,0,0,0
108693,0,0,0,0,0
5880,0,0,0,0,0
77072,0,0,0,0,0
21084,0,0,0,0,0
119858,0,0,0,0,0
31824,0,0,0,0,0
15695,0,0,0,0,0
119047,0,0,0,0,0
14133,0,0,0,0,0
98825,0,0,0,0,0
14834,0,0,0,0,0
115488,0,0,0,0,0
112794,0,0,0,0,0
17265,0,0,0,0,0
34256,0,0,0,0,0
92970,0,0,0,0,0
79663,0,0,0,0,0
2044,0,0,0,0,0
70811,0,0,0,0,0
94611,0,0,0,0,0
97504,0,0,0,0,0
101794,0,0,0,0,0
62907,0,0,0,0,0
71430,0,0,0,0,0
56051,0,0,0,0,0
35168,0,0,0,0,0
23822,0,0,0,0,0
119746,0,0,0,0,0
30898,0,0,0,0,0
29308,0,0,0,0,0
100723,0,0,0,0,0
59656,0,0,0,0,0
11609,0,0,0,0,0
51274,0,0,0,0,0
53637,0,0,0,0,0
46249,0,0,0,0,0
3230,0,0,0,0,0
98781,0,0,0,0,0
4321,0,0,0,0,0
84843,0,0,0,0,0
104254,0,0,0,0,0
54050,0,0,0,0,0
48710,0,0,0,0,0
64583,0,0,0,0,0
11341,0,0,0,0,0
35724,0,0,0,0,0
69712,0,0,0,0,0
38818,0,0,0,0,0
19810,0,0,0,0,0
38232,0,0,0,0,0
95803,0,0,0,0,0
115417,0,0,0,0,0
93173,0,0,0,0,0
103023,0,0,0,0,0
61568,0,0,0,0,0
23951,0,0,0,0,0
73696,0,0,0,0,0
24601,0,0,0,0,0
70148,0,0,0,0,0
103413,0,0,0,0,0
80945,7,7,7,0,0
90626,0,0,0,0,0
86839,0,0,0,0,0
7916,0,0,0,0,0
44774,0,0,0,0,0
54866,0,0,0,0,0
118929,0,0,0,0,0
92406,0,0,0,0,0
81759,0,0,0,0,0
19858,0,0,0,0,0
1515,0,0,0,0,0
94835,0,0,0,0,0
71072,0,0,0,0,0
114799,0,0,0,0,0
49888,0,0,0,0,0
73325,0,0,0,0,0
63993,0,0,0,0,0
58468,0,0,0,0,0
91208,0,0,0,0,0
67340,0,0,0,0,0
87659,0,0,0,0,0
16736,0,0,0,0,0
8906,0,0,0,0,0
100774,0,0,0,0,0
45851,0,0,0,0,0
14778,0,0,0,0,0
30269,0,0,0,0,0
41876,1,1,1,0,0
78373,0,0,0,0,0
88609,0,0,0,0,0
110609,0,0,0,0,0
110207,0,0,0,0,0
40170,0,0,0,0,0
80922,0,0,0,0,0
92466,0,0,0,0,0
63342,0,0,0,0,0
25212,0,0,0,0,0
93746,0,0,0,0,0
4312,0,0,0,0,0
2091,0,0,0,0,0
105269,0,0,0,0,0
36306,0,0,0,0,0
119743,3,3,3,0,0
69081,0,0,0,0,0
94640,0,0,0,0,0
84250,0,0,0,0,0
22525,0,0,0,0,0
52985,0,0,0,0,0
4927,0,0,0,0,0
68716,0,0,0,0,0
21579,0,0,0,0,0
69182,0,0,0,0,0
94886,0,0,0,0,0
91854,0,0,0,0,0
104328,0,0,0,0,0
50708,0,0,0,0,0
106881,0,0,0,0,0
103954,0,0,0,0,0
80290,0,0,0,0,0
33693,0,0,0,0,0
43238,2,2,2,0,0
42754,0,0,0,0,0
67131,0,0,0,0,0
240,0,0,0,0,0
115953,0,0,0,0,0
58818,0,0,0,0,0
71040,0,0,0,0,0
62171,0,0,0,0,0
105948,0,0,0,0,0
61810,0,0,0,0,0
71711,0,0,0,0,0
42063,0,0,0,0,0
83888,0,0,0,0,0
106588,0,0,0,0,0
88838,0,0,0,0,0
50242,0,0,0,0,0
72010,0,0,0,0,0
83993,0,0,0,0,0
35774,0,0,0,0,0
53139,0,0,0,0,0
117627,0,0,0,0,0
27026,0,0,0,0,0
17590,0,0,0,0,0
81944,0,0,0,0,0
73002,0,0,0,0,0
117806,0,0,0,0,0
72055,0,0,0,0,0
116799,0,0,0,0,0
103614,0,0,0,0,0
108627,0,0,0,0,0
112472,0,0,0,0,0
80812,0,0,0,0,0
70759,0,0,0,0,0
86351,0,0,0,0,0
40488,0,0,0,0,0
42312,0,0,0,0,0
118040,0,0,0,0,0
29921,0,0,0,0,0
3659,0,0,0,0,0
112822,0,0,0,0,0
86884,0,0,0,0,0
18629,0,0,0,0,0
50549,0,0,0,0,0
24345,0,0,0,0,0
76170,0,0,0,0,0
24607,0,0,0,0,0
103365,0,0,0,0,0
115266,0,0,0,0,0
41691,0,0,0,0,0
66207,0,0,0,0,0
8888,0,0,0,0,0
5932,0,0,0,0,0
12615,0,0,0,0,0
118080,0,0,0,0,0
33670,0,0,0,0,0
98020,0,0,0,0,0
102109,0,0,0,0,0
106670,0,0,0,0,0
12376,0,0,0,0,0
45843,0,0,0,0,0
24969,0,0,0,0,0
91457,0,0,0,0,0
109704,0,0,0,0,0
66550,0,0,0,0,0
11711,0,0,0,0,0
63070,0,0,0,0,0
70367,0,0,0,0,0
113207,0,0,0,0,0
33806,0,0,0,0,0
24681,0,0,0,0,0
109807,0,0,0,0,0
115449,0,0,0,0,0
84485,0,0,0,0,0
3727,0,0,0,0,0
16697,0,0,0,0,0
44629,0,0,0,0,0
80760,0,0,0,0,0
47328,0,0,0,0,0
112918,0,0,0,0,0
56166,0,0,0,0,0
13584,0,0,0,0,0
52337,0,0,0,0,0
55130,0,0,0,0,0
93627,0,0,0,0,0
35384,0,0,0,0,0
107812,0,0,0,0,0
87787,0,0,0,0,0
108301,0,0,0,0,0
64019,0,0,0,0,0
24338,0,0,0,0,0
120258,0,0,0,0,0
118884,0,0,0,0,0
58806,0,0,0,0,0
14846,0,0,0,0,0
104144,0,0,0,0,0
9299,0,0,0,0,0
22058,0,0,0,0,0
4838,0,0,0,0,0
12412,0,0,0,0,0
105798,0,0,0,0,0
97980,0,0,0,0,0
71198,0,0,0,0,0
73221,0,0,0,0,0
11685,0,0,0,0,0
776,0,0,0,0,0
25418,0,0,0,0,0
75364,0,0,0,0,0
2024,0,0,0,0,0
68524,0,0,0,0,0
28615,0,0,0,0,0
44605,0,0,0,0,0
83665,0,0,0,0,0
97891,0,0,0,0,0
92179,0,0,0,0,0
12011,0,0,0,0,0
50833,0,0,0,0,0
32560,0,0,0,0,0
37926,0,0,0,0,0
780,0,0,0,0,0
27878,0,0,0,0,0
63647,0,0,0,0,0
69876,0,0,0,0,0
93730,0,0,0,0,0
98505,0,0,0,0,0
62912,0,0,0,0,0
61802,0,0,0,0,0
1374,0,0,0,0,0
36280,0,0,0,0,0
85994,0,0,0,0,0
83003,0,0,0,0,0
20802,0,0,0,0,0
115337,0,0,0,0,0
94316,0,0,0,0,0
79204,0,0,0,0,0
3289,0,0,0,0,0
25064,0,0,0,0,0
62558,0,0,0,0,0
101745,0,0,0,0,0
96364,0,0,0,0,0
51442,0,0,0,0,0
45862,0,0,0,0,0
41384,0,0,0,0,0
73581,0,0,0,0,0
20366,0,0,0,0,0
6425,0,0,0,0,0
26975,0,0,0,0,0
9935,3,3,3,0,0
111955,0,0,0,0,0
64348,0,0,0,0,0
11047,0,0,0,0,0
21563,0,0,0,0,0
72624,0,0,0,0,0
67678,0,0,0,0,0
41663,0,0,0,0,0
69448,0,0,0,0,0
111240,0,0,0,0,0
78618,0,0,0,0,0
57967,0,0,0,0,0
118996,0,0,0,0,0
59471,0,0,0,0,0
74898,0,0,0,0,0
107505,0,0,0,0,0
31382,0,0,0,0,0
99554,0,0,0,0,0
633,0,0,0,0,0
40328,0,0,0,0,0
24488,0,0,0,0,0
1080,0,0,0,0,0
65678,0,0,0,0,0
50818,0,0,0,0,0
13502,0,0,0,0,0
98468,0,0,0,0,0
95349,0,0,0,0,0
4589,0,0,0,0,0
108346,0,0,0,0,0
62228,0,0,0,0,0
45030,0,0,0,0,0
38000,0,0,0,0,0
11229,0,0,0,0,0
74150,0,0,0,0,0
487,0,0,0,0,0
346,0,0,0,0,0
86594,0,0,0,0,0
92981,0,0,0,0,0
84603,0,0,0,0,0
26173,0,0,0,0,0
46956,0,0,0,0,0
111397,0,0,0,0,0
99726,0,0,0,0,0
72969,0,0,0,0,0
94024,0,0,0,0,0
51065,0,0,0,0,0
112932,0,0,0,0,0
97553,0,0,0,0,0
76649,0,0,0,0,0
86715,0,0,0,0,0
75590,0,0,0,0,0
75163,0,0,0,0,0
81218,0,0,0,0,0
93239,0,0,0,0,0
88029,0,0,0,0,0
112747,0,0,0,0,0
113178,0,0,0,0,0
73457,0,0,0,0,0
33662,0,0,0,0,0
64459,0,0,0,0,0
118142,0,0,0,0,0
11677,0,0,0,0,0
29145,0,0,0,0,0
82329,0,0,0,0,0
97948,0,0,0,0,0
3694,0,0,0,0,0
29613,0,0,0,0,0
47233,0,0,0,0,0
36927,0,0,0,0,0
8569,0,0,0,0,0
95049,0,0,0,0,0
77233,4,4,4,0,0
118934,0,0,0,0,0
484,0,0,0,0,0
70198,0,0,0,0,0
80038,0,0,0,0,0
90696,0,0,0,0,0
27907,0,0,0,0,0
52714,0,0,0,0,0
71620,0,0,0,0,0
36344,0,0,0,0,0
21097,0,0,0,0,0
67223,0,0,0,0,0
9342,0,0,0,0,0
42920,0,0,0,0,0
105234,0,0,0,0,0
100353,0,0,0,0,0
63921,0,0,0,0,0
3928,0,0,0,0,0
48453,0,0,0,0,0
59285,0,0,0,0,0
103040,0,0,0,0,0
52789,0,0,0,0,0
5882,0,0,0,0,0
64617,0,0,0,0,0
1259,0,0,0,0,0
111878,0,0,0,0,0
102711,0,0,0,0,0
27107,0,0,0,0,0
77954,0,0,0,0,0
102287,0,0,0,0,0
54108,0,0,0,0,0
23554,0,0,0,0,0
38563,0,0,0,0,0
24220,0,0,0,0,0
48863,0,0,0,0,0
49197,0,0,0,0,0
114534,0,0,0,0,0
13947,0,0,0,0,0
16073,0,0,0,0,0
66809,0,0,0,0,0
102374,0,0,0,0,0
31313,0,0,0,0,0
51313,0,0,0,0,0
115749,0,0,0,0,0
43064,0,0,0,0,0
38785,0,0,0,0,0
108563,0,0,0,0,0
85757,0,0,0,0,0
112131,0,0,0,0,0
44532,0,0,0,0,0
2839,0,0,0,0,0
46684,0,0,0,0,0
95906,0,0,0,0,0
53746,0,0,0,0,0
1095,0,0,0,0,0
63799,0,0,0,0,0
31483,1,1,1,0,0
62342,0,0,0,0,0
45539,0,0,0,0,0
110586,0,0,0,0,0
29012,0,0,0,0,0
89530,0,0,0,0,0
108355,0,0,0,0,0
70951,0,0,0,0,0
100541,0,0,0,0,0
37979,0,0,0,0,0
94538,0,0,0,0,0
8431,0,0,0,0,0
89647,0,0,0,0,0
41946,0,0,0,0,0
67062,0,0,0,0,0
51638,0,0,0,0,0
3780,0,0,0,0,0
75405,0,0,0,0,0
15252,0,0,0,0,0
14466,0,0,0,0,0
2074,0,0,0,0,0
75243,0,0,0,0,0
21970,0,0,0,0,0
53239,0,0,0,0,0
24733,0,0,0,0,0
41410,0,0,0,0,0
82664,0,0,0,0,0
13131,0,0,0,0,0
89758,0,0,0,0,0
80732,0,0,0,0,0
112824,0,0,0,0,0
106381,0,0,0,0,0
51588,0,0,0,0,0
20657,0,0,0,0,0
54165,0,0,0,0,0
82624,0,0,0,0,0
56225,0,0,0,0,0
78790,0,0,0,0,0
73006,0,0,0,0,0
61540,0,0,0,0,0
56389,0,0,0,0,0
39542,0,0,0,0,0
16094,0,0,0,0,0
120322,0,0,0,0,0
103752,0,0,0,0,0
76279,0,0,0,0,0
24568,0,0,0,0,0
103450,0,0,0,0,0
46266,0,0,0,0,0
69672,0,0,0,0,0
1586,0,0,0,0,0
60793,0,0,0,0,0
76343,0,0,0,0,0
46273,0,0,0,0,0
74792,0,0,0,0,0
89352,0,0,0,0,0
79521,0,0,0,0,0
8231,0,0,0,0,0
26925,0,0,0,0,0
81344,0,0,0,0,0
88366,0,0,0,0,0
10703,0,0,0,0,0
82830,0,0,0,0,0
109111,0,0,0,0,0
24170,0,0,0,0,0
102460,0,0,0,0,0
101090,0,0,0,0,0
94178,0,0,0,0,0
104916,0,0,0,0,0
117058,0,0,0,0,0
85302,0,0,0,0,0
78309,0,0,0,0,0
62614,0,0,0,0,0
53460,0,0,0,0,0
69790,0,0,0,0,0
56626,0,0,0,0,0
58257,0,0,0,0,0
44393,0,0,0,0,0
93377,0,0,0,0,0
26599,0,0,0,0,0
73198,0,0,0,0,0
9565,0,0,0,0,0
115825,0,0,0,0,0
89263,0,0,0,0,0
55127,0,0,0,0,0
35250,0,0,0,0,0
116843,0,0,0,0,0
118085,0,0,0,0,0
104338,0,0,0,0,0
89207,0,0,0,0,0
97603,0,0,0,0,0
67720,0,0,0,0,0
5194,0,0,0,0,0
105897,0,0,0,0,0
72145,0,0,0,0,0
56719,0,0,0,0,0
52882,0,0,0,0,0
89614,0,0,0,0,0
85453,0,0,0,0,0
7007,0,0,0,0,0
46151,0,0,0,0,0
68330,0,0,0,0,0
59044,0,0,0,0,0
64420,1,1,1,0,0
80592,0,0,0,0,0
99718,0,0,0,0,0
37626,0,0,0,0,0
112047,0,0,0,0,0
96589,0,0,0,0,0
37158,0,0,0,0,0
109974,0,0,0,0,0
5824,0,0,0,0,0
45269,0,0,0,0,0
75103,0,0,0,0,0
7400,0,0,0,0,0
43292,0,0,0,0,0
3700,0,0,0,0,0
37056,0,0,0,0,0
15236,0,0,0,0,0
72619,0,0,0,0,0
99798,0,0,0,0,0
32922,0,0,0,0,0
34200,0,0,0,0,0
10047,0,0,0,0,0
38384,0,0,0,0,0
119086,0,0,0,0,0
86106,0,0,0,0,0
76487,0,0,0,0,0
98965,0,0,0,0,0
80527,0,0,0,0,0
39019,0,0,0,0,0
114128,0,0,0,0,0
99223,0,0,0,0,0
17270,0,0,0,0,0
56725,0,0,0,0,0
37411,0,0,0,0,0
104391,0,0,0,0,0
112205,0,0,0,0,0
68878,0,0,0,0,0
21160,0,0,0,0,0
61107,0,0,0,0,0
101132,0,0,0,0,0
8598,0,0,0,0,0
18897,0,0,0,0,0
94571,0,0,0,0,0
105321,0,0,0,0,0
28765,0,0,0,0,0
34494,0,0,0,0,0
106373,0,0,0,0,0
30431,0,0,0,0,0
107448,0,0,0,0,0
79210,0,0,0,0,0
54169,0,0,0,0,0
108903,1,1,1,0,0
53215,0,0,0,0,0
61666,0,0,0,0,0
9325,0,0,0,0,0
68696,0,0,0,0,0
120077,0,0,0,0,0
54424,0,0,0,0,0
66004,0,0,0,0,0
14530,0,0,0,0,0
112881,1,1,1,0,0
81192,0,0,0,0,0
5115,0,0,0,0,0
31048,0,0,0,0,0
97248,0,0,0,0,0
97869,0,0,0,0,0
9278,0,0,0,0,0
45056,0,0,0,0,0
14088,0,0,0,0,0
26654,0,0,0,0,0
80083,0,0,0,0,0
90136,0,0,0,0,0
20751,0,0,0,0,0
55712,0,0,0,0,0
99873,0,0,0,0,0
35244,0,0,0,0,0
51451,0,0,0,0,0
111376,0,0,0,0,0
51494,0,0,0,0,0
20190,0,0,0,0,0
46424,0,0,0,0,0
51783,0,0,0,0,0
95922,0,0,0,0,0
48258,0,0,0,0,0
38127,0,0,0,0,0
87419,0,0,0,0,0
118041,0,0,0,0,0
5416,0,0,0,0,0
74863,0,0,0,0,0
14179,0,0,0,0,0
107895,0,0,0,0,0
114329,0,0,0,0,0
5208,0,0,0,0,0
40117,0,0,0,0,0
39667,0,0,0,0,0
107167,0,0,0,0,0
89775,0,0,0,0,0
38719,0,0,0,0,0
14708,0,0,0,0,0
64016,0,0,0,0,0
42061,0,0,0,0,0
20857,0,0,0,0,0
36140,0,0,0,0,0
56851,0,0,0,0,0
81379,0,0,0,0,0
76276,0,0,0,0,0
13450,0,0,0,0,0
84644,0,0,0,0,0
70471,0,0,0,0,0
47049,0,0,0,0,0
24077,0,0,0,0,0
95823,0,0,0,0,0
24757,0,0,0,0,0
54346,0,0,0,0,0
57552,0,0,0,0,0
28982,0,0,0,0,0
32354,0,0,0,0,0
73687,0,0,0,0,0
8245,0,0,0,0,0
61324,0,0,0,0,0
29343,0,0,0,0,0
32253,0,0,0,0,0
97018,0,0,0,0,0
48133,0,0,0,0,0
86984,0,0,0,0,0
117635,0,0,0,0,0
36079,0,0,0,0,0
55164,0,0,0,0,0
65942,0,0,0,0,0
79533,0,0,0,0,0
99772,0,0,0,0,0
38752,0,0,0,0,0
49486,0,0,0,0,0
86115,0,0,0,0,0
86712,0,0,0,0,0
90848,0,0,0,0,0
106198,0,0,0,0,0
55416,0,0,0,0,0
86439,0,0,0,0,0
38362,0,0,0,0,0
91776,0,0,0,0,0
47476,0,0,0,0,0
54087,0,0,0,0,0
31365,0,0,0,0,0
102627,0,0,0,0,0
53275,0,0,0,0,0
53764,0,0,0,0,0
107564,0,0,0,0,0
23123,0,0,0,0,0
70842,0,0,0,0,0
32015,0,0,0,0,0
50957,0,0,0,0,0
80184,0,0,0,0,0
116686,0,0,0,0,0
86581,0,0,0,0,0
99692,0,0,0,0,0
2515,0,0,0,0,0
19743,0,0,0,0,0
99176,0,0,0,0,0
26328,0,0,0,0,0
102265,0,0,0,0,0
31890,0,0,0,0,0
59180,0,0,0,0,0
19828,0,0,0,0,0
79936,0,0,0,0,0
71705,0,0,0,0,0
40109,0,0,0,0,0
21221,0,0,0,0,0
4553,0,0,0,0,0
51988,0,0,0,0,0
5224,0,0,0,0,0
116717,0,0,0,0,0
28851,0,0,0,0,0
74839,0,0,0,0,0
111463,0,0,0,0,0
80754,0,0,0,0,0
3420,8,8,8,0,0
69731,0,0,0,0,0
14092,0,0,0,0,0
101402,0,0,0,0,0
64435,0,0,0,0,0
35689,0,0,0,0,0
92103,0,0,0,0,0
13010,2,2,2,0,0
11682,0,0,0,0,0
25980,0,0,0,0,0
65051,0,0,0,0,0
39840,0,0,0,0,0
29464,0,0,0,0,0
38402,0,0,0,0,0
48831,0,0,0,0,0
32574,0,0,0,0,0
93413,0,0,0,0,0
107949,0,0,0,0,0
113539,0,0,0,0,0
116841,0,0,0,0,0
72680,0,0,0,0,0
111158,0,0,0,0,0
75879,0,0,0,0,0
51195,0,0,0,0,0
99966,0,0,0,0,0
91674,0,0,0,0,0
104451,0,0,0,0,0
31217,0,0,0,0,0
32771,0,0,0,0,0
64277,0,0,0,0,0
9759,0,0,0,0,0
13978,0,0,0,0,0
109891,0,0,0,0,0
59173,0,0,0,0,0
3398,1,1,1,0,0
110140,0,0,0,0,0
37539,0,0,0,0,0
42675,0,0,0,0,0
21013,0,0,0,0,0
66115,0,0,0,0,0
42484,0,0,0,0,0
87164,0,0,0,0,0
55344,0,0,0,0,0
29927,0,0,0,0,0
33132,0,0,0,0,0
118806,0,0,0,0,0
34098,0,0,0,0,0
8706,0,0,0,0,0
7887,0,0,0,0,0
17846,0,0,0,0,0
67174,0,0,0,0,0
20598,0,0,0,0,0
54354,0,0,0,0,0
74378,0,0,0,0,0
24260,0,0,0,0,0
46046,0,0,0,0,0
89150,0,0,0,0,0
38809,0,0,0,0,0
76284,0,0,0,0,0
60429,0,0,0,0,0
90972,0,0,0,0,0
84948,0,0,0,0,0
105259,0,0,0,0,0
23308,0,0,0,0,0
67194,0,0,0,0,0
67610,0,0,0,0,0
114482,0,0,0,0,0
45420,0,0,0,0,0
23948,0,0,0,0,0
56469,0,0,0,0,0
107892,0,0,0,0,0
8033,0,0,0,0,0
28410,0,0,0,0,0
32367,0,0,0,0,0
40182,0,0,0,0,0
118944,0,0,0,0,0
4504,0,0,0,0,0
101942,0,0,0,0,0
41126,0,0,0,0,0
109102,0,0,0,0,0
75429,0,0,0,0,0
1659,0,0,0,0,0
2005,0,0,0,0,0
64760,0,0,0,0,0
81979,0,0,0,0,0
119087,0,0,0,0,0
41042,0,0,0,0,0
66912,0,0,0,0,0
14921,0,0,0,0,0
101892,0,0,0,0,0
94837,0,0,0,0,0
69423,0,0,0,0,0
44612,0,0,0,0,0
18084,0,0,0,0,0
106512,0,0,0,0,0
15822,0,0,0,0,0
70849,0,0,0,0,0
3763,0,0,0,0,0
115022,0,0,0,0,0
112297,0,0,0,0,0
49205,0,0,0,0,0
46452,0,0,0,0,0
33439,0,0,0,0,0
3034,0,0,0,0,0
110550,0,0,0,0,0
24120,0,0,0,0,0
97739,1,1,1,0,0
115447,0,0,0,0,0
15142,0,0,0,0,0
84775,0,0,0,0,0
58003,0,0,0,0,0
111835,0,0,0,0,0
103285,0,0,0,0,0
82559,0,0,0,0,0
39420,0,0,0,0,0
37058,0,0,0,0,0
38885,0,0,0,0,0
725,0,0,0,0,0
62726,0,0,0,0,0
88072,0,0,0,0,0
44970,0,0,0,0,0
101008,0,0,0,0,0
98860,0,0,0,0,0
31113,0,0,0,0,0
46011,0,0,0,0,0
114392,0,0,0,0,0
102428,0,0,0,0,0
92096,0,0,0,0,0
81290,0,0,0,0,0
13632,0,0,0,0,0
100986,0,0,0,0,0
111115,0,0,0,0,0
58182,0,0,0,0,0
90362,0,0,0,0,0
27814,0,0,0,0,0
34750,0,0,0,0,0
74913,0,0,0,0,0
33632,0,0,0,0,0
117847,0,0,0,0,0
24714,0,0,0,0,0
87906,0,0,0,0,0
16146,0,0,0,0,0
14751,0,0,0,0,0
39232,0,0,0,0,0
12745,0,0,0,0,0
8005,0,0,0,0,0
63893,0,0,0,0,0
39611,0,0,0,0,0
90560,0,0,0,0,0
24796,0,0,0,0,0
91958,0,0,0,0,0
118296,0,0,0,0,0
68176,0,0,0,0,0
51046,0,0,0,0,0
86552,0,0,0,0,0
95781,0,0,0,0,0
115501,2,2,2,0,0
110130,0,0,0,0,0
5876,0,0,0,0,0
53618,0,0,0,0,0
2324,0,0,0,0,0
43658,0,0,0,0,0
92165,0,0,0,0,0
51830,0,0,0,0,0
52014,0,0,0,0,0
75665,0,0,0,0,0
36558,0,0,0,0,0
4112,0,0,0,0,0
12530,0,0,0,0,0
54422,0,0,0,0,0
35463,0,0,0,0,0
68158,0,0,0,0,0
57861,0,0,0,0,0
72638,0,0,0,0,0
99105,0,0,0,0,0
96405,0,0,0,0,0
74671,0,0,0,0,0
88196,0,0,0,0,0
69702,0,0,0,0,0
46610,0,0,0,0,0
40497,0,0,0,0,0
28148,0,0,0,0,0
117343,1,1,1,0,0
55654,0,0,0,0,0
79804,0,0,0,0,0
3947,0,0,0,0,0
99529,0,0,0,0,0
72103,0,0,0,0,0
10567,0,0,0,0,0
119932,0,0,0,0,0
115491,0,0,0,0,0
43747,0,0,0,0,0
116248,0,0,0,0,0
9017,0,0,0,0,0
74734,0,0,0,0,0
119135,0,0,0,0,0
100199,0,0,0,0,0
109425,0,0,0,0,0
92701,0,0,0,0,0
12117,0,0,0,0,0
26684,0,0,0,0,0
58365,0,0,0,0,0
107680,0,0,0,0,0
25105,0,0,0,0,0
86974,0,0,0,0,0
4606,0,0,0,0,0
68633,0,0,0,0,0
57407,0,0,0,0,0
75959,0,0,0,0,0
91565,0,0,0,0,0
13086,0,0,0,0,0
49391,0,0,0,0,0
98674,0,0,0,0,0
17171,0,0,0,0,0
29714,0,0,0,0,0
108135,0,0,0,0,0
44246,0,0,0,0,0
84893,0,0,0,0,0
43871,0,0,0,0,0
33990,0,0,0,0,0
19883,0,0,0,0,0
75158,0,0,0,0,0
49027,0,0,0,0,0
97569,0,0,0,0,0
111440,0,0,0,0,0
29010,0,0,0,0,0
41107,0,0,0,0,0
115134,0,0,0,0,0
92279,0,0,0,0,0
36375,0,0,0,0,0
89580,0,0,0,0,0
87324,0,0,0,0,0
52452,0,0,0,0,0
8384,0,0,0,0,0
41945,0,0,0,0,0
61733,0,0,0,0,0
44065,0,0,0,0,0
34539,0,0,0,0,0
1207,0,0,0,0,0
18315,1,1,1,0,0
20451,0,0,0,0,0
48547,0,0,0,0,0
16848,0,0,0,0,0
32393,0,0,0,0,0
117922,0,0,0,0,0
94343,0,0,0,0,0
102693,0,0,0,0,0
20163,0,0,0,0,0
44187,0,0,0,0,0
2256,0,0,0,0,0
91768,0,0,0,0,0
76364,0,0,0,0,0
17496,0,0,0,0,0
19150,0,0,0,0,0
34193,0,0,0,0,0
5714,0,0,0,0,0
92634,0,0,0,0,0
79648,0,0,0,0,0
77464,0,0,0,0,0
101392,0,0,0,0,0
100821,0,0,0,0,0
94882,0,0,0,0,0
48353,0,0,0,0,0
33378,0,0,0,0,0
68101,0,0,0,0,0
60219,0,0,0,0,0
77143,0,0,0,0,0
32004,0,0,0,0,0
25832,0,0,0,0,0
8301,0,0,0,0,0
40775,0,0,0,0,0
85169,0,0,0,0,0
102783,0,0,0,0,0
20821,0,0,0,0,0
44757,0,0,0,0,0
31088,0,0,0,0,0
102060,0,0,0,0,0
34972,0,0,0,0,0
5970,0,0,0,0,0
100607,0,0,0,0,0
95849,0,0,0,0,0
2361,0,0,0,0,0
112529,0,0,0,0,0
23132,0,0,0,0,0
89793,0,0,0,0,0
41176,0,0,0,0,0
110731,0,0,0,0,0
17793,0,0,0,0,0
87020,0,0,0,0,0
120261,0,0,0,0,0
120363,0,0,0,0,0
80563,0,0,0,0,0
15868,0,0,0,0,0
22445,0,0,0,0,0
40551,1,1,1,0,0
74308,0,0,0,0,0
82265,0,0,0,0,0
72029,1,1,1,0,0
53834,0,0,0,0,0
48574,0,0,0,0,0
33703,0,0,0,0,0
1301,0,0,0,0,0
45878,0,0,0,0,0
117988,0,0,0,0,0
41189,0,0,0,0,0
24165,0,0,0,0,0
94986,0,0,0,0,0
19227,0,0,0,0,0
66453,0,0,0,0,0
55600,0,0,0,0,0
88064,0,0,0,0,0
99712,0,0,0,0,0
60534,0,0,0,0,0
86279,0,0,0,0,0
74380,0,0,0,0,0
107434,0,0,0,0,0
63467,0,0,0,0,0
60936,0,0,0,0,0
119779,0,0,0,0,0
117283,0,0,0,0,0
44126,0,0,0,0,0
76296,0,0,0,0,0
55410,0,0,0,0,0
40447,0,0,0,0,0
30520,0,0,0,0,0
97163,0,0,0,0,0
53461,0,0,0,0,0
5530,0,0,0,0,0
92811,0,0,0,0,0
97483,0,0,0,0,0
51513,0,0,0,0,0
92755,0,0,0,0,0
102067,0,0,0,0,0
81378,0,0,0,0,0
108202,0,0,0,0,0
104164,0,0,0,0,0
86474,0,0,0,0,0
46216,0,0,0,0,0
75727,0,0,0,0,0
53761,0,0,0,0,0
35505,0,0,0,0,0
32425,0,0,0,0,0
33356,0,0,0,0,0
32157,0,0,0,0,0
43733,0,0,0,0,0
117812,0,0,0,0,0
57644,0,0,0,0,0
99724,0,0,0,0,0
4899,0,0,0,0,0
87645,0,0,0,0,0
48859,0,0,0,0,0
86988,0,0,0,0,0
118302,0,0,0,0,0
99480,0,0,0,0,0
65507,0,0,0,0,0
4633,0,0,0,0,0
1725,0,0,0,0,0
39403,0,0,0,0,0
71146,0,0,0,0,0
86571,0,0,0,0,0
72976,0,0,0,0,0
81074,0,0,0,0,0
104006,0,0,0,0,0
84790,0,0,0,0,0
23383,0,0,0,0,0
19663,0,0,0,0,0
78497,0,0,0,0,0
63290,0,0,0,0,0
3787,2,2,2,0,0
26595,0,0,0,0,0
60519,0,0,0,0,0
20025,0,0,0,0,0
8400,0,0,0,0,0
25057,0,0,0,0,0
26166,0,0,0,0,0
107222,0,0,0,0,0
13395,0,0,0,0,0
76775,0,0,0,0,0
7191,0,0,0,0,0
63494,0,0,0,0,0
91477,0,0,0,0,0
93995,0,0,0,0,0
27175,0,0,0,0,0
57305,0,0,0,0,0
110813,0,0,0,0,0
69584,0,0,0,0,0
116913,1,1,1,0,0
92912,0,0,0,0,0
53604,0,0,0,0,0
111034,0,0,0,0,0
91858,0,0,0,0,0
75672,0,0,0,0,0
112321,0,0,0,0,0
37045,0,0,0,0,0
105590,0,0,0,0,0
25773,0,0,0,0,0
23740,0,0,0,0,0
73723,0,0,0,0,0
4341,2,2,2,0,0
104892,0,0,0,0,0
102417,0,0,0,0,0
112515,0,0,0,0,0
29696,0,0,0,0,0
100552,0,0,0,0,0
6807,0,0,0,0,0
74948,0,0,0,0,0
70408,0,0,0,0,0
95336,0,0,0,0,0
194,0,0,0,0,0
63837,0,0,0,0,0
77729,0,0,0,0,0
40071,0,0,0,0,0
81404,0,0,0,0,0
2093,0,0,0,0,0
70589,0,0,0,0,0
99803,0,0,0,0,0
100117,0,0,0,0,0
109849,0,0,0,0,0
91263,0,0,0,0,0
100884,0,0,0,0,0
100289,0,0,0,0,0
31650,0,0,0,0,0
118695,0,0,0,0,0
98386,0,0,0,0,0
53150,0,0,0,0,0
56316,0,0,0,0,0
10521,0,0,0,0,0
75397,0,0,0,0,0
89498,0,0,0,0,0
96166,0,0,0,0,0
106126,0,0,0,0,0
15145,0,0,0,0,0
3449,0,0,0,0,0
32323,0,0,0,0,0
59687,0,0,0,0,0
112398,0,0,0,0,0
105083,0,0,0,0,0
119121,0,0,0,0,0
30744,0,0,0,0,0
4259,0,0,0,0,0
51556,0,0,0,0,0
82604,0,0,0,0,0
49117,0,0,0,0,0
35623,0,0,0,0,0
99819,0,0,0,0,0
12419,0,0,0,0,0
109216,0,0,0,0,0
94363,0,0,0,0,0
43506,0,0,0,0,0
72275,0,0,0,0,0
48054,0,0,0,0,0
37909,0,0,0,0,0
59585,0,0,0,0,0
106046,0,0,0,0,0
111681,0,0,0,0,0
76105,0,0,0,0,0
31808,0,0,0,0,0
114332,0,0,0,0,0
86652,0,0,0,0,0
31965,0,0,0,0,0
85593,0,0,0,0,0
106237,0,0,0,0,0
117314,0,0,0,0,0
55150,0,0,0,0,0
118169,0,0,0,0,0
69638,0,0,0,0,0
111246,0,0,0,0,0
70722,0,0,0,0,0
74637,0,0,0,0,0
44430,0,0,0,0,0
53611,0,0,0,0,0
54828,0,0,0,0,0
39751,0,0,0,0,0
13227,0,0,0,0,0
18115,0,0,0,0,0
101210,0,0,0,0,0
93585,0,0,0,0,0
11688,0,0,0,0,0
36626,0,0,0,0,0
71838,0,0,0,0,0
36353,0,0,0,0,0
74933,0,0,0,0,0
80141,0,0,0,0,0
118333,0,0,0,0,0
21872,0,0,0,0,0
95168,0,0,0,0,0
61629,0,0,0,0,0
15697,0,0,0,0,0
103383,0,0,0,0,0
104831,0,0,0,0,0
4955,0,0,0,0,0
87127,0,0,0,0,0
110607,0,0,0,0,0
96232,0,0,0,0,0
110769,0,0,0,0,0
105245,0,0,0,0,0
41143,0,0,0,0,0
120325,0,0,0,0,0
4448,0,0,0,0,0
57968,0,0,0,0,0
24115,0,0,0,0,0
66701,0,0,0,0,0
38708,0,0,0,0,0
116193,0,0,0,0,0
113356,0,0,0,0,0
21068,0,0,0,0,0
103469,0,0,0,0,0
24596,0,0,0,0,0
26382,0,0,0,0,0
19324,0,0,0,0,0
64772,0,0,0,0,0
116154,0,0,0,0,0
93927,0,0,0,0,0
23332,0,0,0,0,0
66387,0,0,0,0,0
114088,0,0,0,0,0
8575,0,0,0,0,0
102733,0,0,0,0,0
93439,0,0,0,0,0
41987,0,0,0,0,0
112504,0,0,0,0,0
7244,0,0,0,0,0
67111,0,0,0,0,0
114094,0,0,0,0,0
28694,0,0,0,0,0
104713,0,0,0,0,0
106749,0,0,0,0,0
15386,0,0,0,0,0
115125,0,0,0,0,0
96796,0,0,0,0,0
19999,0,0,0,0,0
107213,0,0,0,0,0
74404,0,0,0,0,0
53000,0,0,0,0,0
74607,0,0,0,0,0
60021,0,0,0,0,0
79098,0,0,0,0,0
78061,0,0,0,0,0
74754,0,0,0,0,0
18852,0,0,0,0,0
21249,0,0,0,0,0
80366,0,0,0,0,0
89858,0,0,0,0,0
87337,0,0,0,0,0
69,0,0,0,0,0
16735,0,0,0,0,0
19561,0,0,0,0,0
11660,0,0,0,0,0
111850,0,0,0,0,0
15532,0,0,0,0,0
8882,0,0,0,0,0
95978,0,0,0,0,0
90301,0,0,0,0,0
104113,0,0,0,0,0
91694,0,0,0,0,0
115074,1,1,1,0,0
89202,0,0,0,0,0
87210,0,0,0,0,0
118758,0,0,0,0,0
80518,0,0,0,0,0
44347,0,0,0,0,0
9692,0,0,0,0,0
79746,0,0,0,0,0
7068,0,0,0,0,0
10124,0,0,0,0,0
85196,0,0,0,0,0
79957,0,0,0,0,0
48383,0,0,0,0,0
15356,0,0,0,0,0
96103,0,0,0,0,0
66745,0,0,0,0,0
14244,0,0,0,0,0
44034,0,0,0,0,0
70982,0,0,0,0,0
111027,0,0,0,0,0
108032,0,0,0,0,0
73535,0,0,0,0,0
110450,2,2,2,0,0
38698,0,0,0,0,0
61312,0,0,0,0,0
105303,0,0,0,0,0
49277,0,0,0,0,0
96750,0,0,0,0,0
69035,2,2,2,0,0
113114,0,0,0,0,0
97186,0,0,0,0,0
97121,0,0,0,0,0
14107,1,1,1,0,0
59507,0,0,0,0,0
29787,0,0,0,0,0
20596,0,0,0,0,0
120147,0,0,0,0,0
70298,0,0,0,0,0
68289,0,0,0,0,0
53385,0,0,0,0,0
13109,0,0,0,0,0
20081,6,6,6,0,0
67220,0,0,0,0,0
28658,0,0,0,0,0
24556,0,0,0,0,0
81717,0,0,0,0,0
102985,0,0,0,0,0
98349,0,0,0,0,0
60780,0,0,0,0,0
76075,0,0,0,0,0
5293,0,0,0,0,0
23936,0,0,0,0,0
53542,0,0,0,0,0
97056,0,0,0,0,0
77169,0,0,0,0,0
118389,0,0,0,0,0
117008,0,0,0,0,0
69685,0,0,0,0,0
69221,0,0,0,0,0
2513,0,0,0,0,0
10710,0,0,0,0,0
116973,0,0,0,0,0
92154,0,0,0,0,0
94751,0,0,0,0,0
94605,0,0,0,0,0
100101,0,0,0,0,0
111400,0,0,0,0,0
115959,0,0,0,0,0
93545,1,1,1,0,0
34327,0,0,0,0,0
95933,0,0,0,0,0
61839,0,0,0,0,0
72014,0,0,0,0,0
109156,0,0,0,0,0
85993,3,3,3,0,0
92495,0,0,0,0,0
13532,0,0,0,0,0
96118,0,0,0,0,0
50899,0,0,0,0,0
77544,0,0,0,0,0
12881,0,0,0,0,0
34708,0,0,0,0,0
61943,0,0,0,0,0
93456,0,0,0,0,0
66499,0,0,0,0,0
118140,0,0,0,0,0
45944,0,0,0,0,0
41857,0,0,0,0,0
48962,0,0,0,0,0
74013,0,0,0,0,0
97168,0,0,0,0,0
63438,0,0,0,0,0
85052,0,0,0,0,0
47729,0,0,0,0,0
119414,0,0,0,0,0
14417,0,0,0,0,0
66633,0,0,0,0,0
38391,0,0,0,0,0
96753,0,0,0,0,0
86469,0,0,0,0,0
87695,0,0,0,0,0
97415,0,0,0,0,0
57953,0,0,0,0,0
16093,0,0,0,0,0
28361,0,0,0,0,0
100667,0,0,0,0,0
19456,0,0,0,0,0
115598,0,0,0,0,0
69592,0,0,0,0,0
82228,2,2,2,0,0
86930,0,0,0,0,0
20813,0,0,0,0,0
111414,0,0,0,0,0
55996,0,0,0,0,0
32244,0,0,0,0,0
13964,0,0,0,0,0
23001,0,0,0,0,0
95418,0,0,0,0,0
82221,0,0,0,0,0
77335,0,0,0,0,0
51505,0,0,0,0,0
100831,0,0,0,0,0
2544,0,0,0,0,0
110669,0,0,0,0,0
68991,0,0,0,0,0
15511,0,0,0,0,0
82679,0,0,0,0,0
56438,0,0,0,0,0
71538,0,0,0,0,0
55655,0,0,0,0,0
112090,0,0,0,0,0
11206,0,0,0,0,0
1433,0,0,0,0,0
46048,1,1,1,0,0
105351,0,0,0,0,0
114209,0,0,0,0,0
78887,0,0,0,0,0
92341,0,0,0,0,0
26673,0,0,0,0,0
13805,0,0,0,0,0
56681,0,0,0,0,0
92118,0,0,0,0,0
94922,0,0,0,0,0
96859,0,0,0,0,0
84020,0,0,0,0,0
54820,0,0,0,0,0
42420,0,0,0,0,0
29384,0,0,0,0,0
104134,0,0,0,0,0
78313,0,0,0,0,0
100189,0,0,0,0,0
51829,0,0,0,0,0
46806,0,0,0,0,0
94619,0,0,0,0,0
87283,0,0,0,0,0
107005,0,0,0,0,0
104935,0,0,0,0,0
71926,0,0,0,0,0
16043,0,0,0,0,0
37156,0,0,0,0,0
18906,0,0,0,0,0
15647,0,0,0,0,0
14540,0,0,0,0,0
16514,0,0,0,0,0
91391,0,0,0,0,0
65704,0,0,0,0,0
70815,0,0,0,0,0
33348,0,0,0,0,0
99686,0,0,0,0,0
118743,0,0,0,0,0
100273,0,0,0,0,0
94849,0,0,0,0,0
61036,0,0,0,0,0
1419,0,0,0,0,0
115265,0,0,0,0,0
57594,0,0,0,0,0
38847,0,0,0,0,0
103568,0,0,0,0,0
65259,0,0,0,0,0
74160,0,0,0,0,0
77717,0,0,0,0,0
74528,0,0,0,0,0
29231,0,0,0,0,0
32804,0,0,0,0,0
85216,0,0,0,0,0
18916,0,0,0,0,0
75596,0,0,0,0,0
47088,0,0,0,0,0
85183,0,0,0,0,0
2464,1,1,1,0,0
62142,0,0,0,0,0
97644,0,0,0,0,0
23656,0,0,0,0,0
69213,0,0,0,0,0
32501,0,0,0,0,0
120425,0,0,0,0,0
49927,0,0,0,0,0
66698,0,0,0,0,0
93472,0,0,0,0,0
44862,0,0,0,0,0
102986,0,0,0,0,0
11671,0,0,0,0,0
74643,0,0,0,0,0
33392,0,0,0,0,0
100558,0,0,0,0,0
35021,0,0,0,0,0
45091,0,0,0,0,0
119642,0,0,0,0,0
107265,0,0,0,0,0
18546,0,0,0,0,0
12841,0,0,0,0,0
30181,0,0,0,0,0
11506,0,0,0,0,0
74005,0,0,0,0,0
78737,0,0,0,0,0
539,0,0,0,0,0
37442,0,0,0,0,0
54742,0,0,0,0,0
6258,0,0,0,0,0
62400,0,0,0,0,0
21786,0,0,0,0,0
73417,0,0,0,0,0
69393,0,0,0,0,0
64066,0,0,0,0,0
84378,0,0,0,0,0
78381,0,0,0,0,0
110016,0,0,0,0,0
285,0,0,0,0,0
51913,0,0,0,0,0
25303,1,1,1,0,0
40136,0,0,0,0,0
110343,0,0,0,0,0
17642,0,0,0,0,0
110290,0,0,0,0,0
34185,0,0,0,0,0
24748,0,0,0,0,0
97167,0,0,0,0,0
41831,0,0,0,0,0
63711,0,0,0,0,0
57281,0,0,0,0,0
84579,0,0,0,0,0
20168,0,0,0,0,0
27567,0,0,0,0,0
98685,0,0,0,0,0
8601,0,0,0,0,0
25055,0,0,0,0,0
45832,0,0,0,0,0
106451,0,0,0,0,0
113962,0,0,0,0,0
110053,0,0,0,0,0
64638,0,0,0,0,0
96112,0,0,0,0,0
17139,0,0,0,0,0
33846,0,0,0,0,0
15310,0,0,0,0,0
46766,0,0,0,0,0
68472,0,0,0,0,0
56981,0,0,0,0,0
54787,0,0,0,0,0
52456,0,0,0,0,0
11844,0,0,0,0,0
120463,0,0,0,0,0
58270,0,0,0,0,0
90000,0,0,0,0,0
111991,0,0,0,0,0
42450,0,0,0,0,0
95573,0,0,0,0,0
107986,0,0,0,0,0
86322,0,0,0,0,0
77545,0,0,0,0,0
26866,0,0,0,0,0
27531,0,0,0,0,0
72098,0,0,0,0,0
65412,0,0,0,0,0
69333,0,0,0,0,0
34495,0,0,0,0,0
115925,0,0,0,0,0
25678,0,0,0,0,0
12098,0,0,0,0,0
76493,0,0,0,0,0
59040,0,0,0,0,0
119607,0,0,0,0,0
30542,0,0,0,0,0
93841,0,0,0,0,0
105679,0,0,0,0,0
86151,0,0,0,0,0
92442,0,0,0,0,0
50699,0,0,0,0,0
72667,0,0,0,0,0
34413,0,0,0,0,0
120189,0,0,0,0,0
117566,0,0,0,0,0
12554,0,0,0,0,0
92391,0,0,0,0,0
109547,0,0,0,0,0
47527,2,2,2,0,0
48090,2,2,2,0,0
70200,0,0,0,0,0
76661,0,0,0,0,0
72378,0,0,0,0,0
116690,0,0,0,0,0
98840,0,0,0,0,0
83076,0,0,0,0,0
23420,0,0,0,0,0
90142,0,0,0,0,0
41171,0,0,0,0,0
111019,0,0,0,0,0
100442,0,0,0,0,0
51117,0,0,0,0,0
93112,0,0,0,0,0
65181,0,0,0,0,0
116433,0,0,0,0,0
18077,0,0,0,0,0
36124,0,0,0,0,0
116105,0,0,0,0,0
9073,0,0,0,0,0
97038,0,0,0,0,0
90122,0,0,0,0,0
89219,0,0,0,0,0
105571,0,0,0,0,0
76529,0,0,0,0,0
91774,0,0,0,0,0
103785,0,0,0,0,0
50337,0,0,0,0,0
59808,0,0,0,0,0
67563,0,0,0,0,0
67829,0,0,0,0,0
21545,0,0,0,0,0
65563,0,0,0,0,0
103608,0,0,0,0,0
12677,0,0,0,0,0
9321,0,0,0,0,0
36011,0,0,0,0,0
81393,0,0,0,0,0
66162,0,0,0,0,0
47763,0,0,0,0,0
16963,0,0,0,0,0
117520,0,0,0,0,0
17680,0,0,0,0,0
75383,1,1,1,0,0
69800,0,0,0,0,0
98849,1,1,1,0,0
116010,0,0,0,0,0
84592,0,0,0,0,0
31699,0,0,0,0,0
87607,0,0,0,0,0
68014,0,0,0,0,0
96282,0,0,0,0,0
49359,0,0,0,0,0
14390,0,0,0,0,0
118939,0,0,0,0,0
4831,0,0,0,0,0
72929,0,0,0,0,0
60327,0,0,0,0,0
14824,0,0,0,0,0
101708,0,0,0,0,0
40883,0,0,0,0,0
19237,0,0,0,0,0
112245,0,0,0,0,0
68577,0,0,0,0,0
36078,0,0,0,0,0
18980,0,0,0,0,0
41015,0,0,0,0,0
37286,0,0,0,0,0
21463,0,0,0,0,0
20145,0,0,0,0,0
40228,0,0,0,0,0
70221,0,0,0,0,0
8761,0,0,0,0,0
74025,0,0,0,0,0
32201,0,0,0,0,0
106647,0,0,0,0,0
81573,0,0,0,0,0
59541,0,0,0,0,0
65951,0,0,0,0,0
120293,0,0,0,0,0
24223,0,0,0,0,0
29168,0,0,0,0,0
110977,0,0,0,0,0
69624,0,0,0,0,0
35155,0,0,0,0,0
64500,0,0,0,0,0
102019,0,0,0,0,0
107330,0,0,0,0,0
99580,0,0,0,0,0
106698,0,0,0,0,0
116671,0,0,0,0,0
52236,0,0,0,0,0
46854,0,0,0,0,0
31347,0,0,0,0,0
113309,0,0,0,0,0
95763,0,0,0,0,0
47012,0,0,0,0,0
95001,0,0,0,0,0
82945,0,0,0,0,0
7666,0,0,0,0,0
30471,0,0,0,0,0
78699,1,1,1,0,0
2606,0,0,0,0,0
87526,0,0,0,0,0
23211,0,0,0,0,0
109840,0,0,0,0,0
681,0,0,0,0,0
2829,0,0,0,0,0
109092,1,1,1,0,0
63013,0,0,0,0,0
83617,0,0,0,0,0
28300,0,0,0,0,0
13757,2,2,2,0,0
87016,0,0,0,0,0
37296,0,0,0,0,0
12606,0,0,0,0,0
44272,0,0,0,0,0
63927,0,0,0,0,0
31618,0,0,0,0,0
109934,0,0,0,0,0
77217,0,0,0,0,0
66138,0,0,0,0,0
53641,0,0,0,0,0
63661,0,0,0,0,0
17623,0,0,0,0,0
84085,0,0,0,0,0
57378,0,0,0,0,0
104139,0,0,0,0,0
69498,0,0,0,0,0
112110,0,0,0,0,0
13524,0,0,0,0,0
70609,0,0,0,0,0
86901,0,0,0,0,0
28256,0,0,0,0,0
116508,0,0,0,0,0
105971,0,0,0,0,0
86208,0,0,0,0,0
39087,0,0,0,0,0
78078,0,0,0,0,0
56932,0,0,0,0,0
12926,0,0,0,0,0
109133,0,0,0,0,0
3368,0,0,0,0,0
94956,0,0,0,0,0
90983,0,0,0,0,0
29193,0,0,0,0,0
40345,0,0,0,0,0
40814,0,0,0,0,0
53500,0,0,0,0,0
86246,0,0,0,0,0
36240,0,0,0,0,0
66386,0,0,0,0,0
31911,0,0,0,0,0
18833,0,0,0,0,0
393,0,0,0,0,0
4094,0,0,0,0,0
19312,0,0,0,0,0
105014,0,0,0,0,0
77478,0,0,0,0,0
56148,0,0,0,0,0
105964,0,0,0,0,0
117788,0,0,0,0,0
117735,0,0,0,0,0
4920,0,0,0,0,0
114826,0,0,0,0,0
76165,0,0,0,0,0
81327,0,0,0,0,0
118437,0,0,0,0,0
19014,0,0,0,0,0
15566,0,0,0,0,0
62480,0,0,0,0,0
77048,0,0,0,0,0
117018,0,0,0,0,0
79061,0,0,0,0,0
104635,0,0,0,0,0
44383,0,0,0,0,0
3638,0,0,0,0,0
50068,0,0,0,0,0
5425,0,0,0,0,0
8482,0,0,0,0,0
6710,0,0,0,0,0
79166,0,0,0,0,0
12985,0,0,0,0,0
25097,0,0,0,0,0
6645,0,0,0,0,0
19700,0,0,0,0,0
14857,0,0,0,0,0
67453,0,0,0,0,0
464,0,0,0,0,0
109973,0,0,0,0,0
53209,0,0,0,0,0
23529,0,0,0,0,0
74195,0,0,0,0,0
12734,0,0,0,0,0
15264,0,0,0,0,0
115114,0,0,0,0,0
17226,0,0,0,0,0
113380,0,0,0,0,0
5762,0,0,0,0,0
108980,0,0,0,0,0
47339,0,0,0,0,0
27815,0,0,0,0,0
119845,0,0,0,0,0
53921,0,0,0,0,0
108634,0,0,0,0,0
107512,0,0,0,0,0
66396,0,0,0,0,0
50829,0,0,0,0,0
25920,0,0,0,0,0
56104,0,0,0,0,0
68582,0,0,0,0,0
60167,0,0,0,0,0
81809,0,0,0,0,0
103077,0,0,0,0,0
71445,0,0,0,0,0
9092,0,0,0,0,0
72669,0,0,0,0,0
2002,0,0,0,0,0
88350,0,0,0,0,0
6649,0,0,0,0,0
119291,0,0,0,0,0
25393,0,0,0,0,0
6553,0,0,0,0,0
56587,0,0,0,0,0
26855,0,0,0,0,0
18782,0,0,0,0,0
70523,0,0,0,0,0
87381,0,0,0,0,0
27738,0,0,0,0,0
97713,0,0,0,0,0
107773,0,0,0,0,0
70763,0,0,0,0,0
20777,0,0,0,0,0
26547,0,0,0,0,0
88132,0,0,0,0,0
44571,1,1,1,0,0
43430,0,0,0,0,0
26624,0,0,0,0,0
57019,0,0,0,0,0
93362,1,1,1,0,0
97548,0,0,0,0,0
116648,0,0,0,0,0
45175,0,0,0,0,0
41274,0,0,0,0,0
25496,0,0,0,0,0
117246,0,0,0,0,0
70926,0,0,0,0,0
2360,0,0,0,0,0
18721,0,0,0,0,0
8851,0,0,0,0,0
111351,0,0,0,0,0
109330,0,0,0,0,0
106162,0,0,0,0,0
88667,0,0,0,0,0
43434,0,0,0,0,0
27467,0,0,0,0,0
9166,0,0,0,0,0
47747,0,0,0,0,0
102090,1,1,1,0,0
102231,0,0,0,0,0
35178,0,0,0,0,0
34651,0,0,0,0,0
43787,0,0,0,0,0
109144,0,0,0,0,0
85536,0,0,0,0,0
34976,0,0,0,0,0
6079,0,0,0,0,0
13387,0,0,0,0,0
94114,0,0,0,0,0
105632,0,0,0,0,0
43431,0,0,0,0,0
80278,0,0,0,0,0
54678,0,0,0,0,0
25161,0,0,0,0,0
59031,0,0,0,0,0
77306,0,0,0,0,0
69108,0,0,0,0,0
107678,0,0,0,0,0
69218,0,0,0,0,0
35148,0,0,0,0,0
15463,0,0,0,0,0
1906,0,0,0,0,0
43922,0,0,0,0,0
18870,0,0,0,0,0
70864,0,0,0,0,0
73238,0,0,0,0,0
64101,0,0,0,0,0
103979,0,0,0,0,0
4960,0,0,0,0,0
16717,0,0,0,0,0
95038,0,0,0,0,0
39890,0,0,0,0,0
114083,0,0,0,0,0
38347,0,0,0,0,0
98612,0,0,0,0,0
104555,0,0,0,0,0
112026,0,0,0,0,0
71469,0,0,0,0,0
12174,0,0,0,0,0
80358,0,0,0,0,0
105210,0,0,0,0,0
109729,0,0,0,0,0
90300,0,0,0,0,0
59472,0,0,0,0,0
49057,0,0,0,0,0
8350,0,0,0,0,0
13079,0,0,0,0,0
84230,0,0,0,0,0
6516,0,0,0,0,0
114263,0,0,0,0,0
20885,0,0,0,0,0
72,0,0,0,0,0
52352,0,0,0,0,0
9992,0,0,0,0,0
24063,0,0,0,0,0
94301,0,0,0,0,0
105036,0,0,0,0,0
29529,0,0,0,0,0
25033,0,0,0,0,0
81642,0,0,0,0,0
29781,0,0,0,0,0
70046,0,0,0,0,0
2784,0,0,0,0,0
81174,0,0,0,0,0
9856,0,0,0,0,0
68808,0,0,0,0,0
7086,0,0,0,0,0
99922,0,0,0,0,0
48613,0,0,0,0,0
14261,0,0,0,0,0
33351,0,0,0,0,0
61298,0,0,0,0,0
113337,0,0,0,0,0
77895,0,0,0,0,0
48239,0,0,0,0,0
43001,0,0,0,0,0
47540,0,0,0,0,0
33006,0,0,0,0,0
18635,0,0,0,0,0
75695,0,0,0,0,0
37166,0,0,0,0,0
101111,0,0,0,0,0
49413,0,0,0,0,0
14166,0,0,0,0,0
39462,0,0,0,0,0
84301,0,0,0,0,0
42362,4,4,4,0,0
89277,0,0,0,0,0
5430,0,0,0,0,0
53975,0,0,0,0,0
3529,0,0,0,0,0
72087,0,0,0,0,0
102687,2,2,2,0,0
95401,0,0,0,0,0
45614,0,0,0,0,0
5808,0,0,0,0,0
51172,0,0,0,0,0
79635,0,0,0,0,0
101100,0,0,0,0,0
64463,0,0,0,0,0
3074,0,0,0,0,0
70963,0,0,0,0,0
60271,0,0,0,0,0
25335,0,0,0,0,0
80876,0,0,0,0,0
63708,0,0,0,0,0
35520,0,0,0,0,0
38743,0,0,0,0,0
35240,0,0,0,0,0
35291,0,0,0,0,0
78306,0,0,0,0,0
76600,0,0,0,0,0
11817,0,0,0,0,0
4836,0,0,0,0,0
11297,0,0,0,0,0
9743,0,0,0,0,0
75630,0,0,0,0,0
115076,0,0,0,0,0
65291,0,0,0,0,0
72590,0,0,0,0,0
56301,0,0,0,0,0
7138,0,0,0,0,0
66266,0,0,0,0,0
37784,0,0,0,0,0
16266,0,0,0,0,0
82622,0,0,0,0,0
21534,0,0,0,0,0
25312,0,0,0,0,0
107991,0,0,0,0,0
45435,0,0,0,0,0
51432,0,0,0,0,0
87635,0,0,0,0,0
44665,0,0,0,0,0
64968,0,0,0,0,0
53668,0,0,0,0,0
61504,0,0,0,0,0
90786,0,0,0,0,0
3211,0,0,0,0,0
59372,0,0,0,0,0
49835,0,0,0,0,0
84719,0,0,0,0,0
36328,0,0,0,0,0
1689,0,0,0,0,0
120021,0,0,0,0,0
48676,0,0,0,0,0
79132,0,0,0,0,0
106759,0,0,0,0,0
69821,0,0,0,0,0
94133,0,0,0,0,0
30531,0,0,0,0,0
103297,0,0,0,0,0
22183,0,0,0,0,0
68593,0,0,0,0,0
49371,0,0,0,0,0
27992,0,0,0,0,0
36602,0,0,0,0,0
103885,0,0,0,0,0
79504,0,0,0,0,0
11610,0,0,0,0,0
92717,0,0,0,0,0
91006,0,0,0,0,0
42388,0,0,0,0,0
108060,0,0,0,0,0
2502,0,0,0,0,0
75168,0,0,0,0,0
120015,0,0,0,0,0
32358,0,0,0,0,0
115015,0,0,0,0,0
76823,0,0,0,0,0
104073,0,0,0,0,0
25160,0,0,0,0,0
111372,0,0,0,0,0
7230,0,0,0,0,0
11738,0,0,0,0,0
59261,0,0,0,0,0
15841,0,0,0,0,0
1509,0,0,0,0,0
118449,0,0,0,0,0
113319,0,0,0,0,0
78359,0,0,0,0,0
31941,0,0,0,0,0
98729,0,0,0,0,0
79239,0,0,0,0,0
51035,0,0,0,0,0
87367,0,0,0,0,0
61799,0,0,0,0,0
49743,0,0,0,0,0
112259,0,0,0,0,0
71463,0,0,0,0,0
8136,0,0,0,0,0
44538,0,0,0,0,0
94580,0,0,0,0,0
43669,0,0,0,0,0
104161,0,0,0,0,0
54172,0,0,0,0,0
60408,0,0,0,0,0
69687,0,0,0,0,0
52673,0,0,0,0,0
32303,0,0,0,0,0
102361,0,0,0,0,0
71232,0,0,0,0,0
104769,0,0,0,0,0
60465,0,0,0,0,0
50838,0,0,0,0,0
52496,0,0,0,0,0
92352,0,0,0,0,0
103427,0,0,0,0,0
88774,0,0,0,0,0
72504,0,0,0,0,0
114839,0,0,0,0,0
47221,0,0,0,0,0
60694,0,0,0,0,0
22282,0,0,0,0,0
41096,0,0,0,0,0
104508,0,0,0,0,0
23219,0,0,0,0,0
103351,0,0,0,0,0
109816,0,0,0,0,0
41785,0,0,0,0,0
57092,0,0,0,0,0
78964,0,0,0,0,0
1275,0,0,0,0,0
31657,0,0,0,0,0
24470,0,0,0,0,0
73094,0,0,0,0,0
48713,0,0,0,0,0
5088,0,0,0,0,0
80860,0,0,0,0,0
72178,0,0,0,0,0
78681,0,0,0,0,0
5165,0,0,0,0,0
89322,0,0,0,0,0
36643,0,0,0,0,0
65990,0,0,0,0,0
14214,0,0,0,0,0
88653,0,0,0,0,0
107164,0,0,0,0,0
117710,0,0,0,0,0
7864,0,0,0,0,0
75796,0,0,0,0,0
33012,0,0,0,0,0
16477,0,0,0,0,0
108787,0,0,0,0,0
45429,0,0,0,0,0
102805,0,0,0,0,0
65397,0,0,0,0,0
16361,1,1,1,0,0
28473,0,0,0,0,0
77726,0,0,0,0,0
108775,0,0,0,0,0
11320,0,0,0,0,0
24893,0,0,0,0,0
13006,0,0,0,0,0
101954,0,0,0,0,0
44163,0,0,0,0,0
53567,0,0,0,0,0
103686,0,0,0,0,0
9752,0,0,0,0,0
115219,0,0,0,0,0
42583,0,0,0,0,0
112880,0,0,0,0,0
116822,0,0,0,0,0
57735,0,0,0,0,0
55073,0,0,0,0,0
86887,0,0,0,0,0
109480,0,0,0,0,0
61727,0,0,0,0,0
437,0,0,0,0,0
115662,0,0,0,0,0
117801,0,0,0,0,0
32002,0,0,0,0,0
87665,0,0,0,0,0
64331,0,0,0,0,0
93072,0,0,0,0,0
11147,0,0,0,0,0
48719,0,0,0,0,0
69932,0,0,0,0,0
76294,0,0,0,0,0
112452,0,0,0,0,0
24029,0,0,0,0,0
109496,0,0,0,0,0
48938,0,0,0,0,0
89662,0,0,0,0,0
70739,0,0,0,0,0
94086,0,0,0,0,0
111839,0,0,0,0,0
956,0,0,0,0,0
45718,0,0,0,0,0
33879,0,0,0,0,0
95044,0,0,0,0,0
33978,0,0,0,0,0
79154,0,0,0,0,0
51346,0,0,0,0,0
33053,0,0,0,0,0
94825,0,0,0,0,0
20573,0,0,0,0,0
3133,0,0,0,0,0
87961,0,0,0,0,0
25588,0,0,0,0,0
51874,0,0,0,0,0
25207,0,0,0,0,0
99193,0,0,0,0,0
66571,0,0,0,0,0
45079,0,0,0,0,0
38413,0,0,0,0,0
84186,1,1,1,0,0
28252,0,0,0,0,0
35841,0,0,0,0,0
63221,0,0,0,0,0
45940,0,0,0,0,0
30764,0,0,0,0,0
72713,0,0,0,0,0
16622,0,0,0,0,0
21130,0,0,0,0,0
109206,0,0,0,0,0
57495,0,0,0,0,0
68199,0,0,0,0,0
102820,0,0,0,0,0
71090,0,0,0,0,0
46510,0,0,0,0,0
36064,0,0,0,0,0
31654,0,0,0,0,0
42056,0,0,0,0,0
72754,0,0,0,0,0
66240,0,0,0,0,0
69200,0,0,0,0,0
110535,0,0,0,0,0
36841,0,0,0,0,0
68414,0,0,0,0,0
57960,0,0,0,0,0
56190,0,0,0,0,0
91430,0,0,0,0,0
34433,0,0,0,0,0
4707,0,0,0,0,0
76549,0,0,0,0,0
101367,0,0,0,0,0
35758,0,0,0,0,0
92385,0,0,0,0,0
73848,0,0,0,0,0
53269,0,0,0,0,0
43089,0,0,0,0,0
104103,0,0,0,0,0
91076,0,0,0,0,0
112973,0,0,0,0,0
101188,0,0,0,0,0
106978,0,0,0,0,0
33078,0,0,0,0,0
32844,0,0,0,0,0
15611,0,0,0,0,0
30418,0,0,0,0,0
4083,0,0,0,0,0
13297,0,0,0,0,0
84528,0,0,0,0,0
48407,0,0,0,0,0
13533,0,0,0,0,0
33068,0,0,0,0,0
113555,0,0,0,0,0
27297,0,0,0,0,0
95917,0,0,0,0,0
16568,0,0,0,0,0
52603,0,0,0,0,0
83174,0,0,0,0,0
80100,0,0,0,0,0
90339,0,0,0,0,0
77235,0,0,0,0,0
20429,0,0,0,0,0
31819,0,0,0,0,0
73103,0,0,0,0,0
93278,0,0,0,0,0
89200,0,0,0,0,0
67499,0,0,0,0,0
79612,2,2,2,0,0
89106,1,1,1,0,0
45535,0,0,0,0,0
63210,0,0,0,0,0
55517,0,0,0,0,0
39869,0,0,0,0,0
23973,0,0,0,0,0
83900,0,0,0,0,0
21869,0,0,0,0,0
15482,0,0,0,0,0
898,0,0,0,0,0
28486,0,0,0,0,0
165,0,0,0,0,0
17001,0,0,0,0,0
24917,0,0,0,0,0
118173,0,0,0,0,0
27077,0,0,0,0,0
25870,0,0,0,0,0
55398,0,0,0,0,0
110596,0,0,0,0,0
100415,0,0,0,0,0
89979,0,0,0,0,0
98542,0,0,0,0,0
48358,0,0,0,0,0
34312,0,0,0,0,0
55010,0,0,0,0,0
43212,0,0,0,0,0
45844,0,0,0,0,0
5838,0,0,0,0,0
33983,0,0,0,0,0
21691,0,0,0,0,0
87183,0,0,0,0,0
5580,0,0,0,0,0
78198,0,0,0,0,0
43695,0,0,0,0,0
102196,0,0,0,0,0
116782,0,0,0,0,0
116277,0,0,0,0,0
81180,0,0,0,0,0
65918,0,0,0,0,0
11583,0,0,0,0,0
5609,0,0,0,0,0
25341,0,0,0,0,0
20997,0,0,0,0,0
65641,0,0,0,0,0
11493,0,0,0,0,0
92458,0,0,0,0,0
33063,0,0,0,0,0
31037,0,0,0,0,0
81145,0,0,0,0,0
58235,0,0,0,0,0
61591,0,0,0,0,0
111618,0,0,0,0,0
119464,0,0,0,0,0
74434,0,0,0,0,0
40204,0,0,0,0,0
116466,0,0,0,0,0
1958,0,0,0,0,0
15761,0,0,0,0,0
7390,0,0,0,0,0
107599,0,0,0,0,0
118690,0,0,0,0,0
39065,0,0,0,0,0
13703,0,0,0,0,0
61161,0,0,0,0,0
48679,0,0,0,0,0
12967,0,0,0,0,0
15677,0,0,0,0,0
60642,0,0,0,0,0
59854,0,0,0,0,0
4137,0,0,0,0,0
92137,0,0,0,0,0
3946,0,0,0,0,0
64666,0,0,0,0,0
26815,0,0,0,0,0
28661,0,0,0,0,0
11569,0,0,0,0,0
49832,0,0,0,0,0
19532,0,0,0,0,0
95276,0,0,0,0,0
24809,0,0,0,0,0
26365,0,0,0,0,0
26971,0,0,0,0,0
5820,0,0,0,0,0
51328,0,0,0,0,0
6133,0,0,0,0,0
70477,0,0,0,0,0
82424,0,0,0,0,0
64657,0,0,0,0,0
62215,0,0,0,0,0
74712,0,0,0,0,0
59553,0,0,0,0,0
76616,0,0,0,0,0
13523,0,0,0,0,0
87285,0,0,0,0,0
64502,0,0,0,0,0
2603,0,0,0,0,0
100121,0,0,0,0,0
83748,0,0,0,0,0
33955,0,0,0,0,0
95576,0,0,0,0,0
21347,0,0,0,0,0
7647,0,0,0,0,0
35218,0,0,0,0,0
79216,0,0,0,0,0
104255,0,0,0,0,0
64466,0,0,0,0,0
72705,0,0,0,0,0
83324,0,0,0,0,0
89962,0,0,0,0,0
4922,0,0,0,0,0
30097,0,0,0,0,0
73398,0,0,0,0,0
118378,0,0,0,0,0
33756,0,0,0,0,0
45996,0,0,0,0,0
110118,0,0,0,0,0
38116,0,0,0,0,0
6903,0,0,0,0,0
27056,0,0,0,0,0
69973,0,0,0,0,0
105416,0,0,0,0,0
93113,0,0,0,0,0
56201,0,0,0,0,0
78759,0,0,0,0,0
85668,0,0,0,0,0
21580,0,0,0,0,0
11092,0,0,0,0,0
73336,0,0,0,0,0
9399,0,0,0,0,0
72405,3,3,3,0,0
39849,0,0,0,0,0
8649,0,0,0,0,0
77535,0,0,0,0,0
8920,0,0,0,0,0
10852,0,0,0,0,0
74812,0,0,0,0,0
55501,0,0,0,0,0
105011,0,0,0,0,0
77106,0,0,0,0,0
23789,0,0,0,0,0
57091,0,0,0,0,0
45022,0,0,0,0,0
7306,0,0,0,0,0
48731,0,0,0,0,0
15726,0,0,0,0,0
75540,0,0,0,0,0
40725,0,0,0,0,0
367,0,0,0,0,0
12755,0,0,0,0,0
6697,0,0,0,0,0
73271,0,0,0,0,0
59692,0,0,0,0,0
1991,0,0,0,0,0
110829,0,0,0,0,0
100745,0,0,0,0,0
113050,0,0,0,0,0
7292,0,0,0,0,0
57057,0,0,0,0,0
89455,0,0,0,0,0
110164,0,0,0,0,0
60700,0,0,0,0,0
10154,0,0,0,0,0
72633,0,0,0,0,0
90188,0,0,0,0,0
38618,0,0,0,0,0
94103,0,0,0,0,0
92393,0,0,0,0,0
70762,0,0,0,0,0
90816,0,0,0,0,0
17628,0,0,0,0,0
76748,0,0,0,0,0
111978,0,0,0,0,0
104443,0,0,0,0,0
111054,0,0,0,0,0
50472,0,0,0,0,0
67263,0,0,0,0,0
13604,0,0,0,0,0
49618,1,1,1,0,0
118419,0,0,0,0,0
55901,0,0,0,0,0
6484,0,0,0,0,0
61853,0,0,0,0,0
86017,0,0,0,0,0
75684,0,0,0,0,0
27412,0,0,0,0,0
18754,0,0,0,0,0
87602,0,0,0,0,0
20654,0,0,0,0,0
5062,0,0,0,0,0
106271,0,0,0,0,0
3718,0,0,0,0,0
65491,0,0,0,0,0
17828,0,0,0,0,0
113485,0,0,0,0,0
97269,0,0,0,0,0
91166,0,0,0,0,0
103596,0,0,0,0,0
33816,0,0,0,0,0
32380,0,0,0,0,0
70312,0,0,0,0,0
29745,0,0,0,0,0
94885,0,0,0,0,0
61387,0,0,0,0,0
41328,0,0,0,0,0
45331,0,0,0,0,0
32512,0,0,0,0,0
8994,0,0,0,0,0
84467,0,0,0,0,0
78270,0,0,0,0,0
18973,0,0,0,0,0
52020,0,0,0,0,0
35840,0,0,0,0,0
46447,0,0,0,0,0
78552,0,0,0,0,0
36970,0,0,0,0,0
7341,0,0,0,0,0
13812,0,0,0,0,0
56415,0,0,0,0,0
75398,0,0,0,0,0
64051,0,0,0,0,0
93830,0,0,0,0,0
97960,0,0,0,0,0
44622,0,0,0,0,0
101613,0,0,0,0,0
93886,0,0,0,0,0
31538,0,0,0,0,0
120299,0,0,0,0,0
49911,0,0,0,0,0
107969,0,0,0,0,0
10739,0,0,0,0,0
80513,0,0,0,0,0
91116,0,0,0,0,0
67569,0,0,0,0,0
114130,0,0,0,0,0
2008,0,0,0,0,0
33938,0,0,0,0,0
64369,0,0,0,0,0
79629,0,0,0,0,0
34388,0,0,0,0,0
6482,0,0,0,0,0
50780,0,0,0,0,0
59018,0,0,0,0,0
25272,0,0,0,0,0
1927,0,0,0,0,0
32396,0,0,0,0,0
52751,0,0,0,0,0
57080,0,0,0,0,0
21588,0,0,0,0,0
108467,0,0,0,0,0
25087,0,0,0,0,0
86326,0,0,0,0,0
45211,0,0,0,0,0
50609,0,0,0,0,0
10236,0,0,0,0,0
39376,0,0,0,0,0
102091,0,0,0,0,0
12465,0,0,0,0,0
61176,0,0,0,0,0
49630,0,0,0,0,0
50702,0,0,0,0,0
35657,0,0,0,0,0
96064,0,0,0,0,0
31809,0,0,0,0,0
86918,0,0,0,0,0
25822,0,0,0,0,0
76022,0,0,0,0,0
93209,0,0,0,0,0
97519,0,0,0,0,0
47757,0,0,0,0,0
64522,0,0,0,0,0
2083,0,0,0,0,0
43554,0,0,0,0,0
106817,0,0,0,0,0
43744,0,0,0,0,0
53457,0,0,0,0,0
105952,0,0,0,0,0
117611,0,0,0,0,0
112182,0,0,0,0,0
59940,0,0,0,0,0
64357,0,0,0,0,0
84544,0,0,0,0,0
29391,0,0,0,0,0
42605,0,0,0,0,0
79116,0,0,0,0,0
107634,0,0,0,0,0
23832,0,0,0,0,0
102763,0,0,0,0,0
1149,0,0,0,0,0
91917,0,0,0,0,0
13764,0,0,0,0,0
26495,0,0,0,0,0
8267,0,0,0,0,0
116507,0,0,0,0,0
17970,0,0,0,0,0
74794,0,0,0,0,0
34149,0,0,0,0,0
102278,0,0,0,0,0
19821,0,0,0,0,0
67739,0,0,0,0,0
21220,0,0,0,0,0
78430,0,0,0,0,0
56942,0,0,0,0,0
93852,0,0,0,0,0
11744,0,0,0,0,0
34354,0,0,0,0,0
102189,0,0,0,0,0
75395,0,0,0,0,0
115854,0,0,0,0,0
73380,0,0,0,0,0
31946,0,0,0,0,0
78422,0,0,0,0,0
112293,0,0,0,0,0
53007,0,0,0,0,0
44544,0,0,0,0,0
7040,0,0,0,0,0
60718,0,0,0,0,0
86609,0,0,0,0,0
63816,0,0,0,0,0
76756,0,0,0,0,0
106883,0,0,0,0,0
87129,0,0,0,0,0
6952,0,0,0,0,0
12009,0,0,0,0,0
110911,0,0,0,0,0
47089,0,0,0,0,0
105307,0,0,0,0,0
116561,0,0,0,0,0
26753,0,0,0,0,0
100682,0,0,0,0,0
5892,0,0,0,0,0
5419,0,0,0,0,0
53644,0,0,0,0,0
93392,2,2,2,0,0
90168,0,0,0,0,0
26766,0,0,0,0,0
94406,0,0,0,0,0
72727,0,0,0,0,0
44330,0,0,0,0,0
109050,0,0,0,0,0
30400,0,0,0,0,0
102453,0,0,0,0,0
103306,0,0,0,0,0
77982,0,0,0,0,0
100642,0,0,0,0,0
83437,0,0,0,0,0
21940,0,0,0,0,0
103220,0,0,0,0,0
65785,0,0,0,0,0
80728,0,0,0,0,0
56178,0,0,0,0,0
24653,0,0,0,0,0
11774,0,0,0,0,0
93891,0,0,0,0,0
98946,0,0,0,0,0
76949,0,0,0,0,0
94031,0,0,0,0,0
10093,0,0,0,0,0
70532,0,0,0,0,0
119157,0,0,0,0,0
118114,0,0,0,0,0
80623,0,0,0,0,0
111800,0,0,0,0,0
24374,0,0,0,0,0
110960,0,0,0,0,0
11410,0,0,0,0,0
112674,0,0,0,0,0
95202,0,0,0,0,0
113562,0,0,0,0,0
14669,0,0,0,0,0
67487,0,0,0,0,0
30816,0,0,0,0,0
25833,0,0,0,0,0
54706,0,0,0,0,0
11124,0,0,0,0,0
39854,0,0,0,0,0
13125,0,0,0,0,0
62376,0,0,0,0,0
7093,0,0,0,0,0
98088,0,0,0,0,0
81221,0,0,0,0,0
51368,0,0,0,0,0
19538,0,0,0,0,0
43219,0,0,0,0,0
89388,0,0,0,0,0
39407,0,0,0,0,0
54450,0,0,0,0,0
71907,0,0,0,0,0
49275,0,0,0,0,0
59890,0,0,0,0,0
104533,0,0,0,0,0
5723,0,0,0,0,0
47139,0,0,0,0,0
56231,0,0,0,0,0
39215,0,0,0,0,0
54639,0,0,0,0,0
60561,0,0,0,0,0
88404,0,0,0,0,0
31508,0,0,0,0,0
64493,0,0,0,0,0
116938,0,0,0,0,0
11340,0,0,0,0,0
88416,0,0,0,0,0
34670,0,0,0,0,0
111089,0,0,0,0,0
88535,0,0,0,0,0
68951,0,0,0,0,0
109174,0,0,0,0,0
7769,0,0,0,0,0
39363,0,0,0,0,0
51722,0,0,0,0,0
71688,0,0,0,0,0
31180,0,0,0,0,0
30485,0,0,0,0,0
98807,0,0,0,0,0
115700,0,0,0,0,0
37864,0,0,0,0,0
97919,0,0,0,0,0
10325,0,0,0,0,0
34861,0,0,0,0,0
24520,0,0,0,0,0
13659,0,0,0,0,0
79390,0,0,0,0,0
47554,0,0,0,0,0
34649,0,0,0,0,0
51590,0,0,0,0,0
40896,2,2,2,0,0
20334,0,0,0,0,0
23503,0,0,0,0,0
17858,0,0,0,0,0
91637,0,0,0,0,0
17857,0,0,0,0,0
34206,0,0,0,0,0
105932,0,0,0,0,0
31757,0,0,0,0,0
20035,0,0,0,0,0
98883,0,0,0,0,0
43334,0,0,0,0,0
60882,0,0,0,0,0
82446,0,0,0,0,0
107553,0,0,0,0,0
11683,0,0,0,0,0
12545,0,0,0,0,0
35344,0,0,0,0,0
113286,0,0,0,0,0
2065,0,0,0,0,0
90037,0,0,0,0,0
43858,0,0,0,0,0
108652,0,0,0,0,0
100468,0,0,0,0,0
42043,0,0,0,0,0
19015,0,0,0,0,0
114473,0,0,0,0,0
73376,0,0,0,0,0
77783,0,0,0,0,0
48765,0,0,0,0,0
80878,0,0,0,0,0
72508,0,0,0,0,0
11544,0,0,0,0,0
1001,0,0,0,0,0
46335,0,0,0,0,0
4551,0,0,0,0,0
31516,0,0,0,0,0
22127,0,0,0,0,0
8857,0,0,0,0,0
76285,0,0,0,0,0
88292,0,0,0,0,0
33498,0,0,0,0,0
62436,0,0,0,0,0
34883,0,0,0,0,0
9695,0,0,0,0,0
106256,0,0,0,0,0
23399,0,0,0,0,0
22002,0,0,0,0,0
90290,0,0,0,0,0
82500,0,0,0,0,0
76648,0,0,0,0,0
74924,0,0,0,0,0
61128,0,0,0,0,0
15491,0,0,0,0,0
19852,0,0,0,0,0
112723,1,1,1,0,0
33349,0,0,0,0,0
99850,0,0,0,0,0
105940,0,0,0,0,0
43309,0,0,0,0,0
33956,0,0,0,0,0
113452,0,0,0,0,0
111735,0,0,0,0,0
113476,0,0,0,0,0
113719,0,0,0,0,0
50062,0,0,0,0,0
18953,0,0,0,0,0
96159,0,0,0,0,0
89037,0,0,0,0,0
108351,0,0,0,0,0
59409,0,0,0,0,0
56737,0,0,0,0,0
116532,0,0,0,0,0
54281,0,0,0,0,0
31656,0,0,0,0,0
110241,0,0,0,0,0
32211,0,0,0,0,0
47252,0,0,0,0,0
70220,0,0,0,0,0
13839,0,0,0,0,0
52962,0,0,0,0,0
37585,0,0,0,0,0
91105,0,0,0,0,0
81021,0,0,0,0,0
82362,0,0,0,0,0
116630,0,0,0,0,0
32614,0,0,0,0,0
36616,0,0,0,0,0
35271,0,0,0,0,0
56821,0,0,0,0,0
73845,0,0,0,0,0
58771,0,0,0,0,0
9054,0,0,0,0,0
79905,0,0,0,0,0
49729,0,0,0,0,0
106202,0,0,0,0,0
91643,0,0,0,0,0
65148,0,0,0,0,0
22265,0,0,0,0,0
52791,0,0,0,0,0
86722,0,0,0,0,0
371,0,0,0,0,0
118223,0,0,0,0,0
35593,0,0,0,0,0
79268,0,0,0,0,0
101042,0,0,0,0,0
69885,0,0,0,0,0
12403,0,0,0,0,0
82932,0,0,0,0,0
7748,0,0,0,0,0
57464,0,0,0,0,0
54375,0,0,0,0,0
15006,0,0,0,0,0
16469,0,0,0,0,0
104825,0,0,0,0,0
4131,0,0,0,0,0
50567,0,0,0,0,0
81446,0,0,0,0,0
65876,3,3,3,0,0
66604,0,0,0,0,0
81093,0,0,0,0,0
77010,0,0,0,0,0
92215,0,0,0,0,0
102689,0,0,0,0,0
10651,0,0,0,0,0
37360,0,0,0,0,0
114631,0,0,0,0,0
29444,0,0,0,0,0
39472,0,0,0,0,0
82493,0,0,0,0,0
40581,0,0,0,0,0
82597,0,0,0,0,0
90430,0,0,0,0,0
90217,0,0,0,0,0
112910,0,0,0,0,0
88044,0,0,0,0,0
47102,0,0,0,0,0
86964,0,0,0,0,0
65105,0,0,0,0,0
108337,0,0,0,0,0
76454,0,0,0,0,0
120563,0,0,0,0,0
12333,0,0,0,0,0
87836,0,0,0,0,0
82544,0,0,0,0,0
53436,0,0,0,0,0
76172,0,0,0,0,0
26302,0,0,0,0,0
74031,0,0,0,0,0
35909,0,0,0,0,0
62282,0,0,0,0,0
17939,0,0,0,0,0
3854,0,0,0,0,0
54171,0,0,0,0,0
85778,0,0,0,0,0
96525,0,0,0,0,0
56432,0,0,0,0,0
74594,0,0,0,0,0
37235,0,0,0,0,0
58000,0,0,0,0,0
86049,0,0,0,0,0
3909,0,0,0,0,0
21679,0,0,0,0,0
102703,0,0,0,0,0
11163,0,0,0,0,0
4446,0,0,0,0,0
30338,0,0,0,0,0
42828,0,0,0,0,0
48572,0,0,0,0,0
63634,0,0,0,0,0
87361,0,0,0,0,0
47277,0,0,0,0,0
32379,0,0,0,0,0
8638,0,0,0,0,0
660,0,0,0,0,0
86928,0,0,0,0,0
11159,0,0,0,0,0
31520,0,0,0,0,0
30098,4,4,4,0,0
78592,0,0,0,0,0
102490,0,0,0,0,0
119761,0,0,0,0,0
102927,0,0,0,0,0
118769,0,0,0,0,0
1364,0,0,0,0,0
107327,0,0,0,0,0
98629,0,0,0,0,0
71092,0,0,0,0,0
115050,0,0,0,0,0
97035,0,0,0,0,0
68145,0,0,0,0,0
119599,0,0,0,0,0
73866,0,0,0,0,0
38682,0,0,0,0,0
22966,0,0,0,0,0
4095,0,0,0,0,0
59964,0,0,0,0,0
46685,0,0,0,0,0
55896,0,0,0,0,0
49574,0,0,0,0,0
57974,0,0,0,0,0
97930,0,0,0,0,0
90109,0,0,0,0,0
78263,0,0,0,0,0
16065,0,0,0,0,0
17387,0,0,0,0,0
115924,0,0,0,0,0
71199,0,0,0,0,0
74577,0,0,0,0,0
43503,0,0,0,0,0
53262,0,0,0,0,0
32194,0,0,0,0,0
69740,0,0,0,0,0
10225,0,0,0,0,0
100885,0,0,0,0,0
74724,0,0,0,0,0
69738,0,0,0,0,0
90600,0,0,0,0,0
8273,0,0,0,0,0
14158,0,0,0,0,0
65201,0,0,0,0,0
48901,0,0,0,0,0
74020,0,0,0,0,0
77824,1,1,1,0,0
5212,0,0,0,0,0
99770,0,0,0,0,0
66456,0,0,0,0,0
76460,0,0,0,0,0
91313,0,0,0,0,0
96196,0,0,0,0,0
11284,0,0,0,0,0
81768,0,0,0,0,0
88199,0,0,0,0,0
94977,0,0,0,0,0
93770,0,0,0,0,0
86271,0,0,0,0,0
26889,0,0,0,0,0
17247,0,0,0,0,0
13949,0,0,0,0,0
33183,0,0,0,0,0
10288,0,0,0,0,0
48802,0,0,0,0,0
86083,0,0,0,0,0
106689,0,0,0,0,0
67772,1,1,1,0,0
86522,0,0,0,0,0
77507,0,0,0,0,0
76250,0,0,0,0,0
42001,0,0,0,0,0
102643,0,0,0,0,0
7526,0,0,0,0,0
35417,0,0,0,0,0
116779,0,0,0,0,0
3076,0,0,0,0,0
112008,1,1,1,0,0
108570,0,0,0,0,0
37324,0,0,0,0,0
9768,0,0,0,0,0
118598,0,0,0,0,0
40018,0,0,0,0,0
92163,0,0,0,0,0
76613,0,0,0,0,0
64499,0,0,0,0,0
84557,0,0,0,0,0
29326,0,0,0,0,0
69006,0,0,0,0,0
16791,0,0,0,0,0
89727,2,2,2,0,0
2249,0,0,0,0,0
95059,0,0,0,0,0
52990,0,0,0,0,0
58841,0,0,0,0,0
15704,0,0,0,0,0
24303,0,0,0,0,0
89877,0,0,0,0,0
96154,0,0,0,0,0
97528,0,0,0,0,0
16041,0,0,0,0,0
31770,0,0,0,0,0
36,0,0,0,0,0
118002,0,0,0,0,0
23507,0,0,0,0,0
51276,0,0,0,0,0
80914,0,0,0,0,0
119724,0,0,0,0,0
55449,0,0,0,0,0
92184,0,0,0,0,0
20672,0,0,0,0,0
69757,0,0,0,0,0
7340,0,0,0,0,0
49454,0,0,0,0,0
69661,0,0,0,0,0
118438,0,0,0,0,0
32575,0,0,0,0,0
5553,0,0,0,0,0
44997,0,0,0,0,0
74851,0,0,0,0,0
42406,0,0,0,0,0
95694,0,0,0,0,0
66776,0,0,0,0,0
81161,0,0,0,0,0
23687,0,0,0,0,0
60845,0,0,0,0,0
87315,0,0,0,0,0
65476,0,0,0,0,0
23144,0,0,0,0,0
80148,0,0,0,0,0
9645,0,0,0,0,0
41085,0,0,0,0,0
106016,0,0,0,0,0
33295,3,3,3,0,0
38613,0,0,0,0,0
74486,0,0,0,0,0
92945,0,0,0,0,0
119195,0,0,0,0,0
31875,0,0,0,0,0
62873,0,0,0,0,0
85684,0,0,0,0,0
28036,0,0,0,0,0
62056,6,6,6,0,0
62935,0,0,0,0,0
25538,0,0,0,0,0
4284,0,0,0,0,0
69270,0,0,0,0,0
49370,0,0,0,0,0
97393,0,0,0,0,0
49129,0,0,0,0,0
10932,0,0,0,0,0
109927,0,0,0,0,0
6,0,0,0,0,0
69482,0,0,0,0,0
45949,0,0,0,0,0
83269,0,0,0,0,0
65602,0,0,0,0,0
32798,0,0,0,0,0
97237,0,0,0,0,0
65337,0,0,0,0,0
48694,0,0,0,0,0
5302,0,0,0,0,0
5844,0,0,0,0,0
105585,0,0,0,0,0
47754,0,0,0,0,0
59175,0,0,0,0,0
27891,0,0,0,0,0
52474,0,0,0,0,0
26446,0,0,0,0,0
77991,0,0,0,0,0
23112,0,0,0,0,0
76708,0,0,0,0,0
70058,0,0,0,0,0
116569,0,0,0,0,0
66944,0,0,0,0,0
70772,0,0,0,0,0
64458,0,0,0,0,0
107752,0,0,0,0,0
29009,0,0,0,0,0
105221,0,0,0,0,0
101654,0,0,0,0,0
111770,0,0,0,0,0
1613,0,0,0,0,0
103981,0,0,0,0,0
92658,0,0,0,0,0
60305,0,0,0,0,0
31189,0,0,0,0,0
41761,0,0,0,0,0
60471,0,0,0,0,0
95141,0,0,0,0,0
105857,0,0,0,0,0
25491,0,0,0,0,0
55123,0,0,0,0,0
93957,0,0,0,0,0
8243,0,0,0,0,0
42782,0,0,0,0,0
38825,0,0,0,0,0
99019,0,0,0,0,0
5710,0,0,0,0,0
66440,0,0,0,0,0
99638,0,0,0,0,0
41801,0,0,0,0,0
14539,0,0,0,0,0
76306,0,0,0,0,0
31263,0,0,0,0,0
35202,0,0,0,0,0
72665,0,0,0,0,0
91223,0,0,0,0,0
34873,0,0,0,0,0
37801,0,0,0,0,0
46021,0,0,0,0,0
61622,0,0,0,0,0
103098,1,1,1,0,0
63987,0,0,0,0,0
21577,0,0,0,0,0
53318,0,0,0,0,0
18223,0,0,0,0,0
1910,0,0,0,0,0
95525,0,0,0,0,0
110494,0,0,0,0,0
43381,0,0,0,0,0
73961,0,0,0,0,0
109257,0,0,0,0,0
120063,0,0,0,0,0
67229,0,0,0,0,0
54636,0,0,0,0,0
112698,0,0,0,0,0
76064,0,0,0,0,0
91596,5,5,5,0,0
96820,0,0,0,0,0
20712,0,0,0,0,0
7643,0,0,0,0,0
115601,0,0,0,0,0
55484,0,0,0,0,0
53838,0,0,0,0,0
7641,0,0,0,0,0
80690,0,0,0,0,0
56500,0,0,0,0,0
48474,0,0,0,0,0
63885,0,0,0,0,0
6082,4,4,4,0,0
37352,0,0,0,0,0
118537,0,0,0,0,0
99034,0,0,0,0,0
18302,0,0,0,0,0
80834,0,0,0,0,0
18431,0,0,0,0,0
75056,0,0,0,0,0
18676,0,0,0,0,0
115793,0,0,0,0,0
93445,0,0,0,0,0
61937,0,0,0,0,0
104535,0,0,0,0,0
113399,1,1,1,0,0
69143,0,0,0,0,0
115807,0,0,0,0,0
30060,0,0,0,0,0
61139,0,0,0,0,0
73965,0,0,0,0,0
115753,0,0,0,0,0
42288,4,4,4,0,0
86042,0,0,0,0,0
5909,0,0,0,0,0
16923,0,0,0,0,0
57208,0,0,0,0,0
58423,0,0,0,0,0
48504,0,0,0,0,0
2175,0,0,0,0,0
33390,0,0,0,0,0
81519,0,0,0,0,0
103177,0,0,0,0,0
64624,0,0,0,0,0
28555,0,0,0,0,0
26967,0,0,0,0,0
108361,0,0,0,0,0
85353,0,0,0,0,0
58861,0,0,0,0,0
8328,0,0,0,0,0
33959,0,0,0,0,0
65033,0,0,0,0,0
107102,0,0,0,0,0
78614,0,0,0,0,0
46707,0,0,0,0,0
118205,0,0,0,0,0
50378,0,0,0,0,0
10509,0,0,0,0,0
114489,3,3,3,0,0
76798,0,0,0,0,0
52584,0,0,0,0,0
87028,0,0,0,0,0
46210,0,0,0,0,0
118078,0,0,0,0,0
112628,0,0,0,0,0
17701,0,0,0,0,0
31323,0,0,0,0,0
97028,0,0,0,0,0
35196,0,0,0,0,0
54633,0,0,0,0,0
95329,0,0,0,0,0
45735,0,0,0,0,0
100612,0,0,0,0,0
39071,0,0,0,0,0
31242,0,0,0,0,0
76612,0,0,0,0,0
7699,0,0,0,0,0
76651,0,0,0,0,0
30456,0,0,0,0,0
115215,0,0,0,0,0
65045,0,0,0,0,0
115517,0,0,0,0,0
27847,0,0,0,0,0
83890,0,0,0,0,0
91365,0,0,0,0,0
110204,0,0,0,0,0
105928,0,0,0,0,0
64480,0,0,0,0,0
61920,0,0,0,0,0
50572,0,0,0,0,0
36354,0,0,0,0,0
53464,0,0,0,0,0
14524,0,0,0,0,0
62491,0,0,0,0,0
65375,0,0,0,0,0
16683,0,0,0,0,0
66848,0,0,0,0,0
52228,1,1,1,0,0
73960,0,0,0,0,0
108093,0,0,0,0,0
55610,0,0,0,0,0
49915,0,0,0,0,0
97409,0,0,0,0,0
91270,0,0,0,0,0
32130,0,0,0,0,0
20597,0,0,0,0,0
111549,0,0,0,0,0
107876,1,1,1,0,0
4861,0,0,0,0,0
16658,0,0,0,0,0
33035,0,0,0,0,0
51178,0,0,0,0,0
7586,0,0,0,0,0
95446,0,0,0,0,0
49620,0,0,0,0,0
56745,0,0,0,0,0
79999,0,0,0,0,0
26543,0,0,0,0,0
38322,0,0,0,0,0
120351,0,0,0,0,0
52886,0,0,0,0,0
13558,0,0,0,0,0
119354,0,0,0,0,0
117613,0,0,0,0,0
60401,0,0,0,0,0
117562,0,0,0,0,0
117736,0,0,0,0,0
17913,2,2,2,0,0
41448,0,0,0,0,0
96650,0,0,0,0,0
48790,0,0,0,0,0
11025,0,0,0,0,0
47564,0,0,0,0,0
57156,0,0,0,0,0
85239,0,0,0,0,0
65275,0,0,0,0,0
1218,0,0,0,0,0
90001,0,0,0,0,0
119940,0,0,0,0,0
64649,0,0,0,0,0
12190,0,0,0,0,0
91720,2,2,2,0,0
71998,0,0,0,0,0
41373,0,0,0,0,0
9326,0,0,0,0,0
99033,0,0,0,0,0
15629,0,0,0,0,0
7471,0,0,0,0,0
56372,0,0,0,0,0
35711,0,0,0,0,0
94531,0,0,0,0,0
72890,0,0,0,0,0
85497,0,0,0,0,0
3066,0,0,0,0,0
86972,0,0,0,0,0
68925,0,0,0,0,0
55015,0,0,0,0,0
26358,0,0,0,0,0
56113,0,0,0,0,0
83195,0,0,0,0,0
90795,0,0,0,0,0
31065,0,0,0,0,0
102907,0,0,0,0,0
60158,0,0,0,0,0
31024,0,0,0,0,0
31246,0,0,0,0,0
7363,0,0,0,0,0
28881,0,0,0,0,0
98411,0,0,0,0,0
12646,0,0,0,0,0
77018,0,0,0,0,0
4229,0,0,0,0,0
4097,0,0,0,0,0
53823,0,0,0,0,0
40317,0,0,0,0,0
117737,0,0,0,0,0
4714,0,0,0,0,0
75924,0,0,0,0,0
85468,0,0,0,0,0
120568,0,0,0,0,0
104921,0,0,0,0,0
73264,0,0,0,0,0
85772,0,0,0,0,0
52654,0,0,0,0,0
44053,0,0,0,0,0
112251,0,0,0,0,0
17469,0,0,0,0,0
95706,0,0,0,0,0
55665,0,0,0,0,0
94534,0,0,0,0,0
70834,0,0,0,0,0
81804,0,0,0,0,0
74368,0,0,0,0,0
81143,0,0,0,0,0
42145,0,0,0,0,0
101441,0,0,0,0,0
111352,0,0,0,0,0
8122,0,0,0,0,0
40002,0,0,0,0,0
64465,0,0,0,0,0
50728,0,0,0,0,0
29551,0,0,0,0,0
56854,0,0,0,0,0
61188,0,0,0,0,0
40119,0,0,0,0,0
66572,0,0,0,0,0
32441,0,0,0,0,0
45512,0,0,0,0,0
23643,0,0,0,0,0
27104,0,0,0,0,0
39352,0,0,0,0,0
57882,0,0,0,0,0
62333,0,0,0,0,0
15557,0,0,0,0,0
67643,0,0,0,0,0
8249,0,0,0,0,0
95023,0,0,0,0,0
106654,0,0,0,0,0
94005,0,0,0,0,0
20297,0,0,0,0,0
92961,0,0,0,0,0
97407,0,0,0,0,0
7477,0,0,0,0,0
24259,0,0,0,0,0
822,0,0,0,0,0
14501,0,0,0,0,0
18009,0,0,0,0,0
99418,1,1,1,0,0
60209,0,0,0,0,0
120101,0,0,0,0,0
2725,0,0,0,0,0
100311,0,0,0,0,0
45599,0,0,0,0,0
34707,0,0,0,0,0
87077,0,0,0,0,0
24398,0,0,0,0,0
31762,1,1,1,0,0
96835,0,0,0,0,0
1917,0,0,0,0,0
78383,1,1,1,0,0
105659,0,0,0,0,0
59302,0,0,0,0,0
56025,0,0,0,0,0
74359,0,0,0,0,0
107526,0,0,0,0,0
69297,0,0,0,0,0
74803,0,0,0,0,0
116097,0,0,0,0,0
61103,0,0,0,0,0
101193,0,0,0,0,0
80516,0,0,0,0,0
113420,0,0,0,0,0
50642,0,0,0,0,0
55288,0,0,0,0,0
88498,0,0,0,0,0
4702,0,0,0,0,0
80590,0,0,0,0,0
60110,0,0,0,0,0
86677,0,0,0,0,0
26811,0,0,0,0,0
106103,0,0,0,0,0
116213,0,0,0,0,0
10266,0,0,0,0,0
77551,0,0,0,0,0
46062,0,0,0,0,0
85968,0,0,0,0,0
101352,0,0,0,0,0
91913,0,0,0,0,0
5044,0,0,0,0,0
118084,0,0,0,0,0
63447,0,0,0,0,0
72723,0,0,0,0,0
78037,0,0,0,0,0
113125,0,0,0,0,0
88331,0,0,0,0,0
16375,0,0,0,0,0
43079,0,0,0,0,0
106632,0,0,0,0,0
39025,0,0,0,0,0
116510,0,0,0,0,0
91544,0,0,0,0,0
60727,0,0,0,0,0
118724,0,0,0,0,0
9894,0,0,0,0,0
33610,0,0,0,0,0
40928,3,3,3,0,0
34008,0,0,0,0,0
78678,0,0,0,0,0
117251,0,0,0,0,0
29766,0,0,0,0,0
15072,0,0,0,0,0
98790,0,0,0,0,0
73173,0,0,0,0,0
11504,0,0,0,0,0
3573,0,0,0,0,0
116980,0,0,0,0,0
108616,0,0,0,0,0
40828,0,0,0,0,0
118980,0,0,0,0,0
56810,0,0,0,0,0
18797,0,0,0,0,0
54494,0,0,0,0,0
105651,0,0,0,0,0
35827,0,0,0,0,0
16783,0,0,0,0,0
110522,0,0,0,0,0
12767,0,0,0,0,0
21876,0,0,0,0,0
103523,5,5,5,0,0
35275,1,1,1,0,0
44204,0,0,0,0,0
81498,0,0,0,0,0
51971,0,0,0,0,0
55353,0,0,0,0,0
65696,0,0,0,0,0
105356,0,0,0,0,0
28911,0,0,0,0,0
10462,0,0,0,0,0
24664,0,0,0,0,0
49636,0,0,0,0,0
109972,0,0,0,0,0
97642,0,0,0,0,0
12869,0,0,0,0,0
117509,0,0,0,0,0
91754,0,0,0,0,0
36119,0,0,0,0,0
107982,0,0,0,0,0
51177,0,0,0,0,0
27570,0,0,0,0,0
4017,0,0,0,0,0
38408,0,0,0,0,0
43273,0,0,0,0,0
2194,0,0,0,0,0
2750,0,0,0,0,0
90970,0,0,0,0,0
52835,0,0,0,0,0
79416,0,0,0,0,0
30751,0,0,0,0,0
84725,0,0,0,0,0
32224,0,0,0,0,0
5632,0,0,0,0,0
96643,0,0,0,0,0
4084,0,0,0,0,0
39782,4,4,4,0,0
72993,0,0,0,0,0
79553,0,0,0,0,0
106858,0,0,0,0,0
65024,0,0,0,0,0
11742,0,0,0,0,0
58412,2,2,2,0,0
116863,0,0,0,0,0
15284,0,0,0,0,0
84492,0,0,0,0,0
46569,0,0,0,0,0
25532,0,0,0,0,0
34716,0,0,0,0,0
78095,0,0,0,0,0
30964,0,0,0,0,0
72091,0,0,0,0,0
89366,0,0,0,0,0
29505,0,0,0,0,0
105427,0,0,0,0,0
114820,0,0,0,0,0
2575,0,0,0,0,0
93913,0,0,0,0,0
24977,0,0,0,0,0
102649,0,0,0,0,0
95941,0,0,0,0,0
21156,0,0,0,0,0
87284,0,0,0,0,0
69010,0,0,0,0,0
78973,0,0,0,0,0
4231,0,0,0,0,0
94869,0,0,0,0,0
104899,0,0,0,0,0
95829,0,0,0,0,0
65027,0,0,0,0,0
93352,0,0,0,0,0
51818,0,0,0,0,0
58318,0,0,0,0,0
23833,0,0,0,0,0
77581,0,0,0,0,0
58957,0,0,0,0,0
22790,1,1,1,0,0
70972,0,0,0,0,0
103161,0,0,0,0,0
43557,0,0,0,0,0
88220,0,0,0,0,0
98321,0,0,0,0,0
88161,0,0,0,0,0
119856,0,0,0,0,0
53504,0,0,0,0,0
74397,0,0,0,0,0
18818,0,0,0,0,0
77974,0,0,0,0,0
24648,0,0,0,0,0
2730,0,0,0,0,0
87227,0,0,0,0,0
43887,0,0,0,0,0
49305,0,0,0,0,0
3295,0,0,0,0,0
9760,0,0,0,0,0
38421,0,0,0,0,0
8047,0,0,0,0,0
10940,0,0,0,0,0
41039,0,0,0,0,0
46849,0,0,0,0,0
51288,0,0,0,0,0
14961,0,0,0,0,0
36204,0,0,0,0,0
28289,0,0,0,0,0
51280,0,0,0,0,0
78218,0,0,0,0,0
72289,0,0,0,0,0
76914,0,0,0,0,0
100455,0,0,0,0,0
10601,0,0,0,0,0
87217,0,0,0,0,0
57256,0,0,0,0,0
91799,0,0,0,0,0
40940,0,0,0,0,0
75116,0,0,0,0,0
98097,0,0,0,0,0
4844,0,0,0,0,0
82787,0,0,0,0,0
5805,0,0,0,0,0
51739,0,0,0,0,0
43891,0,0,0,0,0
35392,0,0,0,0,0
99936,0,0,0,0,0
112054,0,0,0,0,0
99897,0,0,0,0,0
75505,0,0,0,0,0
48231,0,0,0,0,0
69549,2,2,2,0,0
17811,0,0,0,0,0
98904,0,0,0,0,0
24088,0,0,0,0,0
33118,0,0,0,0,0
72314,0,0,0,0,0
85402,0,0,0,0,0
105253,0,0,0,0,0
45258,0,0,0,0,0
70796,0,0,0,0,0
27696,0,0,0,0,0
36248,0,0,0,0,0
12360,0,0,0,0,0
30337,0,0,0,0,0
36465,0,0,0,0,0
33526,0,0,0,0,0
87719,4,4,4,0,0
18390,0,0,0,0,0
93773,0,0,0,0,0
15987,0,0,0,0,0
44878,0,0,0,0,0
120210,0,0,0,0,0
52825,0,0,0,0,0
48306,0,0,0,0,0
37537,0,0,0,0,0
82828,0,0,0,0,0
114117,0,0,0,0,0
87252,0,0,0,0,0
5898,0,0,0,0,0
17737,0,0,0,0,0
34321,0,0,0,0,0
15305,0,0,0,0,0
27630,0,0,0,0,0
41920,0,0,0,0,0
22321,0,0,0,0,0
111435,0,0,0,0,0
79571,0,0,0,0,0
90044,0,0,0,0,0
81368,0,0,0,0,0
87021,0,0,0,0,0
90547,0,0,0,0,0
50302,0,0,0,0,0
1105,0,0,0,0,0
68830,0,0,0,0,0
43861,0,0,0,0,0
44280,0,0,0,0,0
61533,0,0,0,0,0
62812,0,0,0,0,0
118729,2,2,2,0,0
94744,0,0,0,0,0
54957,0,0,0,0,0
23703,0,0,0,0,0
110678,0,0,0,0,0
15027,0,0,0,0,0
98029,0,0,0,0,0
26279,0,0,0,0,0
71213,0,0,0,0,0
10530,0,0,0,0,0
78599,0,0,0,0,0
41736,0,0,0,0,0
88489,0,0,0,0,0
112790,0,0,0,0,0
23393,0,0,0,0,0
77453,0,0,0,0,0
52318,0,0,0,0,0
115739,0,0,0,0,0
34358,0,0,0,0,0
28889,0,0,0,0,0
19872,0,0,0,0,0
110028,0,0,0,0,0
68792,0,0,0,0,0
119563,0,0,0,0,0
40408,0,0,0,0,0
30351,0,0,0,0,0
29113,0,0,0,0,0
76163,0,0,0,0,0
117067,0,0,0,0,0
10809,0,0,0,0,0
87980,0,0,0,0,0
105045,0,0,0,0,0
33159,0,0,0,0,0
89172,0,0,0,0,0
87031,0,0,0,0,0
85081,0,0,0,0,0
38020,0,0,0,0,0
105000,0,0,0,0,0
87153,0,0,0,0,0
33344,0,0,0,0,0
106043,0,0,0,0,0
95097,0,0,0,0,0
90341,0,0,0,0,0
22247,0,0,0,0,0
76119,0,0,0,0,0
53093,0,0,0,0,0
33535,1,1,1,0,0
88998,0,0,0,0,0
33355,0,0,0,0,0
92433,0,0,0,0,0
78773,0,0,0,0,0
19124,0,0,0,0,0
84510,0,0,0,0,0
2601,0,0,0,0,0
63506,0,0,0,0,0
3504,0,0,0,0,0
17336,0,0,0,0,0
7457,0,0,0,0,0
59720,0,0,0,0,0
40989,0,0,0,0,0
36948,0,0,0,0,0
110653,0,0,0,0,0
26114,0,0,0,0,0
33150,0,0,0,0,0
83603,0,0,0,0,0
113062,0,0,0,0,0
18863,0,0,0,0,0
13422,0,0,0,0,0
1332,0,0,0,0,0
117950,0,0,0,0,0
37629,0,0,0,0,0
98496,0,0,0,0,0
70560,0,0,0,0,0
53945,0,0,0,0,0
110760,0,0,0,0,0
18421,0,0,0,0,0
112115,0,0,0,0,0
3549,0,0,0,0,0
71073,0,0,0,0,0
64723,0,0,0,0,0
119171,0,0,0,0,0
102647,0,0,0,0,0
118523,0,0,0,0,0
59288,0,0,0,0,0
43710,0,0,0,0,0
87927,0,0,0,0,0
108839,0,0,0,0,0
8535,0,0,0,0,0
103987,0,0,0,0,0
25996,0,0,0,0,0
108521,0,0,0,0,0
42610,0,0,0,0,0
106655,0,0,0,0,0
2706,0,0,0,0,0
98997,0,0,0,0,0
69829,0,0,0,0,0
16350,0,0,0,0,0
39136,2,2,2,0,0
32910,0,0,0,0,0
57263,0,0,0,0,0
89641,0,0,0,0,0
30277,0,0,0,0,0
20575,0,0,0,0,0
105844,0,0,0,0,0
41072,0,0,0,0,0
25138,0,0,0,0,0
83301,0,0,0,0,0
65798,0,0,0,0,0
85555,0,0,0,0,0
108848,0,0,0,0,0
95989,0,0,0,0,0
55744,0,0,0,0,0
26718,0,0,0,0,0
30653,0,0,0,0,0
2124,0,0,0,0,0
96265,0,0,0,0,0
76389,0,0,0,0,0
66382,0,0,0,0,0
101640,0,0,0,0,0
96267,0,0,0,0,0
110887,0,0,0,0,0
72805,0,0,0,0,0
46379,0,0,0,0,0
113800,1,1,1,0,0
113368,0,0,0,0,0
3951,0,0,0,0,0
76131,0,0,0,0,0
19512,0,0,0,0,0
11888,0,0,0,0,0
23780,0,0,0,0,0
119208,0,0,0,0,0
82428,0,0,0,0,0
14563,0,0,0,0,0
108417,0,0,0,0,0
108440,0,0,0,0,0
105518,0,0,0,0,0
100616,0,0,0,0,0
5902,0,0,0,0,0
2595,0,0,0,0,0
33507,0,0,0,0,0
116169,0,0,0,0,0
120577,0,0,0,0,0
66622,0,0,0,0,0
19510,0,0,0,0,0
34351,0,0,0,0,0
71519,0,0,0,0,0
60697,0,0,0,0,0
120522,0,0,0,0,0
56381,0,0,0,0,0
62291,0,0,0,0,0
27184,0,0,0,0,0
94917,0,0,0,0,0
14782,0,0,0,0,0
9100,0,0,0,0,0
98842,0,0,0,0,0
97240,0,0,0,0,0
93470,0,0,0,0,0
58294,0,0,0,0,0
49491,0,0,0,0,0
1624,0,0,0,0,0
39569,0,0,0,0,0
46268,0,0,0,0,0
38706,0,0,0,0,0
85045,2,2,2,0,0
49859,0,0,0,0,0
89666,0,0,0,0,0
106059,0,0,0,0,0
106936,0,0,0,0,0
99610,0,0,0,0,0
89177,0,0,0,0,0
54463,0,0,0,0,0
107919,0,0,0,0,0
61589,0,0,0,0,0
9698,0,0,0,0,0
107364,0,0,0,0,0
42257,0,0,0,0,0
83976,0,0,0,0,0
58026,0,0,0,0,0
3008,0,0,0,0,0
3005,0,0,0,0,0
19095,0,0,0,0,0
74888,0,0,0,0,0
82907,0,0,0,0,0
57307,0,0,0,0,0
23492,0,0,0,0,0
22096,0,0,0,0,0
19495,0,0,0,0,0
35152,0,0,0,0,0
85573,0,0,0,0,0
53205,0,0,0,0,0
775,0,0,0,0,0
23569,0,0,0,0,0
80071,0,0,0,0,0
21853,0,0,0,0,0
17928,0,0,0,0,0
112001,0,0,0,0,0
58684,0,0,0,0,0
21858,1,1,1,0,0
100309,0,0,0,0,0
87148,0,0,0,0,0
75377,0,0,0,0,0
37686,0,0,0,0,0
89829,0,0,0,0,0
37750,0,0,0,0,0
68131,0,0,0,0,0
54480,0,0,0,0,0
63490,0,0,0,0,0
82209,0,0,0,0,0
20580,0,0,0,0,0
64546,0,0,0,0,0
77696,0,0,0,0,0
21939,0,0,0,0,0
119079,0,0,0,0,0
79384,0,0,0,0,0
106189,0,0,0,0,0
55061,0,0,0,0,0
68650,0,0,0,0,0
62101,0,0,0,0,0
88809,0,0,0,0,0
9551,0,0,0,0,0
59055,0,0,0,0,0
3156,0,0,0,0,0
43904,0,0,0,0,0
34635,0,0,0,0,0
59823,4,4,4,0,0
44714,0,0,0,0,0
107608,0,0,0,0,0
89317,0,0,0,0,0
93781,0,0,0,0,0
3734,0,0,0,0,0
87434,0,0,0,0,0
105304,0,0,0,0,0
83278,0,0,0,0,0
25098,0,0,0,0,0
22080,0,0,0,0,0
11216,0,0,0,0,0
47568,0,0,0,0,0
114992,0,0,0,0,0
6318,0,0,0,0,0
33383,0,0,0,0,0
37620,0,0,0,0,0
91158,0,0,0,0,0
23964,0,0,0,0,0
8287,0,0,0,0,0
37356,0,0,0,0,0
69411,0,0,0,0,0
90249,0,0,0,0,0
15712,2,2,2,0,0
109756,0,0,0,0,0
82621,0,0,0,0,0
35245,0,0,0,0,0
92412,0,0,0,0,0
38778,0,0,0,0,0
94050,0,0,0,0,0
107380,0,0,0,0,0
51858,0,0,0,0,0
106351,0,0,0,0,0
55628,0,0,0,0,0
4273,0,0,0,0,0
13424,0,0,0,0,0
80481,0,0,0,0,0
35703,0,0,0,0,0
90930,0,0,0,0,0
54217,0,0,0,0,0
23597,0,0,0,0,0
7813,0,0,0,0,0
101248,0,0,0,0,0
117035,0,0,0,0,0
112740,0,0,0,0,0
36994,0,0,0,0,0
86921,0,0,0,0,0
87502,0,0,0,0,0
36188,0,0,0,0,0
85254,0,0,0,0,0
109322,0,0,0,0,0
14320,1,1,1,0,0
10392,0,0,0,0,0
10575,0,0,0,0,0
70444,0,0,0,0,0
35566,0,0,0,0,0
113892,0,0,0,0,0
3,0,0,0,0,0
73833,0,0,0,0,0
68720,0,0,0,0,0
105206,0,0,0,0,0
84204,0,0,0,0,0
59878,0,0,0,0,0
103931,0,0,0,0,0
18462,0,0,0,0,0
116153,0,0,0,0,0
98692,0,0,0,0,0
28655,0,0,0,0,0
15422,0,0,0,0,0
7694,0,0,0,0,0
101719,2,2,2,0,0
6946,0,0,0,0,0
51607,0,0,0,0,0
40222,0,0,0,0,0
59469,0,0,0,0,0
71069,0,0,0,0,0
109246,2,2,2,0,0
102900,0,0,0,0,0
61857,0,0,0,0,0
9176,0,0,0,0,0
115667,4,4,4,0,0
12781,0,0,0,0,0
101809,0,0,0,0,0
36867,0,0,0,0,0
10744,0,0,0,0,0
7407,0,0,0,0,0
4320,0,0,0,0,0
50480,0,0,0,0,0
75414,0,0,0,0,0
120295,0,0,0,0,0
60233,0,0,0,0,0
111641,0,0,0,0,0
107963,0,0,0,0,0
22580,0,0,0,0,0
42809,0,0,0,0,0
16819,0,0,0,0,0
66085,0,0,0,0,0
96747,0,0,0,0,0
59582,0,0,0,0,0
78539,0,0,0,0,0
69422,0,0,0,0,0
39399,0,0,0,0,0
68405,0,0,0,0,0
62507,0,0,0,0,0
81594,0,0,0,0,0
12784,0,0,0,0,0
97368,0,0,0,0,0
37357,0,0,0,0,0
17145,0,0,0,0,0
16422,0,0,0,0,0
79545,0,0,0,0,0
37335,0,0,0,0,0
85606,0,0,0,0,0
119898,0,0,0,0,0
3062,0,0,0,0,0
25115,0,0,0,0,0
47951,0,0,0,0,0
32623,0,0,0,0,0
18488,0,0,0,0,0
56208,0,0,0,0,0
44085,0,0,0,0,0
94764,0,0,0,0,0
87249,1,1,1,0,0
87641,0,0,0,0,0
34937,0,0,0,0,0
21297,0,0,0,0,0
35843,1,1,1,0,0
31759,0,0,0,0,0
67630,0,0,0,0,0
42936,0,0,0,0,0
78159,0,0,0,0,0
93366,0,0,0,0,0
41065,0,0,0,0,0
77677,0,0,0,0,0
22213,0,0,0,0,0
9928,0,0,0,0,0
54618,0,0,0,0,0
11291,0,0,0,0,0
26231,0,0,0,0,0
69449,0,0,0,0,0
88047,0,0,0,0,0
116281,0,0,0,0,0
71318,0,0,0,0,0
2778,4,4,4,0,0
109058,0,0,0,0,0
63823,0,0,0,0,0
109398,0,0,0,0,0
73448,0,0,0,0,0
2051,0,0,0,0,0
95345,0,0,0,0,0
60893,0,0,0,0,0
105510,0,0,0,0,0
46983,0,0,0,0,0
104190,0,0,0,0,0
100138,0,0,0,0,0
17167,0,0,0,0,0
77022,0,0,0,0,0
118362,0,0,0,0,0
24447,0,0,0,0,0
4678,0,0,0,0,0
41717,0,0,0,0,0
95502,0,0,0,0,0
107278,0,0,0,0,0
41106,0,0,0,0,0
93686,0,0,0,0,0
66596,0,0,0,0,0
66641,0,0,0,0,0
75295,0,0,0,0,0
65579,0,0,0,0,0
110349,0,0,0,0,0
26800,0,0,0,0,0
56848,0,0,0,0,0
29710,0,0,0,0,0
44957,0,0,0,0,0
62827,0,0,0,0,0
110330,0,0,0,0,0
61162,0,0,0,0,0
1652,0,0,0,0,0
75379,0,0,0,0,0
52022,0,0,0,0,0
50514,0,0,0,0,0
118949,0,0,0,0,0
116124,0,0,0,0,0
104231,0,0,0,0,0
42119,0,0,0,0,0
33108,0,0,0,0,0
71455,0,0,0,0,0
60269,0,0,0,0,0
47679,0,0,0,0,0
54953,1,1,1,0,0
17864,0,0,0,0,0
43416,0,0,0,0,0
65469,0,0,0,0,0
65643,0,0,0,0,0
82030,0,0,0,0,0
34848,0,0,0,0,0
119706,0,0,0,0,0
92307,0,0,0,0,0
2463,0,0,0,0,0
31408,0,0,0,0,0
26850,0,0,0,0,0
13009,0,0,0,0,0
105005,0,0,0,0,0
50278,0,0,0,0,0
34511,0,0,0,0,0
19751,0,0,0,0,0
16358,0,0,0,0,0
44643,0,0,0,0,0
23897,0,0,0,0,0
33961,0,0,0,0,0
2695,0,0,0,0,0
25392,0,0,0,0,0
32302,0,0,0,0,0
100517,0,0,0,0,0
44704,0,0,0,0,0
108820,0,0,0,0,0
101597,0,0,0,0,0
13247,0,0,0,0,0
11053,0,0,0,0,0
120569,0,0,0,0,0
60779,0,0,0,0,0
54823,0,0,0,0,0
62953,0,0,0,0,0
25339,0,0,0,0,0
73811,0,0,0,0,0
76694,0,0,0,0,0
107916,0,0,0,0,0
88008,0,0,0,0,0
73537,0,0,0,0,0
55248,0,0,0,0,0
89349,0,0,0,0,0
87877,0,0,0,0,0
95616,0,0,0,0,0
96757,0,0,0,0,0
29561,0,0,0,0,0
81088,0,0,0,0,0
114671,0,0,0,0,0
94698,0,0,0,0,0
89827,0,0,0,0,0
43712,0,0,0,0,0
42409,0,0,0,0,0
99939,0,0,0,0,0
73003,0,0,0,0,0
44410,0,0,0,0,0
3473,0,0,0,0,0
87436,0,0,0,0,0
11579,0,0,0,0,0
58982,0,0,0,0,0
51211,0,0,0,0,0
100122,0,0,0,0,0
120344,0,0,0,0,0
104145,0,0,0,0,0
84513,0,0,0,0,0
30347,0,0,0,0,0
93491,0,0,0,0,0
98176,0,0,0,0,0
34821,0,0,0,0,0
52919,0,0,0,0,0
103241,1,1,1,0,0
74967,0,0,0,0,0
10577,0,0,0,0,0
18907,0,0,0,0,0
36851,0,0,0,0,0
9810,0,0,0,0,0
73196,0,0,0,0,0
36047,0,0,0,0,0
60924,0,0,0,0,0
111323,0,0,0,0,0
92643,0,0,0,0,0
16728,0,0,0,0,0
60932,0,0,0,0,0
19940,0,0,0,0,0
116834,0,0,0,0,0
39361,0,0,0,0,0
97573,0,0,0,0,0
96812,0,0,0,0,0
6651,0,0,0,0,0
76098,0,0,0,0,0
26617,0,0,0,0,0
26146,0,0,0,0,0
41519,0,0,0,0,0
104846,0,0,0,0,0
101707,0,0,0,0,0
112453,0,0,0,0,0
91493,0,0,0,0,0
118460,0,0,0,0,0
28448,0,0,0,0,0
82936,0,0,0,0,0
20380,0,0,0,0,0
26364,0,0,0,0,0
39006,0,0,0,0,0
95270,0,0,0,0,0
22917,0,0,0,0,0
49677,0,0,0,0,0
45877,0,0,0,0,0
41331,0,0,0,0,0
7896,0,0,0,0,0
23154,0,0,0,0,0
111927,0,0,0,0,0
50761,0,0,0,0,0
30549,0,0,0,0,0
6559,0,0,0,0,0
60015,0,0,0,0,0
69620,0,0,0,0,0
48845,0,0,0,0,0
40073,0,0,0,0,0
64730,0,0,0,0,0
12159,0,0,0,0,0
55692,0,0,0,0,0
21370,0,0,0,0,0
27499,0,0,0,0,0
86162,0,0,0,0,0
28398,0,0,0,0,0
38545,0,0,0,0,0
34248,0,0,0,0,0
18970,0,0,0,0,0
97045,0,0,0,0,0
104588,2,2,2,0,0
89667,0,0,0,0,0
15544,0,0,0,0,0
66659,0,0,0,0,0
83319,0,0,0,0,0
15050,0,0,0,0,0
82760,0,0,0,0,0
29211,0,0,0,0,0
29852,0,0,0,0,0
48424,0,0,0,0,0
98287,0,0,0,0,0
63452,0,0,0,0,0
60048,0,0,0,0,0
100014,0,0,0,0,0
52127,0,0,0,0,0
84868,0,0,0,0,0
41429,0,0,0,0,0
104076,0,0,0,0,0
101316,0,0,0,0,0
16867,0,0,0,0,0
118036,0,0,0,0,0
72941,0,0,0,0,0
24702,0,0,0,0,0
62875,0,0,0,0,0
64356,0,0,0,0,0
20873,0,0,0,0,0
70448,0,0,0,0,0
113367,0,0,0,0,0
10130,0,0,0,0,0
23721,0,0,0,0,0
37264,0,0,0,0,0
10887,0,0,0,0,0
19734,0,0,0,0,0
90324,0,0,0,0,0
77498,0,0,0,0,0
83528,0,0,0,0,0
64562,0,0,0,0,0
83368,0,0,0,0,0
60951,0,0,0,0,0
80487,0,0,0,0,0
60803,0,0,0,0,0
92531,0,0,0,0,0
98534,0,0,0,0,0
59290,0,0,0,0,0
13667,0,0,0,0,0
91529,0,0,0,0,0
32169,0,0,0,0,0
1353,0,0,0,0,0
116218,0,0,0,0,0
75300,0,0,0,0,0
3371,0,0,0,0,0
81899,0,0,0,0,0
71405,0,0,0,0,0
76659,0,0,0,0,0
57029,0,0,0,0,0
55884,0,0,0,0,0
38042,1,1,1,0,0
110341,0,0,0,0,0
51426,0,0,0,0,0
112239,0,0,0,0,0
114440,0,0,0,0,0
110346,0,0,0,0,0
96509,0,0,0,0,0
57691,0,0,0,0,0
91486,0,0,0,0,0
108323,0,0,0,0,0
98430,0,0,0,0,0
53367,0,0,0,0,0
62616,0,0,0,0,0
115684,0,0,0,0,0
8602,0,0,0,0,0
96959,0,0,0,0,0
86315,1,1,1,0,0
99230,0,0,0,0,0
113229,0,0,0,0,0
42132,0,0,0,0,0
76145,0,0,0,0,0
73098,3,3,3,0,0
116225,0,0,0,0,0
84207,0,0,0,0,0
117994,0,0,0,0,0
26010,0,0,0,0,0
120135,0,0,0,0,0
117300,0,0,0,0,0
40903,0,0,0,0,0
115002,0,0,0,0,0
14628,0,0,0,0,0
105311,0,0,0,0,0
94505,0,0,0,0,0
53286,0,0,0,0,0
28734,0,0,0,0,0
59388,0,0,0,0,0
16811,0,0,0,0,0
104499,0,0,0,0,0
77657,0,0,0,0,0
49375,0,0,0,0,0
55351,0,0,0,0,0
104348,0,0,0,0,0
106613,0,0,0,0,0
1422,0,0,0,0,0
68535,0,0,0,0,0
31711,0,0,0,0,0
94451,0,0,0,0,0
12935,0,0,0,0,0
80434,0,0,0,0,0
51268,0,0,0,0,0
37892,0,0,0,0,0
59779,0,0,0,0,0
37912,0,0,0,0,0
34971,0,0,0,0,0
79949,0,0,0,0,0
17875,0,0,0,0,0
10757,0,0,0,0,0
54969,0,0,0,0,0
96338,0,0,0,0,0
11931,0,0,0,0,0
44089,0,0,0,0,0
53635,0,0,0,0,0
51024,0,0,0,0,0
13204,0,0,0,0,0
95766,0,0,0,0,0
7352,0,0,0,0,0
36007,0,0,0,0,0
95337,0,0,0,0,0
49860,0,0,0,0,0
92241,0,0,0,0,0
26354,0,0,0,0,0
39528,0,0,0,0,0
43866,0,0,0,0,0
18461,0,0,0,0,0
45359,0,0,0,0,0
7279,0,0,0,0,0
63511,0,0,0,0,0
41083,0,0,0,0,0
58984,0,0,0,0,0
29403,0,0,0,0,0
83425,0,0,0,0,0
106521,0,0,0,0,0
84627,0,0,0,0,0
13754,0,0,0,0,0
105418,0,0,0,0,0
110336,0,0,0,0,0
116826,0,0,0,0,0
61876,0,0,0,0,0
14699,0,0,0,0,0
25896,0,0,0,0,0
48756,0,0,0,0,0
40760,0,0,0,0,0
20660,0,0,0,0,0
25406,0,0,0,0,0
19593,0,0,0,0,0
23387,0,0,0,0,0
119820,0,0,0,0,0
100764,0,0,0,0,0
108095,0,0,0,0,0
7829,0,0,0,0,0
98521,0,0,0,0,0
42750,0,0,0,0,0
113287,0,0,0,0,0
5423,0,0,0,0,0
95991,0,0,0,0,0
79909,0,0,0,0,0
111608,0,0,0,0,0
24773,0,0,0,0,0
89195,0,0,0,0,0
51220,0,0,0,0,0
91408,0,0,0,0,0
74478,0,0,0,0,0
54818,0,0,0,0,0
95653,0,0,0,0,0
114210,0,0,0,0,0
74352,0,0,0,0,0
43380,0,0,0,0,0
99645,0,0,0,0,0
113936,0,0,0,0,0
6470,0,0,0,0,0
62638,0,0,0,0,0
73930,0,0,0,0,0
13948,0,0,0,0,0
117477,0,0,0,0,0
107461,0,0,0,0,0
11827,0,0,0,0,0
120414,0,0,0,0,0
66220,0,0,0,0,0
64055,0,0,0,0,0
100389,0,0,0,0,0
92233,0,0,0,0,0
26058,0,0,0,0,0
103488,0,0,0,0,0
62499,0,0,0,0,0
41520,0,0,0,0,0
59150,0,0,0,0,0
55179,0,0,0,0,0
6078,0,0,0,0,0
17993,0,0,0,0,0
29029,0,0,0,0,0
114028,0,0,0,0,0
74738,0,0,0,0,0
12263,0,0,0,0,0
71956,0,0,0,0,0
21559,0,0,0,0,0
96621,0,0,0,0,0
89916,0,0,0,0,0
84014,0,0,0,0,0
7677,0,0,0,0,0
23639,0,0,0,0,0
118353,0,0,0,0,0
63359,0,0,0,0,0
34271,0,0,0,0,0
89101,0,0,0,0,0
74670,0,0,0,0,0
74142,0,0,0,0,0
52759,0,0,0,0,0
68105,0,0,0,0,0
103247,0,0,0,0,0
27845,0,0,0,0,0
7934,0,0,0,0,0
5404,0,0,0,0,0
106886,0,0,0,0,0
25787,0,0,0,0,0
114847,0,0,0,0,0
104627,0,0,0,0,0
2919,0,0,0,0,0
110206,0,0,0,0,0
7328,0,0,0,0,0
103859,0,0,0,0,0
11930,0,0,0,0,0
95295,0,0,0,0,0
53811,0,0,0,0,0
11785,0,0,0,0,0
96123,0,0,0,0,0
90974,0,0,0,0,0
48199,0,0,0,0,0
22197,0,0,0,0,0
24314,0,0,0,0,0
35508,0,0,0,0,0
110948,0,0,0,0,0
3228,0,0,0,0,0
34119,0,0,0,0,0
58385,0,0,0,0,0
47640,0,0,0,0,0
118718,1,1,1,0,0
56706,0,0,0,0,0
61091,0,0,0,0,0
26022,0,0,0,0,0
95405,0,0,0,0,0
112271,0,0,0,0,0
114822,0,0,0,0,0
85718,0,0,0,0,0
89053,0,0,0,0,0
69205,0,0,0,0,0
108774,0,0,0,0,0
49671,0,0,0,0,0
66478,0,0,0,0,0
18626,0,0,0,0,0
35958,0,0,0,0,0
33518,0,0,0,0,0
82464,0,0,0,0,0
111460,0,0,0,0,0
95294,0,0,0,0,0
74198,0,0,0,0,0
101043,0,0,0,0,0
116594,0,0,0,0,0
58338,0,0,0,0,0
90175,0,0,0,0,0
88027,0,0,0,0,0
47872,0,0,0,0,0
40809,0,0,0,0,0
38863,0,0,0,0,0
85525,0,0,0,0,0
25473,0,0,0,0,0
54797,0,0,0,0,0
117973,0,0,0,0,0
45509,0,0,0,0,0
45284,0,0,0,0,0
42747,0,0,0,0,0
38707,0,0,0,0,0
51650,0,0,0,0,0
110553,0,0,0,0,0
51159,0,0,0,0,0
102311,0,0,0,0,0
80794,0,0,0,0,0
92448,0,0,0,0,0
11814,0,0,0,0,0
88949,0,0,0,0,0
3273,0,0,0,0,0
52991,0,0,0,0,0
59161,0,0,0,0,0
72960,0,0,0,0,0
18135,0,0,0,0,0
44107,0,0,0,0,0
33010,0,0,0,0,0
94394,0,0,0,0,0
10126,0,0,0,0,0
90534,0,0,0,0,0
45865,0,0,0,0,0
98223,0,0,0,0,0
61072,0,0,0,0,0
46238,0,0,0,0,0
22577,0,0,0,0,0
86857,0,0,0,0,0
19711,0,0,0,0,0
108473,0,0,0,0,0
68279,0,0,0,0,0
25712,0,0,0,0,0
3311,0,0,0,0,0
105419,0,0,0,0,0
35544,2,2,2,0,0
6551,0,0,0,0,0
61587,0,0,0,0,0
10286,0,0,0,0,0
51157,0,0,0,0,0
58255,0,0,0,0,0
112244,0,0,0,0,0
32147,0,0,0,0,0
46767,0,0,0,0,0
65490,0,0,0,0,0
7721,7,7,7,0,0
71901,0,0,0,0,0
90606,0,0,0,0,0
69656,0,0,0,0,0
8722,0,0,0,0,0
69622,0,0,0,0,0
30788,0,0,0,0,0
101937,0,0,0,0,0
107033,0,0,0,0,0
58995,0,0,0,0,0
55788,0,0,0,0,0
105920,0,0,0,0,0
114119,0,0,0,0,0
60671,0,0,0,0,0
75338,0,0,0,0,0
37555,0,0,0,0,0
112884,0,0,0,0,0
108040,0,0,0,0,0
50102,0,0,0,0,0
3539,0,0,0,0,0
69743,0,0,0,0,0
86531,0,0,0,0,0
61345,0,0,0,0,0
87849,0,0,0,0,0
39357,0,0,0,0,0
36391,0,0,0,0,0
44134,0,0,0,0,0
77286,0,0,0,0,0
33563,0,0,0,0,0
94402,0,0,0,0,0
75878,0,0,0,0,0
64845,0,0,0,0,0
79082,0,0,0,0,0
90985,0,0,0,0,0
52229,0,0,0,0,0
51539,0,0,0,0,0
83610,0,0,0,0,0
29181,0,0,0,0,0
69337,0,0,0,0,0
41144,0,0,0,0,0
99265,0,0,0,0,0
88183,0,0,0,0,0
106035,0,0,0,0,0
84717,0,0,0,0,0
120234,0,0,0,0,0
103592,0,0,0,0,0
45643,0,0,0,0,0
67544,0,0,0,0,0
72044,0,0,0,0,0
45216,0,0,0,0,0
22476,0,0,0,0,0
79376,4,4,4,0,0
3510,0,0,0,0,0
82344,0,0,0,0,0
110473,0,0,0,0,0
2836,0,0,0,0,0
97205,0,0,0,0,0
56045,0,0,0,0,0
46965,0,0,0,0,0
87911,0,0,0,0,0
8561,0,0,0,0,0
106841,0,0,0,0,0
67494,0,0,0,0,0
24761,0,0,0,0,0
59128,0,0,0,0,0
112753,0,0,0,0,0
97146,0,0,0,0,0
58762,0,0,0,0,0
10113,0,0,0,0,0
100362,0,0,0,0,0
96270,0,0,0,0,0
64013,0,0,0,0,0
67148,0,0,0,0,0
87964,0,0,0,0,0
98747,0,0,0,0,0
59156,0,0,0,0,0
59093,0,0,0,0,0
27736,0,0,0,0,0
89849,0,0,0,0,0
18469,0,0,0,0,0
38760,0,0,0,0,0
40758,0,0,0,0,0
117784,0,0,0,0,0
61796,0,0,0,0,0
4582,0,0,0,0,0
28091,0,0,0,0,0
69053,0,0,0,0,0
101645,0,0,0,0,0
69653,0,0,0,0,0
9717,0,0,0,0,0
61233,0,0,0,0,0
54116,0,0,0,0,0
45356,0,0,0,0,0
79853,0,0,0,0,0
44075,0,0,0,0,0
50895,0,0,0,0,0
39791,0,0,0,0,0
82456,0,0,0,0,0
45566,0,0,0,0,0
24053,0,0,0,0,0
11715,0,0,0,0,0
76826,0,0,0,0,0
6656,0,0,0,0,0
69839,0,0,0,0,0
70281,0,0,0,0,0
79022,0,0,0,0,0
43805,0,0,0,0,0
72825,0,0,0,0,0
64398,0,0,0,0,0
80439,0,0,0,0,0
73566,0,0,0,0,0
9160,0,0,0,0,0
114858,0,0,0,0,0
18644,0,0,0,0,0
33820,0,0,0,0,0
26366,0,0,0,0,0
116403,0,0,0,0,0
109213,0,0,0,0,0
114582,0,0,0,0,0
5417,0,0,0,0,0
114362,0,0,0,0,0
431,0,0,0,0,0
50519,0,0,0,0,0
80454,0,0,0,0,0
119223,0,0,0,0,0
74973,0,0,0,0,0
117552,0,0,0,0,0
42792,0,0,0,0,0
72471,0,0,0,0,0
93200,0,0,0,0,0
57880,0,0,0,0,0
93177,0,0,0,0,0
52691,0,0,0,0,0
54890,0,0,0,0,0
18497,0,0,0,0,0
22908,0,0,0,0,0
85721,0,0,0,0,0
43403,0,0,0,0,0
47439,0,0,0,0,0
119709,0,0,0,0,0
68112,0,0,0,0,0
112839,0,0,0,0,0
98638,0,0,0,0,0
28109,0,0,0,0,0
20676,0,0,0,0,0
91358,0,0,0,0,0
111149,0,0,0,0,0
25971,0,0,0,0,0
41303,0,0,0,0,0
47113,0,0,0,0,0
10197,0,0,0,0,0
59627,0,0,0,0,0
104943,0,0,0,0,0
24074,0,0,0,0,0
46391,0,0,0,0,0
88425,0,0,0,0,0
96810,0,0,0,0,0
60726,0,0,0,0,0
46840,0,0,0,0,0
95098,0,0,0,0,0
55512,0,0,0,0,0
75943,0,0,0,0,0
17219,0,0,0,0,0
6268,0,0,0,0,0
24918,0,0,0,0,0
53820,0,0,0,0,0
14554,0,0,0,0,0
7059,0,0,0,0,0
119953,0,0,0,0,0
37380,0,0,0,0,0
88952,0,0,0,0,0
2286,0,0,0,0,0
82582,0,0,0,0,0
69412,0,0,0,0,0
67032,0,0,0,0,0
8600,0,0,0,0,0
74581,0,0,0,0,0
14497,0,0,0,0,0
108894,0,0,0,0,0
57941,0,0,0,0,0
9917,0,0,0,0,0
73736,0,0,0,0,0
75972,0,0,0,0,0
51822,0,0,0,0,0
114006,0,0,0,0,0
114545,0,0,0,0,0
39187,0,0,0,0,0
9925,0,0,0,0,0
75096,0,0,0,0,0
51082,0,0,0,0,0
40887,0,0,0,0,0
81930,0,0,0,0,0
70644,0,0,0,0,0
99004,0,0,0,0,0
112649,0,0,0,0,0
3496,0,0,0,0,0
87109,0,0,0,0,0
88851,0,0,0,0,0
33629,0,0,0,0,0
71236,0,0,0,0,0
79508,0,0,0,0,0
70760,0,0,0,0,0
25052,0,0,0,0,0
41800,0,0,0,0,0
18196,0,0,0,0,0
104762,0,0,0,0,0
58695,0,0,0,0,0
102240,0,0,0,0,0
102297,0,0,0,0,0
82050,0,0,0,0,0
106429,0,0,0,0,0
89115,0,0,0,0,0
102608,0,0,0,0,0
93384,0,0,0,0,0
26154,0,0,0,0,0
111180,0,0,0,0,0
100262,0,0,0,0,0
41784,0,0,0,0,0
34040,1,1,1,0,0
25186,0,0,0,0,0
31437,0,0,0,0,0
71330,0,0,0,0,0
89557,0,0,0,0,0
94231,0,0,0,0,0
31790,0,0,0,0,0
5440,0,0,0,0,0
24469,0,0,0,0,0
56350,0,0,0,0,0
23853,0,0,0,0,0
84876,0,0,0,0,0
20330,0,0,0,0,0
94710,0,0,0,0,0
46324,0,0,0,0,0
43080,0,0,0,0,0
15755,0,0,0,0,0
97732,0,0,0,0,0
40198,0,0,0,0,0
30318,0,0,0,0,0
63975,0,0,0,0,0
77705,0,0,0,0,0
88787,0,0,0,0,0
4577,0,0,0,0,0
23236,0,0,0,0,0
32970,0,0,0,0,0
96731,0,0,0,0,0
46958,0,0,0,0,0
21890,0,0,0,0,0
78346,0,0,0,0,0
49703,0,0,0,0,0
54349,0,0,0,0,0
39653,0,0,0,0,0
5159,0,0,0,0,0
37358,0,0,0,0,0
6052,0,0,0,0,0
369,0,0,0,0,0
80543,0,0,0,0,0
86039,0,0,0,0,0
5014,0,0,0,0,0
50132,0,0,0,0,0
91590,0,0,0,0,0
53836,0,0,0,0,0
119667,0,0,0,0,0
60971,0,0,0,0,0
15554,0,0,0,0,0
80783,0,0,0,0,0
105534,0,0,0,0,0
59730,0,0,0,0,0
35486,0,0,0,0,0
98501,0,0,0,0,0
15861,0,0,0,0,0
22741,0,0,0,0,0
60800,0,0,0,0,0
17468,0,0,0,0,0
81784,0,0,0,0,0
44805,0,0,0,0,0
52887,0,0,0,0,0
12070,0,0,0,0,0
2805,0,0,0,0,0
111703,0,0,0,0,0
25721,0,0,0,0,0
28397,0,0,0,0,0
72453,0,0,0,0,0
91073,0,0,0,0,0
74458,0,0,0,0,0
1908,0,0,0,0,0
72174,0,0,0,0,0
66783,0,0,0,0,0
43156,0,0,0,0,0
71576,0,0,0,0,0
56216,0,0,0,0,0
84721,0,0,0,0,0
63105,0,0,0,0,0
70650,0,0,0,0,0
81545,0,0,0,0,0
111658,0,0,0,0,0
18762,0,0,0,0,0
45101,0,0,0,0,0
57817,0,0,0,0,0
47309,0,0,0,0,0
108654,0,0,0,0,0
77375,2,2,2,0,0
86707,0,0,0,0,0
34485,0,0,0,0,0
68663,0,0,0,0,0
119498,0,0,0,0,0
111919,0,0,0,0,0
96114,0,0,0,0,0
613,0,0,0,0,0
111416,0,0,0,0,0
30180,0,0,0,0,0
60711,0,0,0,0,0
82304,0,0,0,0,0
72647,0,0,0,0,0
35145,0,0,0,0,0
60626,0,0,0,0,0
1292,0,0,0,0,0
67506,0,0,0,0,0
107002,0,0,0,0,0
118506,0,0,0,0,0
88394,0,0,0,0,0
16252,0,0,0,0,0
94049,0,0,0,0,0
16859,0,0,0,0,0
7543,0,0,0,0,0
33529,1,1,1,0,0
36877,0,0,0,0,0
65102,0,0,0,0,0
8954,1,1,1,0,0
119926,0,0,0,0,0
106777,0,0,0,0,0
106244,0,0,0,0,0
10539,0,0,0,0,0
57182,0,0,0,0,0
78627,0,0,0,0,0
105034,0,0,0,0,0
108729,1,1,1,0,0
100147,0,0,0,0,0
118136,0,0,0,0,0
80391,0,0,0,0,0
73257,0,0,0,0,0
20797,0,0,0,0,0
92580,1,1,1,0,0
47068,0,0,0,0,0
22592,0,0,0,0,0
66703,0,0,0,0,0
18913,0,0,0,0,0
5582,0,0,0,0,0
816,0,0,0,0,0
57390,0,0,0,0,0
3094,0,0,0,0,0
58701,0,0,0,0,0
99888,0,0,0,0,0
16265,0,0,0,0,0
24253,0,0,0,0,0
29983,0,0,0,0,0
112803,0,0,0,0,0
120096,0,0,0,0,0
10334,0,0,0,0,0
66542,0,0,0,0,0
44367,0,0,0,0,0
101196,0,0,0,0,0
88868,0,0,0,0,0
36400,0,0,0,0,0
80294,0,0,0,0,0
31665,0,0,0,0,0
24010,0,0,0,0,0
114583,0,0,0,0,0
53996,0,0,0,0,0
110959,0,0,0,0,0
82955,0,0,0,0,0
17370,0,0,0,0,0
4810,0,0,0,0,0
17847,0,0,0,0,0
64452,0,0,0,0,0
81231,0,0,0,0,0
44974,0,0,0,0,0
90059,0,0,0,0,0
51350,0,0,0,0,0
61170,0,0,0,0,0
25810,0,0,0,0,0
112495,0,0,0,0,0
8204,0,0,0,0,0
39518,0,0,0,0,0
54200,0,0,0,0,0
15630,0,0,0,0,0
29869,0,0,0,0,0
20808,0,0,0,0,0
7579,0,0,0,0,0
17548,0,0,0,0,0
116563,0,0,0,0,0
19628,0,0,0,0,0
94246,0,0,0,0,0
106773,0,0,0,0,0
113528,0,0,0,0,0
41192,0,0,0,0,0
80029,0,0,0,0,0
93792,0,0,0,0,0
61005,0,0,0,0,0
87172,0,0,0,0,0
79019,0,0,0,0,0
104777,0,0,0,0,0
38249,0,0,0,0,0
108529,0,0,0,0,0
68287,0,0,0,0,0
8662,0,0,0,0,0
104798,0,0,0,0,0
83518,0,0,0,0,0
113919,0,0,0,0,0
54083,0,0,0,0,0
89482,0,0,0,0,0
39624,0,0,0,0,0
53272,0,0,0,0,0
92213,0,0,0,0,0
45233,0,0,0,0,0
42700,0,0,0,0,0
117127,0,0,0,0,0
37222,0,0,0,0,0
45468,0,0,0,0,0
55612,0,0,0,0,0
4653,0,0,0,0,0
100540,0,0,0,0,0
115271,0,0,0,0,0
93060,0,0,0,0,0
27493,0,0,0,0,0
83647,0,0,0,0,0
118838,0,0,0,0,0
39689,0,0,0,0,0
23970,0,0,0,0,0
2499,0,0,0,0,0
49380,0,0,0,0,0
94230,0,0,0,0,0
58383,0,0,0,0,0
95272,0,0,0,0,0
86021,0,0,0,0,0
88635,0,0,0,0,0
28434,0,0,0,0,0
51489,0,0,0,0,0
84231,0,0,0,0,0
117423,0,0,0,0,0
33805,0,0,0,0,0
87177,0,0,0,0,0
9163,0,0,0,0,0
91751,0,0,0,0,0
13374,0,0,0,0,0
52450,0,0,0,0,0
29189,0,0,0,0,0
113411,0,0,0,0,0
26373,0,0,0,0,0
115299,0,0,0,0,0
74566,0,0,0,0,0
101174,0,0,0,0,0
36802,0,0,0,0,0
95420,0,0,0,0,0
17202,0,0,0,0,0
94707,0,0,0,0,0
86799,0,0,0,0,0
16987,0,0,0,0,0
117694,0,0,0,0,0
104297,0,0,0,0,0
65077,0,0,0,0,0
36462,0,0,0,0,0
74483,0,0,0,0,0
34867,0,0,0,0,0
83733,0,0,0,0,0
56019,0,0,0,0,0
13064,0,0,0,0,0
98392,0,0,0,0,0
109550,0,0,0,0,0
111836,0,0,0,0,0
44258,0,0,0,0,0
46277,0,0,0,0,0
99032,0,0,0,0,0
76142,0,0,0,0,0
105866,0,0,0,0,0
26361,0,0,0,0,0
95156,0,0,0,0,0
49379,0,0,0,0,0
43603,0,0,0,0,0
91915,0,0,0,0,0
44459,0,0,0,0,0
9509,0,0,0,0,0
93737,0,0,0,0,0
25149,0,0,0,0,0
70555,0,0,0,0,0
39795,0,0,0,0,0
97954,0,0,0,0,0
31494,0,0,0,0,0
39711,0,0,0,0,0
82133,0,0,0,0,0
5599,0,0,0,0,0
6864,0,0,0,0,0
74744,0,0,0,0,0
105869,0,0,0,0,0
63204,0,0,0,0,0
72334,0,0,0,0,0
91437,0,0,0,0,0
25997,0,0,0,0,0
25682,0,0,0,0,0
96339,0,0,0,0,0
42067,0,0,0,0,0
63601,0,0,0,0,0
37746,0,0,0,0,0
34689,0,0,0,0,0
59511,0,0,0,0,0
80544,0,0,0,0,0
113053,0,0,0,0,0
49929,0,0,0,0,0
75229,0,0,0,0,0
27629,0,0,0,0,0
102386,0,0,0,0,0
75769,0,0,0,0,0
70942,0,0,0,0,0
12499,0,0,0,0,0
52502,0,0,0,0,0
67851,0,0,0,0,0
64323,0,0,0,0,0
96772,0,0,0,0,0
102137,0,0,0,0,0
90697,0,0,0,0,0
54624,0,0,0,0,0
115504,0,0,0,0,0
85945,0,0,0,0,0
2245,0,0,0,0,0
113164,0,0,0,0,0
106011,0,0,0,0,0
111739,0,0,0,0,0
39431,0,0,0,0,0
116424,0,0,0,0,0
95395,0,0,0,0,0
106602,1,1,1,0,0
8046,0,0,0,0,0
89725,0,0,0,0,0
83978,0,0,0,0,0
9993,0,0,0,0,0
114975,0,0,0,0,0
114243,0,0,0,0,0
89272,0,0,0,0,0
6775,0,0,0,0,0
88644,0,0,0,0,0
110293,1,1,1,0,0
52362,0,0,0,0,0
5551,0,0,0,0,0
35759,0,0,0,0,0
56379,0,0,0,0,0
83864,0,0,0,0,0
24770,0,0,0,0,0
71424,0,0,0,0,0
94506,0,0,0,0,0
74204,0,0,0,0,0
72429,0,0,0,0,0
52485,0,0,0,0,0
19292,0,0,0,0,0
120452,0,0,0,0,0
62785,0,0,0,0,0
2816,0,0,0,0,0
30601,0,0,0,0,0
106031,0,0,0,0,0
67947,0,0,0,0,0
25693,0,0,0,0,0
60986,0,0,0,0,0
54548,0,0,0,0,0
112889,0,0,0,0,0
68393,0,0,0,0,0
99110,0,0,0,0,0
84832,0,0,0,0,0
23464,0,0,0,0,0
77308,0,0,0,0,0
100964,0,0,0,0,0
28559,0,0,0,0,0
75926,0,0,0,0,0
52353,0,0,0,0,0
52179,0,0,0,0,0
109341,0,0,0,0,0
105671,0,0,0,0,0
44468,0,0,0,0,0
118717,0,0,0,0,0
95236,0,0,0,0,0
74944,0,0,0,0,0
7911,0,0,0,0,0
79169,0,0,0,0,0
101928,0,0,0,0,0
99574,0,0,0,0,0
98535,0,0,0,0,0
38695,0,0,0,0,0
5613,0,0,0,0,0
10874,0,0,0,0,0
94866,0,0,0,0,0
19931,0,0,0,0,0
81202,0,0,0,0,0
15852,0,0,0,0,0
3241,0,0,0,0,0
78970,0,0,0,0,0
78477,0,0,0,0,0
20495,0,0,0,0,0
55738,0,0,0,0,0
74290,0,0,0,0,0
37521,0,0,0,0,0
95170,0,0,0,0,0
65113,0,0,0,0,0
18627,0,0,0,0,0
26646,0,0,0,0,0
34005,0,0,0,0,0
56828,0,0,0,0,0
95577,0,0,0,0,0
113180,0,0,0,0,0
2067,0,0,0,0,0
36300,0,0,0,0,0
25043,0,0,0,0,0
24637,0,0,0,0,0
112411,0,0,0,0,0
13866,0,0,0,0,0
28110,0,0,0,0,0
1954,0,0,0,0,0
67503,0,0,0,0,0
45711,0,0,0,0,0
44578,0,0,0,0,0
91989,0,0,0,0,0
12628,0,0,0,0,0
91614,0,0,0,0,0
115116,0,0,0,0,0
57698,0,0,0,0,0
67205,0,0,0,0,0
70503,0,0,0,0,0
11108,0,0,0,0,0
25,0,0,0,0,0
57836,0,0,0,0,0
35736,0,0,0,0,0
57102,0,0,0,0,0
49153,0,0,0,0,0
113568,0,0,0,0,0
29460,0,0,0,0,0
107071,0,0,0,0,0
25851,0,0,0,0,0
24235,0,0,0,0,0
1627,0,0,0,0,0
73976,0,0,0,0,0
94913,0,0,0,0,0
69509,0,0,0,0,0
34136,1,1,1,0,0
87792,0,0,0,0,0
118213,0,0,0,0,0
113577,0,0,0,0,0
2216,0,0,0,0,0
87228,0,0,0,0,0
12652,0,0,0,0,0
61138,0,0,0,0,0
110970,0,0,0,0,0
2815,0,0,0,0,0
48527,0,0,0,0,0
46173,0,0,0,0,0
111822,0,0,0,0,0
7315,0,0,0,0,0
16244,0,0,0,0,0
108022,0,0,0,0,0
56400,0,0,0,0,0
86837,0,0,0,0,0
42746,0,0,0,0,0
2215,0,0,0,0,0
12281,0,0,0,0,0
23284,0,0,0,0,0
65278,0,0,0,0,0
22352,0,0,0,0,0
62242,0,0,0,0,0
99454,0,0,0,0,0
72997,0,0,0,0,0
62645,0,0,0,0,0
15328,0,0,0,0,0
56258,0,0,0,0,0
1350,0,0,0,0,0
74313,0,0,0,0,0
2931,0,0,0,0,0
30770,0,0,0,0,0
23640,0,0,0,0,0
83742,0,0,0,0,0
42254,0,0,0,0,0
111026,0,0,0,0,0
43867,0,0,0,0,0
31856,0,0,0,0,0
35252,0,0,0,0,0
100910,0,0,0,0,0
23234,0,0,0,0,0
108494,0,0,0,0,0
116049,0,0,0,0,0
23855,0,0,0,0,0
99543,0,0,0,0,0
99734,0,0,0,0,0
99039,0,0,0,0,0
3380,0,0,0,0,0
68515,0,0,0,0,0
68960,0,0,0,0,0
91268,0,0,0,0,0
35191,0,0,0,0,0
68188,0,0,0,0,0
45594,0,0,0,0,0
81466,0,0,0,0,0
76893,0,0,0,0,0
100948,0,0,0,0,0
27595,0,0,0,0,0
66599,0,0,0,0,0
116381,0,0,0,0,0
37463,0,0,0,0,0
55221,0,0,0,0,0
69774,0,0,0,0,0
101880,0,0,0,0,0
115994,0,0,0,0,0
8048,0,0,0,0,0
83729,0,0,0,0,0
7587,0,0,0,0,0
58781,0,0,0,0,0
46247,0,0,0,0,0
10669,0,0,0,0,0
58947,0,0,0,0,0
74267,0,0,0,0,0
110766,0,0,0,0,0
46455,0,0,0,0,0
2807,0,0,0,0,0
106224,0,0,0,0,0
71509,0,0,0,0,0
87376,0,0,0,0,0
62341,0,0,0,0,0
5593,0,0,0,0,0
15129,0,0,0,0,0
29329,0,0,0,0,0
104980,0,0,0,0,0
21699,0,0,0,0,0
94740,0,0,0,0,0
62468,0,0,0,0,0
89851,0,0,0,0,0
91843,0,0,0,0,0
94985,0,0,0,0,0
35781,0,0,0,0,0
4463,0,0,0,0,0
67166,0,0,0,0,0
32044,0,0,0,0,0
13339,0,0,0,0,0
49042,0,0,0,0,0
40027,0,0,0,0,0
93938,0,0,0,0,0
82300,0,0,0,0,0
38217,0,0,0,0,0
111786,0,0,0,0,0
114343,0,0,0,0,0
84511,0,0,0,0,0
71480,0,0,0,0,0
99026,0,0,0,0,0
49819,0,0,0,0,0
20730,0,0,0,0,0
72100,0,0,0,0,0
110167,0,0,0,0,0
17922,0,0,0,0,0
31616,0,0,0,0,0
44470,0,0,0,0,0
99752,0,0,0,0,0
46798,0,0,0,0,0
82593,0,0,0,0,0
98532,0,0,0,0,0
99256,0,0,0,0,0
11430,0,0,0,0,0
120387,0,0,0,0,0
46855,0,0,0,0,0
42348,3,3,3,0,0
93827,0,0,0,0,0
71706,0,0,0,0,0
113003,0,0,0,0,0
32522,0,0,0,0,0
47091,0,0,0,0,0
85128,0,0,0,0,0
26780,0,0,0,0,0
67441,0,0,0,0,0
8077,0,0,0,0,0
84524,0,0,0,0,0
100385,0,0,0,0,0
96140,0,0,0,0,0
88888,0,0,0,0,0
770,0,0,0,0,0
32732,0,0,0,0,0
15565,0,0,0,0,0
8528,0,0,0,0,0
102684,0,0,0,0,0
5515,0,0,0,0,0
120541,0,0,0,0,0
107528,0,0,0,0,0
113969,0,0,0,0,0
30830,0,0,0,0,0
77822,0,0,0,0,0
8173,0,0,0,0,0
27274,0,0,0,0,0
30043,0,0,0,0,0
110145,0,0,0,0,0
39337,0,0,0,0,0
69435,0,0,0,0,0
50027,0,0,0,0,0
95793,0,0,0,0,0
77321,0,0,0,0,0
112084,0,0,0,0,0
75798,0,0,0,0,0
46323,4,4,4,0,0
34926,0,0,0,0,0
61299,0,0,0,0,0
81132,0,0,0,0,0
79453,0,0,0,0,0
59750,0,0,0,0,0
119410,0,0,0,0,0
92686,0,0,0,0,0
104673,0,0,0,0,0
38335,0,0,0,0,0
9069,2,2,2,0,0
35557,0,0,0,0,0
36531,0,0,0,0,0
45769,0,0,0,0,0
45167,0,0,0,0,0
86156,0,0,0,0,0
84648,0,0,0,0,0
27030,0,0,0,0,0
92676,0,0,0,0,0
118382,0,0,0,0,0
49891,0,0,0,0,0
84453,0,0,0,0,0
40063,0,0,0,0,0
63931,0,0,0,0,0
1640,0,0,0,0,0
86720,0,0,0,0,0
37031,0,0,0,0,0
111311,0,0,0,0,0
20169,0,0,0,0,0
105343,0,0,0,0,0
100068,4,4,4,0,0
44692,0,0,0,0,0
99127,0,0,0,0,0
112829,0,0,0,0,0
49979,3,3,3,0,0
53191,0,0,0,0,0
36048,0,0,0,0,0
55760,0,0,0,0,0
17429,0,0,0,0,0
46060,0,0,0,0,0
33504,0,0,0,0,0
28974,0,0,0,0,0
74331,0,0,0,0,0
46982,0,0,0,0,0
32184,0,0,0,0,0
16434,0,0,0,0,0
96216,0,0,0,0,0
27737,0,0,0,0,0
2059,0,0,0,0,0
31087,0,0,0,0,0
61923,0,0,0,0,0
114178,0,0,0,0,0
7016,0,0,0,0,0
44595,0,0,0,0,0
27272,0,0,0,0,0
24450,0,0,0,0,0
18352,0,0,0,0,0
39723,2,2,2,0,0
29560,0,0,0,0,0
66074,0,0,0,0,0
103172,0,0,0,0,0
71276,0,0,0,0,0
88019,0,0,0,0,0
90708,0,0,0,0,0
24532,0,0,0,0,0
64729,0,0,0,0,0
38246,0,0,0,0,0
2530,0,0,0,0,0
45260,0,0,0,0,0
44689,0,0,0,0,0
45115,0,0,0,0,0
75986,0,0,0,0,0
107093,0,0,0,0,0
88600,0,0,0,0,0
84406,0,0,0,0,0
92931,0,0,0,0,0
89205,0,0,0,0,0
6577,0,0,0,0,0
79099,0,0,0,0,0
66694,0,0,0,0,0
86534,0,0,0,0,0
38128,4,4,4,0,0
60458,0,0,0,0,0
23551,0,0,0,0,0
17923,0,0,0,0,0
102462,0,0,0,0,0
92603,0,0,0,0,0
32712,0,0,0,0,0
76238,0,0,0,0,0
92834,4,4,4,0,0
392,0,0,0,0,0
81149,0,0,0,0,0
60907,0,0,0,0,0
4801,0,0,0,0,0
34721,0,0,0,0,0
82147,0,0,0,0,0
50407,0,0,0,0,0
76265,0,0,0,0,0
14741,0,0,0,0,0
66385,0,0,0,0,0
70893,0,0,0,0,0
110005,0,0,0,0,0
76259,0,0,0,0,0
801,0,0,0,0,0
46224,0,0,0,0,0
35302,0,0,0,0,0
111411,0,0,0,0,0
63184,0,0,0,0,0
22864,0,0,0,0,0
34555,0,0,0,0,0
44614,0,0,0,0,0
40643,0,0,0,0,0
120188,0,0,0,0,0
40941,0,0,0,0,0
61443,0,0,0,0,0
31871,5,5,5,0,0
3341,5,5,5,0,0
44340,0,0,0,0,0
94168,0,0,0,0,0
1756,0,0,0,0,0
25243,0,0,0,0,0
10409,0,0,0,0,0
78996,0,0,0,0,0
38588,0,0,0,0,0
81853,0,0,0,0,0
104894,0,0,0,0,0
92052,0,0,0,0,0
81347,0,0,0,0,0
82771,0,0,0,0,0
43788,0,0,0,0,0
2006,0,0,0,0,0
92001,0,0,0,0,0
95225,0,0,0,0,0
5800,0,0,0,0,0
32399,0,0,0,0,0
80024,0,0,0,0,0
20105,0,0,0,0,0
36501,0,0,0,0,0
8153,0,0,0,0,0
16411,0,0,0,0,0
42815,0,0,0,0,0
58989,0,0,0,0,0
45517,0,0,0,0,0
60338,0,0,0,0,0
90533,0,0,0,0,0
88682,0,0,0,0,0
63247,0,0,0,0,0
6999,0,0,0,0,0
72152,0,0,0,0,0
27120,0,0,0,0,0
101098,0,0,0,0,0
98102,0,0,0,0,0
18437,0,0,0,0,0
52386,0,0,0,0,0
101754,0,0,0,0,0
93653,0,0,0,0,0
42421,0,0,0,0,0
9560,0,0,0,0,0
63984,0,0,0,0,0
79484,0,0,0,0,0
19662,0,0,0,0,0
19009,0,0,0,0,0
11631,0,0,0,0,0
40673,0,0,0,0,0
80500,0,0,0,0,0
49816,0,0,0,0,0
44919,0,0,0,0,0
108948,0,0,0,0,0
113118,0,0,0,0,0
71795,0,0,0,0,0
21552,0,0,0,0,0
65623,0,0,0,0,0
107174,0,0,0,0,0
64680,0,0,0,0,0
52643,0,0,0,0,0
1847,1,1,1,0,0
35170,0,0,0,0,0
10054,0,0,0,0,0
50864,0,0,0,0,0
72031,0,0,0,0,0
118892,0,0,0,0,0
72591,0,0,0,0,0
65872,1,1,1,0,0
115988,0,0,0,0,0
57558,0,0,0,0,0
26286,0,0,0,0,0
6898,0,0,0,0,0
52538,4,4,4,0,0
13677,0,0,0,0,0
93914,0,0,0,0,0
37775,0,0,0,0,0
39190,0,0,0,0,0
116599,0,0,0,0,0
77950,0,0,0,0,0
104938,0,0,0,0,0
17138,0,0,0,0,0
35370,0,0,0,0,0
59901,0,0,0,0,0
62092,1,1,1,0,0
2753,0,0,0,0,0
104741,0,0,0,0,0
15632,0,0,0,0,0
11736,0,0,0,0,0
113853,0,0,0,0,0
47595,0,0,0,0,0
109390,0,0,0,0,0
64653,0,0,0,0,0
96101,0,0,0,0,0
89684,0,0,0,0,0
65100,0,0,0,0,0
22672,0,0,0,0,0
36393,0,0,0,0,0
38729,0,0,0,0,0
50927,0,0,0,0,0
97502,1,1,1,0,0
3239,0,0,0,0,0
50710,0,0,0,0,0
47972,0,0,0,0,0
111929,0,0,0,0,0
88531,0,0,0,0,0
82938,0,0,0,0,0
37270,0,0,0,0,0
213,0,0,0,0,0
51879,0,0,0,0,0
23917,0,0,0,0,0
63156,0,0,0,0,0
15568,0,0,0,0,0
85343,0,0,0,0,0
117641,0,0,0,0,0
37705,0,0,0,0,0
102357,0,0,0,0,0
89811,0,0,0,0,0
119162,0,0,0,0,0
50604,0,0,0,0,0
32448,0,0,0,0,0
41600,0,0,0,0,0
50192,0,0,0,0,0
85273,0,0,0,0,0
63023,0,0,0,0,0
58293,0,0,0,0,0
52235,0,0,0,0,0
11257,0,0,0,0,0
77088,0,0,0,0,0
17241,0,0,0,0,0
104835,0,0,0,0,0
102064,0,0,0,0,0
68022,0,0,0,0,0
11392,0,0,0,0,0
73822,0,0,0,0,0
54841,0,0,0,0,0
10428,0,0,0,0,0
26334,0,0,0,0,0
63952,0,0,0,0,0
6495,0,0,0,0,0
19047,0,0,0,0,0
55229,0,0,0,0,0
64259,0,0,0,0,0
82136,0,0,0,0,0
117696,0,0,0,0,0
95999,0,0,0,0,0
71305,0,0,0,0,0
79470,0,0,0,0,0
22727,0,0,0,0,0
96937,3,3,3,0,0
2058,0,0,0,0,0
81216,0,0,0,0,0
51552,0,0,0,0,0
100369,0,0,0,0,0
71447,0,0,0,0,0
115834,0,0,0,0,0
31615,0,0,0,0,0
89971,0,0,0,0,0
109819,0,0,0,0,0
15952,0,0,0,0,0
3120,0,0,0,0,0
4687,0,0,0,0,0
115479,0,0,0,0,0
34165,0,0,0,0,0
61984,0,0,0,0,0
22872,0,0,0,0,0
45088,0,0,0,0,0
44444,0,0,0,0,0
34378,0,0,0,0,0
93235,0,0,0,0,0
8517,0,0,0,0,0
16662,0,0,0,0,0
96705,0,0,0,0,0
82983,0,0,0,0,0
53379,0,0,0,0,0
55603,0,0,0,0,0
118731,0,0,0,0,0
70670,0,0,0,0,0
45298,0,0,0,0,0
23155,0,0,0,0,0
69432,0,0,0,0,0
21400,0,0,0,0,0
100815,0,0,0,0,0
93528,0,0,0,0,0
44334,0,0,0,0,0
49200,0,0,0,0,0
6057,0,0,0,0,0
15312,0,0,0,0,0
43357,0,0,0,0,0
36129,0,0,0,0,0
4517,0,0,0,0,0
10799,0,0,0,0,0
98858,0,0,0,0,0
31160,0,0,0,0,0
16444,1,1,1,0,0
58326,0,0,0,0,0
81617,2,2,2,0,0
98111,1,1,1,0,0
91149,0,0,0,0,0
69115,0,0,0,0,0
109707,0,0,0,0,0
101413,0,0,0,0,0
114287,0,0,0,0,0
12721,0,0,0,0,0
84232,0,0,0,0,0
104461,0,0,0,0,0
21937,0,0,0,0,0
4820,0,0,0,0,0
19799,0,0,0,0,0
114167,0,0,0,0,0
52171,0,0,0,0,0
4620,0,0,0,0,0
25258,0,0,0,0,0
87936,0,0,0,0,0
84265,0,0,0,0,0
116709,0,0,0,0,0
4027,0,0,0,0,0
20668,0,0,0,0,0
69369,1,1,1,0,0
25205,0,0,0,0,0
22547,0,0,0,0,0
12725,0,0,0,0,0
38502,0,0,0,0,0
77741,0,0,0,0,0
26888,0,0,0,0,0
58381,0,0,0,0,0
112976,0,0,0,0,0
89108,0,0,0,0,0
105765,0,0,0,0,0
62992,0,0,0,0,0
87959,0,0,0,0,0
97392,0,0,0,0,0
24270,0,0,0,0,0
99314,0,0,0,0,0
8818,0,0,0,0,0
60548,0,0,0,0,0
54974,0,0,0,0,0
1961,0,0,0,0,0
37489,0,0,0,0,0
92204,0,0,0,0,0
4192,0,0,0,0,0
112944,0,0,0,0,0
49064,0,0,0,0,0
85274,0,0,0,0,0
17175,0,0,0,0,0
11670,0,0,0,0,0
67172,0,0,0,0,0
64404,0,0,0,0,0
1293,1,1,1,0,0
67107,0,0,0,0,0
112443,0,0,0,0,0
56865,0,0,0,0,0
96896,0,0,0,0,0
24537,0,0,0,0,0
60778,0,0,0,0,0
16157,0,0,0,0,0
66394,0,0,0,0,0
113940,0,0,0,0,0
90340,0,0,0,0,0
94936,0,0,0,0,0
22501,0,0,0,0,0
39276,0,0,0,0,0
77756,0,0,0,0,0
86662,0,0,0,0,0
44914,0,0,0,0,0
43862,0,0,0,0,0
8500,0,0,0,0,0
89920,0,0,0,0,0
89440,0,0,0,0,0
29380,0,0,0,0,0
35131,0,0,0,0,0
53978,0,0,0,0,0
12799,0,0,0,0,0
62760,0,0,0,0,0
39012,0,0,0,0,0
106057,0,0,0,0,0
78483,0,0,0,0,0
37088,0,0,0,0,0
72608,0,0,0,0,0
86507,0,0,0,0,0
87362,0,0,0,0,0
32551,0,0,0,0,0
62278,0,0,0,0,0
110955,0,0,0,0,0
67337,0,0,0,0,0
5091,0,0,0,0,0
17183,0,0,0,0,0
49159,0,0,0,0,0
72724,0,0,0,0,0
54947,0,0,0,0,0
29618,0,0,0,0,0
14017,0,0,0,0,0
115775,0,0,0,0,0
99466,0,0,0,0,0
6836,0,0,0,0,0
59968,0,0,0,0,0
113887,0,0,0,0,0
17250,0,0,0,0,0
21733,0,0,0,0,0
95409,0,0,0,0,0
86158,0,0,0,0,0
34279,0,0,0,0,0
101108,0,0,0,0,0
77195,0,0,0,0,0
19496,0,0,0,0,0
97074,0,0,0,0,0
39083,0,0,0,0,0
62936,0,0,0,0,0
62047,0,0,0,0,0
81245,0,0,0,0,0
96158,1,1,1,0,0
28528,0,0,0,0,0
30152,0,0,0,0,0
51882,0,0,0,0,0
23285,0,0,0,0,0
45729,0,0,0,0,0
42763,0,0,0,0,0
13784,0,0,0,0,0
64300,0,0,0,0,0
99865,0,0,0,0,0
43978,0,0,0,0,0
33651,0,0,0,0,0
71666,0,0,0,0,0
106229,0,0,0,0,0
101587,0,0,0,0,0
38747,0,0,0,0,0
97501,0,0,0,0,0
26246,0,0,0,0,0
33746,0,0,0,0,0
6562,0,0,0,0,0
99917,0,0,0,0,0
99628,1,1,1,0,0
27646,0,0,0,0,0
47494,0,0,0,0,0
95764,0,0,0,0,0
63646,0,0,0,0,0
119963,0,0,0,0,0
36508,0,0,0,0,0
34077,0,0,0,0,0
377,0,0,0,0,0
98721,0,0,0,0,0
37739,0,0,0,0,0
53868,0,0,0,0,0
107965,0,0,0,0,0
23770,0,0,0,0,0
107031,0,0,0,0,0
79315,0,0,0,0,0
12991,0,0,0,0,0
83701,0,0,0,0,0
119062,0,0,0,0,0
46549,0,0,0,0,0
43622,0,0,0,0,0
29005,0,0,0,0,0
43697,0,0,0,0,0
57589,0,0,0,0,0
20805,4,4,4,0,0
83472,0,0,0,0,0
92519,0,0,0,0,0
31008,0,0,0,0,0
53237,0,0,0,0,0
33494,0,0,0,0,0
24280,0,0,0,0,0
57416,0,0,0,0,0
92915,0,0,0,0,0
92560,0,0,0,0,0
30282,0,0,0,0,0
26906,0,0,0,0,0
94388,0,0,0,0,0
89787,0,0,0,0,0
57419,0,0,0,0,0
82602,0,0,0,0,0
20810,0,0,0,0,0
42939,0,0,0,0,0
93043,0,0,0,0,0
5901,0,0,0,0,0
95539,0,0,0,0,0
74161,0,0,0,0,0
21181,0,0,0,0,0
14278,0,0,0,0,0
10483,0,0,0,0,0
50614,0,0,0,0,0
38450,0,0,0,0,0
97659,0,0,0,0,0
52460,0,0,0,0,0
49011,0,0,0,0,0
15375,0,0,0,0,0
101859,1,1,1,0,0
74032,0,0,0,0,0
78049,0,0,0,0,0
31513,0,0,0,0,0
9653,0,0,0,0,0
67761,0,0,0,0,0
89424,0,0,0,0,0
84814,0,0,0,0,0
91010,0,0,0,0,0
72268,0,0,0,0,0
24091,0,0,0,0,0
58738,0,0,0,0,0
34020,0,0,0,0,0
45543,0,0,0,0,0
66642,0,0,0,0,0
10678,0,0,0,0,0
118987,0,0,0,0,0
88298,0,0,0,0,0
47161,0,0,0,0,0
106464,0,0,0,0,0
14688,0,0,0,0,0
91222,0,0,0,0,0
61778,0,0,0,0,0
54103,0,0,0,0,0
59542,0,0,0,0,0
91406,0,0,0,0,0
48431,0,0,0,0,0
86714,0,0,0,0,0
84727,0,0,0,0,0
95955,0,0,0,0,0
37077,0,0,0,0,0
78899,0,0,0,0,0
103453,0,0,0,0,0
27176,0,0,0,0,0
40032,0,0,0,0,0
112139,0,0,0,0,0
24293,0,0,0,0,0
4246,0,0,0,0,0
61657,0,0,0,0,0
40103,0,0,0,0,0
103158,0,0,0,0,0
46006,1,1,1,0,0
106131,0,0,0,0,0
96406,0,0,0,0,0
98352,0,0,0,0,0
78003,0,0,0,0,0
53514,0,0,0,0,0
106474,0,0,0,0,0
38925,0,0,0,0,0
34922,0,0,0,0,0
101964,0,0,0,0,0
48881,0,0,0,0,0
63670,0,0,0,0,0
13035,0,0,0,0,0
8334,0,0,0,0,0
21761,0,0,0,0,0
34596,0,0,0,0,0
102744,0,0,0,0,0
21318,0,0,0,0,0
92952,0,0,0,0,0
23827,0,0,0,0,0
24628,0,0,0,0,0
108887,0,0,0,0,0
75570,0,0,0,0,0
118548,0,0,0,0,0
13443,0,0,0,0,0
43639,0,0,0,0,0
20336,0,0,0,0,0
16930,0,0,0,0,0
110528,0,0,0,0,0
85864,0,0,0,0,0
98112,0,0,0,0,0
56252,0,0,0,0,0
72944,0,0,0,0,0
47295,0,0,0,0,0
107293,0,0,0,0,0
47700,0,0,0,0,0
42252,0,0,0,0,0
117100,0,0,0,0,0
107301,0,0,0,0,0
100663,0,0,0,0,0
31445,0,0,0,0,0
27519,0,0,0,0,0
92046,0,0,0,0,0
1026,0,0,0,0,0
16831,0,0,0,0,0
69410,0,0,0,0,0
5360,0,0,0,0,0
111857,0,0,0,0,0
26677,0,0,0,0,0
18827,0,0,0,0,0
84873,0,0,0,0,0
80385,0,0,0,0,0
112402,0,0,0,0,0
91183,0,0,0,0,0
84073,0,0,0,0,0
14128,0,0,0,0,0
26062,0,0,0,0,0
29888,0,0,0,0,0
27925,0,0,0,0,0
49088,0,0,0,0,0
28171,0,0,0,0,0
115424,0,0,0,0,0
83616,0,0,0,0,0
70865,0,0,0,0,0
1399,0,0,0,0,0
20280,0,0,0,0,0
36131,2,2,2,0,0
32497,0,0,0,0,0
63037,0,0,0,0,0
4040,0,0,0,0,0
94342,0,0,0,0,0
94603,0,0,0,0,0
79939,0,0,0,0,0
23742,5,5,5,0,0
99867,0,0,0,0,0
107673,0,0,0,0,0
68128,0,0,0,0,0
56531,0,0,0,0,0
64049,0,0,0,0,0
11668,0,0,0,0,0
38633,0,0,0,0,0
79491,0,0,0,0,0
68947,0,0,0,0,0
6308,0,0,0,0,0
44744,0,0,0,0,0
54726,0,0,0,0,0
10492,0,0,0,0,0
1822,0,0,0,0,0
34365,0,0,0,0,0
96752,0,0,0,0,0
74157,0,0,0,0,0
87766,0,0,0,0,0
72615,0,0,0,0,0
24710,0,0,0,0,0
63061,0,0,0,0,0
79731,0,0,0,0,0
69644,0,0,0,0,0
3382,0,0,0,0,0
80633,0,0,0,0,0
85378,4,4,4,0,0
31710,0,0,0,0,0
21775,0,0,0,0,0
63919,0,0,0,0,0
120350,0,0,0,0,0
6596,0,0,0,0,0
114606,0,0,0,0,0
5692,0,0,0,0,0
103233,0,0,0,0,0
105951,0,0,0,0,0
46334,0,0,0,0,0
62251,0,0,0,0,0
60600,0,0,0,0,0
118208,0,0,0,0,0
65929,0,0,0,0,0
110151,0,0,0,0,0
43512,0,0,0,0,0
26479,0,0,0,0,0
13069,0,0,0,0,0
20196,0,0,0,0,0
56688,0,0,0,0,0
108907,0,0,0,0,0
18485,0,0,0,0,0
23971,0,0,0,0,0
42261,0,0,0,0,0
23357,0,0,0,0,0
119865,0,0,0,0,0
48094,0,0,0,0,0
102549,0,0,0,0,0
87807,0,0,0,0,0
51581,0,0,0,0,0
40210,0,0,0,0,0
61711,0,0,0,0,0
57520,0,0,0,0,0
112156,0,0,0,0,0
92437,0,0,0,0,0
34925,0,0,0,0,0
22268,0,0,0,0,0
8254,0,0,0,0,0
85839,1,1,1,0,0
113154,0,0,0,0,0
97868,0,0,0,0,0
107252,0,0,0,0,0
7891,0,0,0,0,0
85784,0,0,0,0,0
117171,0,0,0,0,0
47242,0,0,0,0,0
30426,0,0,0,0,0
86274,0,0,0,0,0
55533,0,0,0,0,0
31229,0,0,0,0,0
30450,0,0,0,0,0
49444,0,0,0,0,0
83013,0,0,0,0,0
59102,0,0,0,0,0
117468,0,0,0,0,0
50046,0,0,0,0,0
50891,0,0,0,0,0
17364,0,0,0,0,0
48465,0,0,0,0,0
87716,0,0,0,0,0
64654,0,0,0,0,0
83403,0,0,0,0,0
15572,0,0,0,0,0
36709,0,0,0,0,0
18375,0,0,0,0,0
53087,0,0,0,0,0
108096,0,0,0,0,0
91024,0,0,0,0,0
41892,0,0,0,0,0
14518,0,0,0,0,0
6954,0,0,0,0,0
90183,0,0,0,0,0
111296,2,2,2,0,0
12942,0,0,0,0,0
85457,0,0,0,0,0
48898,0,0,0,0,0
55361,0,0,0,0,0
72838,0,0,0,0,0
70960,0,0,0,0,0
109501,0,0,0,0,0
17629,0,0,0,0,0
87999,0,0,0,0,0
64418,0,0,0,0,0
82601,0,0,0,0,0
4982,0,0,0,0,0
62221,0,0,0,0,0
81249,0,0,0,0,0
48924,0,0,0,0,0
20448,0,0,0,0,0
100740,0,0,0,0,0
11416,0,0,0,0,0
61617,0,0,0,0,0
32317,0,0,0,0,0
73575,0,0,0,0,0
50199,0,0,0,0,0
91449,0,0,0,0,0
109842,0,0,0,0,0
104178,0,0,0,0,0
11327,0,0,0,0,0
15439,0,0,0,0,0
61872,0,0,0,0,0
10783,0,0,0,0,0
112577,0,0,0,0,0
118556,0,0,0,0,0
63961,0,0,0,0,0
103983,0,0,0,0,0
91725,0,0,0,0,0
71159,0,0,0,0,0
25581,0,0,0,0,0
21491,0,0,0,0,0
99268,0,0,0,0,0
105413,0,0,0,0,0
26455,0,0,0,0,0
45978,0,0,0,0,0
28034,0,0,0,0,0
107896,0,0,0,0,0
10571,0,0,0,0,0
4061,0,0,0,0,0
116217,0,0,0,0,0
37907,0,0,0,0,0
41253,0,0,0,0,0
71934,0,0,0,0,0
102336,0,0,0,0,0
57046,0,0,0,0,0
23352,0,0,0,0,0
80910,0,0,0,0,0
2950,0,0,0,0,0
113104,0,0,0,0,0
119126,0,0,0,0,0
21045,0,0,0,0,0
114319,0,0,0,0,0
43839,0,0,0,0,0
1496,0,0,0,0,0
70253,0,0,0,0,0
12125,0,0,0,0,0
6703,0,0,0,0,0
37807,0,0,0,0,0
24152,0,0,0,0,0
54578,0,0,0,0,0
11388,0,0,0,0,0
13602,0,0,0,0,0
52901,0,0,0,0,0
114922,0,0,0,0,0
107802,0,0,0,0,0
87054,0,0,0,0,0
68080,0,0,0,0,0
62350,0,0,0,0,0
98811,0,0,0,0,0
22554,0,0,0,0,0
111576,0,0,0,0,0
48598,0,0,0,0,0
48085,0,0,0,0,0
64144,0,0,0,0,0
69041,0,0,0,0,0
63051,0,0,0,0,0
76692,0,0,0,0,0
50026,0,0,0,0,0
72199,0,0,0,0,0
117073,0,0,0,0,0
100963,0,0,0,0,0
42154,0,0,0,0,0
12302,0,0,0,0,0
28760,0,0,0,0,0
60677,0,0,0,0,0
11006,0,0,0,0,0
47704,0,0,0,0,0
67466,0,0,0,0,0
33702,0,0,0,0,0
41319,0,0,0,0,0
84987,0,0,0,0,0
97105,0,0,0,0,0
38866,0,0,0,0,0
63590,0,0,0,0,0
50213,0,0,0,0,0
17983,0,0,0,0,0
47109,0,0,0,0,0
10290,0,0,0,0,0
105614,0,0,0,0,0
52183,0,0,0,0,0
11978,0,0,0,0,0
100848,0,0,0,0,0
51359,0,0,0,0,0
99463,0,0,0,0,0
170,0,0,0,0,0
92597,0,0,0,0,0
79742,0,0,0,0,0
111314,0,0,0,0,0
87096,0,0,0,0,0
53917,0,0,0,0,0
5082,0,0,0,0,0
64876,0,0,0,0,0
62940,0,0,0,0,0
89179,0,0,0,0,0
63568,0,0,0,0,0
86419,0,0,0,0,0
48039,0,0,0,0,0
103446,0,0,0,0,0
86378,0,0,0,0,0
38501,0,0,0,0,0
111560,0,0,0,0,0
7432,0,0,0,0,0
70625,0,0,0,0,0
56268,0,0,0,0,0
17027,0,0,0,0,0
108110,0,0,0,0,0
9331,0,0,0,0,0
60673,0,0,0,0,0
33736,0,0,0,0,0
39358,0,0,0,0,0
48266,0,0,0,0,0
106235,0,0,0,0,0
40666,0,0,0,0,0
22310,0,0,0,0,0
71363,0,0,0,0,0
110514,0,0,0,0,0
81738,0,0,0,0,0
28423,3,3,3,0,0
66695,0,0,0,0,0
48778,0,0,0,0,0
71079,0,0,0,0,0
75060,0,0,0,0,0
75837,0,0,0,0,0
78514,0,0,0,0,0
94217,0,0,0,0,0
105403,0,0,0,0,0
79478,0,0,0,0,0
113602,0,0,0,0,0
25840,0,0,0,0,0
31043,0,0,0,0,0
15979,0,0,0,0,0
81193,0,0,0,0,0
118038,5,5,5,0,0
116043,0,0,0,0,0
47885,0,0,0,0,0
13915,0,0,0,0,0
16943,0,0,0,0,0
111354,0,0,0,0,0
57049,1,1,1,0,0
80057,0,0,0,0,0
44067,0,0,0,0,0
107778,0,0,0,0,0
85546,0,0,0,0,0
101506,0,0,0,0,0
106157,0,0,0,0,0
86094,0,0,0,0,0
45312,0,0,0,0,0
5161,0,0,0,0,0
31264,0,0,0,0,0
90266,0,0,0,0,0
10560,0,0,0,0,0
72562,0,0,0,0,0
36161,0,0,0,0,0
76847,0,0,0,0,0
97346,0,0,0,0,0
10997,0,0,0,0,0
89561,0,0,0,0,0
75192,0,0,0,0,0
81991,0,0,0,0,0
5402,0,0,0,0,0
50119,2,2,2,0,0
63471,0,0,0,0,0
99949,0,0,0,0,0
33306,0,0,0,0,0
103593,0,0,0,0,0
107830,3,3,3,0,0
97647,0,0,0,0,0
66555,5,5,5,0,0
26854,0,0,0,0,0
47156,0,0,0,0,0
32728,0,0,0,0,0
45986,0,0,0,0,0
106094,0,0,0,0,0
28634,0,0,0,0,0
47964,0,0,0,0,0
26357,0,0,0,0,0
8764,0,0,0,0,0
29411,0,0,0,0,0
51215,0,0,0,0,0
16325,0,0,0,0,0
72165,0,0,0,0,0
53386,0,0,0,0,0
74288,0,0,0,0,0
6248,0,0,0,0,0
92538,0,0,0,0,0
101309,0,0,0,0,0
17301,0,0,0,0,0
50590,0,0,0,0,0
37855,0,0,0,0,0
45401,0,0,0,0,0
47079,0,0,0,0,0
71484,0,0,0,0,0
4800,0,0,0,0,0
116318,0,0,0,0,0
49312,0,0,0,0,0
103382,0,0,0,0,0
96636,0,0,0,0,0
85154,0,0,0,0,0
88239,0,0,0,0,0
63734,0,0,0,0,0
59062,0,0,0,0,0
22433,0,0,0,0,0
104282,0,0,0,0,0
80154,0,0,0,0,0
15281,0,0,0,0,0
2213,0,0,0,0,0
82152,0,0,0,0,0
115747,0,0,0,0,0
12328,0,0,0,0,0
25475,0,0,0,0,0
33781,0,0,0,0,0
101003,0,0,0,0,0
96613,0,0,0,0,0
82994,0,0,0,0,0
23181,0,0,0,0,0
82795,0,0,0,0,0
77337,0,0,0,0,0
112151,0,0,0,0,0
84163,0,0,0,0,0
98705,0,0,0,0,0
79469,0,0,0,0,0
15193,0,0,0,0,0
18282,0,0,0,0,0
80829,0,0,0,0,0
98710,0,0,0,0,0
73763,0,0,0,0,0
58432,4,4,4,0,0
39069,0,0,0,0,0
6202,0,0,0,0,0
51295,0,0,0,0,0
97380,0,0,0,0,0
104752,0,0,0,0,0
58821,0,0,0,0,0
115361,0,0,0,0,0
92534,0,0,0,0,0
37149,0,0,0,0,0
35802,0,0,0,0,0
60016,0,0,0,0,0
1432,0,0,0,0,0
722,0,0,0,0,0
17406,0,0,0,0,0
34989,0,0,0,0,0
39266,0,0,0,0,0
95430,0,0,0,0,0
42519,0,0,0,0,0
103463,0,0,0,0,0
83820,0,0,0,0,0
115105,0,0,0,0,0
59316,0,0,0,0,0
73509,0,0,0,0,0
25689,0,0,0,0,0
22021,0,0,0,0,0
108751,0,0,0,0,0
13168,0,0,0,0,0
57213,0,0,0,0,0
56965,0,0,0,0,0
548,0,0,0,0,0
76282,0,0,0,0,0
90792,0,0,0,0,0
49487,0,0,0,0,0
19421,0,0,0,0,0
61530,0,0,0,0,0
82978,0,0,0,0,0
101851,0,0,0,0,0
43630,0,0,0,0,0
66423,0,0,0,0,0
2189,0,0,0,0,0
61836,0,0,0,0,0
27535,0,0,0,0,0
67759,0,0,0,0,0
16905,0,0,0,0,0
22669,0,0,0,0,0
22967,0,0,0,0,0
107357,0,0,0,0,0
96547,0,0,0,0,0
92251,0,0,0,0,0
86913,0,0,0,0,0
208,0,0,0,0,0
87852,0,0,0,0,0
56579,0,0,0,0,0
29205,0,0,0,0,0
71869,0,0,0,0,0
105903,0,0,0,0,0
113738,0,0,0,0,0
29834,0,0,0,0,0
12417,0,0,0,0,0
82642,0,0,0,0,0
91555,0,0,0,0,0
9619,0,0,0,0,0
28562,0,0,0,0,0
73611,0,0,0,0,0
49694,0,0,0,0,0
97687,0,0,0,0,0
35853,0,0,0,0,0
92062,0,0,0,0,0
85909,0,0,0,0,0
30358,0,0,0,0,0
102847,0,0,0,0,0
22760,0,0,0,0,0
29341,0,0,0,0,0
27351,0,0,0,0,0
114692,1,1,1,0,0
34332,0,0,0,0,0
87395,0,0,0,0,0
32954,0,0,0,0,0
44646,0,0,0,0,0
30847,0,0,0,0,0
108476,0,0,0,0,0
43078,0,0,0,0,0
77855,0,0,0,0,0
79601,0,0,0,0,0
2774,0,0,0,0,0
61738,0,0,0,0,0
4918,0,0,0,0,0
94868,0,0,0,0,0
58459,0,0,0,0,0
63997,0,0,0,0,0
114777,0,0,0,0,0
95466,0,0,0,0,0
29182,0,0,0,0,0
83018,0,0,0,0,0
28926,0,0,0,0,0
41723,0,0,0,0,0
78755,0,0,0,0,0
93784,0,0,0,0,0
45113,0,0,0,0,0
84039,0,0,0,0,0
2980,0,0,0,0,0
41240,0,0,0,0,0
104393,0,0,0,0,0
70877,0,0,0,0,0
16482,0,0,0,0,0
68420,0,0,0,0,0
112708,0,0,0,0,0
47861,0,0,0,0,0
45025,0,0,0,0,0
9351,0,0,0,0,0
112633,0,0,0,0,0
104439,0,0,0,0,0
102720,0,0,0,0,0
85835,0,0,0,0,0
74780,0,0,0,0,0
118443,0,0,0,0,0
554,0,0,0,0,0
60538,0,0,0,0,0
42585,0,0,0,0,0
117174,0,0,0,0,0
51181,0,0,0,0,0
73713,0,0,0,0,0
114538,0,0,0,0,0
17676,0,0,0,0,0
40866,0,0,0,0,0
83784,0,0,0,0,0
50906,0,0,0,0,0
118243,0,0,0,0,0
60831,0,0,0,0,0
116522,0,0,0,0,0
51696,0,0,0,0,0
84205,0,0,0,0,0
81303,0,0,0,0,0
53111,0,0,0,0,0
70091,0,0,0,0,0
4725,0,0,0,0,0
12243,0,0,0,0,0
62896,0,0,0,0,0
88041,0,0,0,0,0
55115,0,0,0,0,0
111669,0,0,0,0,0
72311,0,0,0,0,0
109546,0,0,0,0,0
95472,0,0,0,0,0
49276,0,0,0,0,0
112066,0,0,0,0,0
43975,0,0,0,0,0
66534,0,0,0,0,0
75664,0,0,0,0,0
93041,0,0,0,0,0
57714,0,0,0,0,0
32406,0,0,0,0,0
33026,0,0,0,0,0
24022,0,0,0,0,0
100305,0,0,0,0,0
63700,0,0,0,0,0
108822,0,0,0,0,0
115532,0,0,0,0,0
64103,0,0,0,0,0
90408,0,0,0,0,0
43305,0,0,0,0,0
33271,0,0,0,0,0
98703,0,0,0,0,0
72321,0,0,0,0,0
2995,0,0,0,0,0
95655,0,0,0,0,0
15354,0,0,0,0,0
61045,0,0,0,0,0
28104,0,0,0,0,0
53082,0,0,0,0,0
98157,0,0,0,0,0
90392,0,0,0,0,0
23871,0,0,0,0,0
102393,0,0,0,0,0
112715,0,0,0,0,0
68169,0,0,0,0,0
32126,0,0,0,0,0
85711,0,0,0,0,0
67743,0,0,0,0,0
16278,0,0,0,0,0
88825,0,0,0,0,0
50638,0,0,0,0,0
55844,0,0,0,0,0
64025,0,0,0,0,0
97339,0,0,0,0,0
118045,0,0,0,0,0
65553,0,0,0,0,0
7703,0,0,0,0,0
21648,0,0,0,0,0
95905,0,0,0,0,0
33134,0,0,0,0,0
206,0,0,0,0,0
84803,0,0,0,0,0
43594,0,0,0,0,0
36172,0,0,0,0,0
49638,0,0,0,0,0
114759,0,0,0,0,0
7794,0,0,0,0,0
5348,0,0,0,0,0
89559,0,0,0,0,0
88574,0,0,0,0,0
27141,0,0,0,0,0
35372,0,0,0,0,0
58541,0,0,0,0,0
60023,0,0,0,0,0
103831,0,0,0,0,0
111565,0,0,0,0,0
117599,0,0,0,0,0
11874,0,0,0,0,0
44676,0,0,0,0,0
56093,0,0,0,0,0
68340,0,0,0,0,0
116157,0,0,0,0,0
14350,0,0,0,0,0
48097,0,0,0,0,0
112346,0,0,0,0,0
95508,0,0,0,0,0
4663,0,0,0,0,0
118377,0,0,0,0,0
100457,0,0,0,0,0
45380,0,0,0,0,0
33981,0,0,0,0,0
24491,0,0,0,0,0
27140,0,0,0,0,0
1281,0,0,0,0,0
119872,0,0,0,0,0
48803,0,0,0,0,0
120003,0,0,0,0,0
83325,0,0,0,0,0
74147,0,0,0,0,0
55066,0,0,0,0,0
60969,0,0,0,0,0
91225,0,0,0,0,0
102350,0,0,0,0,0
86006,0,0,0,0,0
73231,0,0,0,0,0
8135,0,0,0,0,0
35413,0,0,0,0,0
95748,0,0,0,0,0
31846,0,0,0,0,0
32100,0,0,0,0,0
74423,0,0,0,0,0
74061,0,0,0,0,0
58618,0,0,0,0,0
3559,0,0,0,0,0
49543,0,0,0,0,0
119560,0,0,0,0,0
95034,0,0,0,0,0
55507,0,0,0,0,0
37906,0,0,0,0,0
10506,0,0,0,0,0
23356,0,0,0,0,0
68396,0,0,0,0,0
110808,0,0,0,0,0
6026,0,0,0,0,0
57618,0,0,0,0,0
11316,0,0,0,0,0
102075,0,0,0,0,0
83138,0,0,0,0,0
38224,0,0,0,0,0
34865,0,0,0,0,0
7466,0,0,0,0,0
20342,0,0,0,0,0
12172,0,0,0,0,0
25030,0,0,0,0,0
117773,0,0,0,0,0
31141,0,0,0,0,0
23258,0,0,0,0,0
68096,0,0,0,0,0
5739,0,0,0,0,0
107159,0,0,0,0,0
10624,0,0,0,0,0
97616,0,0,0,0,0
48677,0,0,0,0,0
106049,0,0,0,0,0
106595,0,0,0,0,0
29424,0,0,0,0,0
113851,0,0,0,0,0
38431,0,0,0,0,0
28096,0,0,0,0,0
80565,0,0,0,0,0
34243,0,0,0,0,0
101601,0,0,0,0,0
96447,2,2,2,0,0
32025,0,0,0,0,0
41421,0,0,0,0,0
30888,0,0,0,0,0
6684,0,0,0,0,0
63067,0,0,0,0,0
20150,0,0,0,0,0
69085,0,0,0,0,0
75113,0,0,0,0,0
98404,0,0,0,0,0
76990,0,0,0,0,0
3481,0,0,0,0,0
33426,0,0,0,0,0
112189,0,0,0,0,0
111178,0,0,0,0,0
107462,0,0,0,0,0
45277,0,0,0,0,0
56569,0,0,0,0,0
119868,0,0,0,0,0
85337,0,0,0,0,0
42311,0,0,0,0,0
119212,0,0,0,0,0
61834,0,0,0,0,0
93622,0,0,0,0,0
41408,0,0,0,0,0
99669,0,0,0,0,0
33192,0,0,0,0,0
54095,0,0,0,0,0
18962,0,0,0,0,0
83494,0,0,0,0,0
89472,0,0,0,0,0
40948,0,0,0,0,0
96398,0,0,0,0,0
117789,0,0,0,0,0
61098,0,0,0,0,0
74810,0,0,0,0,0
100972,0,0,0,0,0
103123,0,0,0,0,0
11434,0,0,0,0,0
104417,0,0,0,0,0
9404,0,0,0,0,0
33681,0,0,0,0,0
115777,0,0,0,0,0
22413,0,0,0,0,0
74250,0,0,0,0,0
9666,0,0,0,0,0
89423,0,0,0,0,0
60304,0,0,0,0,0
74171,0,0,0,0,0
97110,0,0,0,0,0
97661,0,0,0,0,0
117785,0,0,0,0,0
109919,0,0,0,0,0
38387,0,0,0,0,0
118517,0,0,0,0,0
12446,0,0,0,0,0
112817,0,0,0,0,0
91501,0,0,0,0,0
15501,0,0,0,0,0
46738,0,0,0,0,0
18547,0,0,0,0,0
13917,0,0,0,0,0
102163,0,0,0,0,0
78636,0,0,0,0,0
37381,0,0,0,0,0
25188,0,0,0,0,0
46546,0,0,0,0,0
49166,0,0,0,0,0
105434,1,1,1,0,0
38412,0,0,0,0,0
100368,0,0,0,0,0
65750,0,0,0,0,0
71275,0,0,0,0,0
78384,0,0,0,0,0
116942,0,0,0,0,0
7389,0,0,0,0,0
75520,4,4,4,0,0
54775,0,0,0,0,0
86437,0,0,0,0,0
64150,0,0,0,0,0
40277,0,0,0,0,0
70382,0,0,0,0,0
45076,0,0,0,0,0
16321,0,0,0,0,0
64068,0,0,0,0,0
46681,0,0,0,0,0
98577,2,2,2,0,0
94364,0,0,0,0,0
1879,0,0,0,0,0
31966,0,0,0,0,0
28510,0,0,0,0,0
38957,0,0,0,0,0
9111,0,0,0,0,0
97231,0,0,0,0,0
98471,0,0,0,0,0
33203,0,0,0,0,0
30175,0,0,0,0,0
102257,0,0,0,0,0
67775,0,0,0,0,0
62957,0,0,0,0,0
104419,0,0,0,0,0
68234,0,0,0,0,0
37963,0,0,0,0,0
63548,0,0,0,0,0
34688,0,0,0,0,0
112809,0,0,0,0,0
86625,0,0,0,0,0
112337,0,0,0,0,0
5390,0,0,0,0,0
92839,0,0,0,0,0
114903,1,1,1,0,0
17728,0,0,0,0,0
98619,0,0,0,0,0
39156,0,0,0,0,0
103580,0,0,0,0,0
72626,0,0,0,0,0
69698,0,0,0,0,0
30319,0,0,0,0,0
40401,0,0,0,0,0
40629,0,0,0,0,0
43549,0,0,0,0,0
66091,0,0,0,0,0
67498,0,0,0,0,0
19153,0,0,0,0,0
49815,0,0,0,0,0
64365,0,0,0,0,0
28782,0,0,0,0,0
74800,0,0,0,0,0
64533,0,0,0,0,0
24054,0,0,0,0,0
68132,0,0,0,0,0
68057,0,0,0,0,0
82957,0,0,0,0,0
16393,0,0,0,0,0
56654,0,0,0,0,0
25006,0,0,0,0,0
1510,2,2,2,0,0
96422,0,0,0,0,0
105950,0,0,0,0,0
20397,0,0,0,0,0
75512,0,0,0,0,0
35953,0,0,0,0,0
15437,0,0,0,0,0
117576,0,0,0,0,0
64591,0,0,0,0,0
49046,0,0,0,0,0
20272,0,0,0,0,0
118426,0,0,0,0,0
113921,0,0,0,0,0
100125,0,0,0,0,0
51253,0,0,0,0,0
24191,0,0,0,0,0
25354,0,0,0,0,0
106732,0,0,0,0,0
39914,0,0,0,0,0
28564,0,0,0,0,0
107562,0,0,0,0,0
62183,0,0,0,0,0
97581,0,0,0,0,0
93655,0,0,0,0,0
8795,0,0,0,0,0
76379,1,1,1,0,0
49282,0,0,0,0,0
6605,0,0,0,0,0
61024,0,0,0,0,0
68179,0,0,0,0,0
97119,0,0,0,0,0
15111,0,0,0,0,0
20296,0,0,0,0,0
88943,0,0,0,0,0
107382,0,0,0,0,0
36358,0,0,0,0,0
31419,0,0,0,0,0
21680,0,0,0,0,0
31980,0,0,0,0,0
101530,0,0,0,0,0
58380,0,0,0,0,0
29479,0,0,0,0,0
103374,0,0,0,0,0
109822,0,0,0,0,0
50703,0,0,0,0,0
72979,0,0,0,0,0
26041,0,0,0,0,0
24928,0,0,0,0,0
55753,0,0,0,0,0
41308,0,0,0,0,0
66134,0,0,0,0,0
46077,0,0,0,0,0
80673,0,0,0,0,0
49251,0,0,0,0,0
116720,0,0,0,0,0
44403,0,0,0,0,0
85871,0,0,0,0,0
95227,0,0,0,0,0
25778,0,0,0,0,0
85447,0,0,0,0,0
94149,0,0,0,0,0
89433,0,0,0,0,0
83653,0,0,0,0,0
12207,0,0,0,0,0
113217,0,0,0,0,0
1751,0,0,0,0,0
48812,0,0,0,0,0
2302,0,0,0,0,0
111432,0,0,0,0,0
96641,0,0,0,0,0
38690,0,0,0,0,0
97092,0,0,0,0,0
98447,0,0,0,0,0
12862,0,0,0,0,0
90716,0,0,0,0,0
20591,0,0,0,0,0
117571,0,0,0,0,0
27883,0,0,0,0,0
17589,0,0,0,0,0
6505,0,0,0,0,0
64985,0,0,0,0,0
74552,0,0,0,0,0
59906,0,0,0,0,0
23608,0,0,0,0,0
15837,0,0,0,0,0
5034,0,0,0,0,0
84061,0,0,0,0,0
98614,0,0,0,0,0
117823,0,0,0,0,0
85875,0,0,0,0,0
91700,0,0,0,0,0
92205,0,0,0,0,0
48818,0,0,0,0,0
46716,0,0,0,0,0
63373,0,0,0,0,0
59458,0,0,0,0,0
51997,0,0,0,0,0
77906,0,0,0,0,0
14055,0,0,0,0,0
35734,0,0,0,0,0
70133,0,0,0,0,0
13251,0,0,0,0,0
38913,0,0,0,0,0
98983,0,0,0,0,0
30962,0,0,0,0,0
14558,0,0,0,0,0
20104,0,0,0,0,0
79439,0,0,0,0,0
52336,0,0,0,0,0
5514,0,0,0,0,0
11150,0,0,0,0,0
10701,0,0,0,0,0
111906,0,0,0,0,0
73426,0,0,0,0,0
33887,0,0,0,0,0
35443,0,0,0,0,0
105739,0,0,0,0,0
117999,0,0,0,0,0
2350,0,0,0,0,0
75526,1,1,1,0,0
7312,0,0,0,0,0
59442,0,0,0,0,0
78297,0,0,0,0,0
61615,0,0,0,0,0
32464,0,0,0,0,0
45686,0,0,0,0,0
5306,0,0,0,0,0
70871,0,0,0,0,0
85333,0,0,0,0,0
15011,0,0,0,0,0
40280,0,0,0,0,0
68634,0,0,0,0,0
30989,0,0,0,0,0
50705,0,0,0,0,0
115897,0,0,0,0,0
83788,0,0,0,0,0
64589,0,0,0,0,0
32304,0,0,0,0,0
93419,0,0,0,0,0
62666,0,0,0,0,0
33272,0,0,0,0,0
36819,0,0,0,0,0
70602,0,0,0,0,0
43775,0,0,0,0,0
108987,1,1,1,0,0
35280,0,0,0,0,0
53825,0,0,0,0,0
112556,0,0,0,0,0
100515,0,0,0,0,0
95478,0,0,0,0,0
59305,0,0,0,0,0
1336,0,0,0,0,0
83634,0,0,0,0,0
54510,0,0,0,0,0
15799,0,0,0,0,0
97681,0,0,0,0,0
47601,0,0,0,0,0
31251,0,0,0,0,0
8813,0,0,0,0,0
92826,0,0,0,0,0
107743,0,0,0,0,0
24810,0,0,0,0,0
15442,0,0,0,0,0
4712,0,0,0,0,0
33018,0,0,0,0,0
27516,0,0,0,0,0
98943,0,0,0,0,0
84153,0,0,0,0,0
65550,0,0,0,0,0
62087,0,0,0,0,0
91930,0,0,0,0,0
68027,0,0,0,0,0
102443,0,0,0,0,0
75194,0,0,0,0,0
98724,0,0,0,0,0
89265,0,0,0,0,0
6269,0,0,0,0,0
98253,0,0,0,0,0
48708,0,0,0,0,0
18099,0,0,0,0,0
118820,0,0,0,0,0
110339,0,0,0,0,0
2930,0,0,0,0,0
79379,0,0,0,0,0
119290,0,0,0,0,0
8959,0,0,0,0,0
80180,0,0,0,0,0
46642,0,0,0,0,0
114800,0,0,0,0,0
17860,0,0,0,0,0
2482,0,0,0,0,0
107370,0,0,0,0,0
41567,0,0,0,0,0
29512,0,0,0,0,0
166,0,0,0,0,0
93789,0,0,0,0,0
13206,0,0,0,0,0
51408,0,0,0,0,0
113391,0,0,0,0,0
117536,0,0,0,0,0
99122,0,0,0,0,0
105222,0,0,0,0,0
90802,0,0,0,0,0
82292,0,0,0,0,0
63292,0,0,0,0,0
11673,0,0,0,0,0
99420,0,0,0,0,0
60393,0,0,0,0,0
20395,0,0,0,0,0
41695,0,0,0,0,0
106852,0,0,0,0,0
106180,0,0,0,0,0
60349,0,0,0,0,0
79,0,0,0,0,0
50340,0,0,0,0,0
118719,0,0,0,0,0
32023,0,0,0,0,0
14668,0,0,0,0,0
60475,0,0,0,0,0
56679,0,0,0,0,0
64410,0,0,0,0,0
12191,0,0,0,0,0
116201,0,0,0,0,0
62355,0,0,0,0,0
66016,0,0,0,0,0
95996,0,0,0,0,0
3238,0,0,0,0,0
4359,0,0,0,0,0
53938,0,0,0,0,0
20075,0,0,0,0,0
61355,0,0,0,0,0
33165,0,0,0,0,0
96550,0,0,0,0,0
29749,0,0,0,0,0
60038,0,0,0,0,0
12561,0,0,0,0,0
62588,0,0,0,0,0
76286,0,0,0,0,0
16637,0,0,0,0,0
82079,0,0,0,0,0
66950,0,0,0,0,0
87260,0,0,0,0,0
95778,0,0,0,0,0
17943,0,0,0,0,0
94697,0,0,0,0,0
90996,0,0,0,0,0
61467,0,0,0,0,0
89993,0,0,0,0,0
99891,0,0,0,0,0
11651,0,0,0,0,0
57494,0,0,0,0,0
119772,0,0,0,0,0
106319,0,0,0,0,0
3373,0,0,0,0,0
113457,0,0,0,0,0
78387,0,0,0,0,0
86816,0,0,0,0,0
97020,0,0,0,0,0
18122,0,0,0,0,0
69586,0,0,0,0,0
36173,0,0,0,0,0
21978,0,0,0,0,0
58280,0,0,0,0,0
109863,0,0,0,0,0
17415,0,0,0,0,0
46859,0,0,0,0,0
68840,0,0,0,0,0
88313,0,0,0,0,0
2196,0,0,0,0,0
89129,0,0,0,0,0
55165,0,0,0,0,0
34637,0,0,0,0,0
57086,0,0,0,0,0
61649,0,0,0,0,0
76735,0,0,0,0,0
22016,0,0,0,0,0
111837,0,0,0,0,0
43429,0,0,0,0,0
42200,0,0,0,0,0
25747,0,0,0,0,0
95770,0,0,0,0,0
99694,0,0,0,0,0
116893,0,0,0,0,0
89353,0,0,0,0,0
59426,0,0,0,0,0
12858,0,0,0,0,0
19778,0,0,0,0,0
79143,0,0,0,0,0
7078,0,0,0,0,0
24611,0,0,0,0,0
84495,0,0,0,0,0
81022,0,0,0,0,0
108583,0,0,0,0,0
20497,0,0,0,0,0
119588,0,0,0,0,0
107246,0,0,0,0,0
1864,0,0,0,0,0
80314,0,0,0,0,0
51045,0,0,0,0,0
21348,0,0,0,0,0
58748,0,0,0,0,0
117934,0,0,0,0,0
39516,0,0,0,0,0
65329,0,0,0,0,0
69773,0,0,0,0,0
89079,0,0,0,0,0
19394,0,0,0,0,0
29980,0,0,0,0,0
40729,0,0,0,0,0
73383,0,0,0,0,0
7698,0,0,0,0,0
88847,0,0,0,0,0
91903,0,0,0,0,0
117209,0,0,0,0,0
19444,0,0,0,0,0
53804,0,0,0,0,0
20097,0,0,0,0,0
26549,0,0,0,0,0
106692,0,0,0,0,0
18168,0,0,0,0,0
63817,0,0,0,0,0
22972,0,0,0,0,0
61964,0,0,0,0,0
49372,0,0,0,0,0
57629,0,0,0,0,0
8868,0,0,0,0,0
38423,0,0,0,0,0
30826,0,0,0,0,0
8159,0,0,0,0,0
77559,0,0,0,0,0
89915,0,0,0,0,0
34746,0,0,0,0,0
109310,0,0,0,0,0
37433,0,0,0,0,0
53894,0,0,0,0,0
75891,0,0,0,0,0
92176,0,0,0,0,0
82870,0,0,0,0,0
57782,0,0,0,0,0
67598,0,0,0,0,0
28273,0,0,0,0,0
97780,3,3,3,0,0
64553,0,0,0,0,0
580,0,0,0,0,0
88564,0,0,0,0,0
2242,0,0,0,0,0
104272,0,0,0,0,0
86995,0,0,0,0,0
4681,0,0,0,0,0
106515,0,0,0,0,0
97776,0,0,0,0,0
16646,0,0,0,0,0
58961,0,0,0,0,0
73840,0,0,0,0,0
100242,0,0,0,0,0
86095,0,0,0,0,0
118275,0,0,0,0,0
115243,0,0,0,0,0
103627,0,0,0,0,0
93452,0,0,0,0,0
55181,0,0,0,0,0
50505,0,0,0,0,0
22471,0,0,0,0,0
34184,0,0,0,0,0
57023,0,0,0,0,0
107183,0,0,0,0,0
66303,0,0,0,0,0
43961,0,0,0,0,0
80954,0,0,0,0,0
57976,0,0,0,0,0
35478,0,0,0,0,0
118735,0,0,0,0,0
5600,0,0,0,0,0
8878,0,0,0,0,0
18177,0,0,0,0,0
72548,0,0,0,0,0
110133,0,0,0,0,0
73710,0,0,0,0,0
77872,0,0,0,0,0
116305,0,0,0,0,0
41496,0,0,0,0,0
60292,0,0,0,0,0
108010,0,0,0,0,0
69284,0,0,0,0,0
26966,0,0,0,0,0
47664,0,0,0,0,0
60487,0,0,0,0,0
71689,0,0,0,0,0
63704,0,0,0,0,0
105432,0,0,0,0,0
37339,0,0,0,0,0
14715,0,0,0,0,0
58628,0,0,0,0,0
55202,0,0,0,0,0
118201,0,0,0,0,0
36033,0,0,0,0,0
32285,0,0,0,0,0
94940,0,0,0,0,0
76791,0,0,0,0,0
73731,0,0,0,0,0
82185,0,0,0,0,0
15609,0,0,0,0,0
63999,0,0,0,0,0
87055,0,0,0,0,0
58765,0,0,0,0,0
38823,0,0,0,0,0
63901,0,0,0,0,0
7192,2,2,2,0,0
104945,0,0,0,0,0
93689,0,0,0,0,0
108833,0,0,0,0,0
42863,0,0,0,0,0
62392,0,0,0,0,0
94747,0,0,0,0,0
44199,0,0,0,0,0
20988,0,0,0,0,0
98679,0,0,0,0,0
66580,0,0,0,0,0
42630,0,0,0,0,0
107473,0,0,0,0,0
81966,0,0,0,0,0
52331,0,0,0,0,0
72482,0,0,0,0,0
78807,0,0,0,0,0
16116,0,0,0,0,0
108405,0,0,0,0,0
85051,0,0,0,0,0
77115,0,0,0,0,0
51532,0,0,0,0,0
11770,0,0,0,0,0
42277,0,0,0,0,0
76956,0,0,0,0,0
54879,0,0,0,0,0
55037,0,0,0,0,0
8346,0,0,0,0,0
31987,0,0,0,0,0
33653,0,0,0,0,0
9634,0,0,0,0,0
98268,0,0,0,0,0
110611,0,0,0,0,0
53653,0,0,0,0,0
49285,0,0,0,0,0
70171,0,0,0,0,0
109733,0,0,0,0,0
60448,0,0,0,0,0
31183,0,0,0,0,0
19194,0,0,0,0,0
19954,0,0,0,0,0
114337,0,0,0,0,0
39210,0,0,0,0,0
21022,0,0,0,0,0
9816,0,0,0,0,0
51903,0,0,0,0,0
82453,0,0,0,0,0
30756,0,0,0,0,0
35606,4,4,4,0,0
77876,0,0,0,0,0
63379,0,0,0,0,0
102941,0,0,0,0,0
50574,0,0,0,0,0
84550,0,0,0,0,0
91005,0,0,0,0,0
87579,0,0,0,0,0
23486,0,0,0,0,0
11823,0,0,0,0,0
99999,0,0,0,0,0
106636,0,0,0,0,0
71514,0,0,0,0,0
47660,0,0,0,0,0
12718,0,0,0,0,0
51662,0,0,0,0,0
4561,0,0,0,0,0
106215,0,0,0,0,0
37770,0,0,0,0,0
96576,0,0,0,0,0
111585,0,0,0,0,0
89184,0,0,0,0,0
83525,0,0,0,0,0
115515,0,0,0,0,0
104106,0,0,0,0,0
81897,0,0,0,0,0
106668,0,0,0,0,0
98273,0,0,0,0,0
20033,0,0,0,0,0
52267,0,0,0,0,0
82247,0,0,0,0,0
95783,0,0,0,0,0
6692,0,0,0,0,0
18495,0,0,0,0,0
106421,0,0,0,0,0
64004,0,0,0,0,0
70195,0,0,0,0,0
115165,0,0,0,0,0
12382,0,0,0,0,0
52627,0,0,0,0,0
109875,0,0,0,0,0
55559,0,0,0,0,0
37344,0,0,0,0,0
106566,0,0,0,0,0
119593,0,0,0,0,0
114608,0,0,0,0,0
22649,0,0,0,0,0
119186,0,0,0,0,0
84854,0,0,0,0,0
93798,0,0,0,0,0
63441,0,0,0,0,0
41943,0,0,0,0,0
88765,0,0,0,0,0
50824,0,0,0,0,0
109618,0,0,0,0,0
73420,0,0,0,0,0
45452,0,0,0,0,0
74341,0,0,0,0,0
95759,0,0,0,0,0
99445,0,0,0,0,0
14684,0,0,0,0,0
57066,0,0,0,0,0
116959,0,0,0,0,0
55622,0,0,0,0,0
60894,0,0,0,0,0
108443,0,0,0,0,0
108240,0,0,0,0,0
73346,0,0,0,0,0
72316,0,0,0,0,0
16323,0,0,0,0,0
116263,0,0,0,0,0
39037,0,0,0,0,0
111982,0,0,0,0,0
58020,0,0,0,0,0
73554,0,0,0,0,0
19264,0,0,0,0,0
635,0,0,0,0,0
90295,0,0,0,0,0
83892,0,0,0,0,0
97668,0,0,0,0,0
30773,0,0,0,0,0
120138,0,0,0,0,0
5359,0,0,0,0,0
713,0,0,0,0,0
90760,0,0,0,0,0
87864,0,0,0,0,0
2130,0,0,0,0,0
3739,0,0,0,0,0
57904,0,0,0,0,0
34288,0,0,0,0,0
10379,0,0,0,0,0
107615,0,0,0,0,0
107907,0,0,0,0,0
101535,0,0,0,0,0
75410,1,1,1,0,0
59191,0,0,0,0,0
34025,0,0,0,0,0
29676,0,0,0,0,0
77830,0,0,0,0,0
34398,0,0,0,0,0
11634,0,0,0,0,0
38204,0,0,0,0,0
47677,0,0,0,0,0
86004,0,0,0,0,0
60669,0,0,0,0,0
35949,0,0,0,0,0
76878,0,0,0,0,0
70304,0,0,0,0,0
49052,0,0,0,0,0
102856,0,0,0,0,0
116374,0,0,0,0,0
105691,0,0,0,0,0
3221,0,0,0,0,0
114578,0,0,0,0,0
22629,0,0,0,0,0
23933,0,0,0,0,0
91545,0,0,0,0,0
15809,0,0,0,0,0
93763,0,0,0,0,0
107343,2,2,2,0,0
45440,0,0,0,0,0
38150,0,0,0,0,0
64372,0,0,0,0,0
49996,0,0,0,0,0
94160,0,0,0,0,0
50954,0,0,0,0,0
36610,0,0,0,0,0
59847,0,0,0,0,0
78334,0,0,0,0,0
31773,0,0,0,0,0
78605,0,0,0,0,0
71912,0,0,0,0,0
82545,0,0,0,0,0
72164,0,0,0,0,0
114506,0,0,0,0,0
119780,0,0,0,0,0
50917,0,0,0,0,0
104138,0,0,0,0,0
90939,0,0,0,0,0
12673,0,0,0,0,0
25453,0,0,0,0,0
26315,0,0,0,0,0
33581,0,0,0,0,0
7787,0,0,0,0,0
12674,0,0,0,0,0
9172,0,0,0,0,0
93246,0,0,0,0,0
54400,0,0,0,0,0
70655,0,0,0,0,0
113780,0,0,0,0,0
39931,0,0,0,0,0
69709,0,0,0,0,0
37876,0,0,0,0,0
3587,0,0,0,0,0
43184,0,0,0,0,0
48402,0,0,0,0,0
26172,0,0,0,0,0
90546,0,0,0,0,0
26460,0,0,0,0,0
38470,0,0,0,0,0
11356,0,0,0,0,0
106839,0,0,0,0,0
63960,0,0,0,0,0
34463,0,0,0,0,0
24864,0,0,0,0,0
38215,0,0,0,0,0
104058,0,0,0,0,0
40945,0,0,0,0,0
22768,0,0,0,0,0
116109,2,2,2,0,0
58643,0,0,0,0,0
33382,0,0,0,0,0
24685,0,0,0,0,0
12753,0,0,0,0,0
52814,0,0,0,0,0
103966,0,0,0,0,0
5701,0,0,0,0,0
98960,0,0,0,0,0
30411,0,0,0,0,0
8388,0,0,0,0,0
46135,0,0,0,0,0
51595,0,0,0,0,0
15063,0,0,0,0,0
55923,0,0,0,0,0
33644,0,0,0,0,0
79196,0,0,0,0,0
41597,0,0,0,0,0
87798,0,0,0,0,0
61191,0,0,0,0,0
25589,0,0,0,0,0
55827,0,0,0,0,0
38095,0,0,0,0,0
29646,0,0,0,0,0
83215,0,0,0,0,0
17179,0,0,0,0,0
27953,0,0,0,0,0
92515,0,0,0,0,0
21048,0,0,0,0,0
3459,0,0,0,0,0
111215,0,0,0,0,0
27452,0,0,0,0,0
56763,0,0,0,0,0
51169,0,0,0,0,0
108871,0,0,0,0,0
62192,0,0,0,0,0
7993,0,0,0,0,0
89421,0,0,0,0,0
88174,0,0,0,0,0
65358,0,0,0,0,0
86955,0,0,0,0,0
98780,0,0,0,0,0
35297,0,0,0,0,0
53184,0,0,0,0,0
113465,0,0,0,0,0
93136,0,0,0,0,0
35687,0,0,0,0,0
113761,0,0,0,0,0
57554,0,0,0,0,0
59894,0,0,0,0,0
100887,0,0,0,0,0
56234,0,0,0,0,0
42064,0,0,0,0,0
110178,0,0,0,0,0
42513,0,0,0,0,0
115467,0,0,0,0,0
41405,0,0,0,0,0
99573,0,0,0,0,0
52784,0,0,0,0,0
6038,0,0,0,0,0
45103,0,0,0,0,0
117384,0,0,0,0,0
12291,0,0,0,0,0
69086,0,0,0,0,0
71939,1,1,1,0,0
67476,0,0,0,0,0
41616,0,0,0,0,0
25263,0,0,0,0,0
74597,0,0,0,0,0
114340,0,0,0,0,0
59849,0,0,0,0,0
84446,0,0,0,0,0
113896,0,0,0,0,0
23786,0,0,0,0,0
2850,0,0,0,0,0
47897,0,0,0,0,0
42037,0,0,0,0,0
59913,0,0,0,0,0
97704,0,0,0,0,0
66073,0,0,0,0,0
88599,0,0,0,0,0
96093,0,0,0,0,0
15798,0,0,0,0,0
2814,0,0,0,0,0
83329,0,0,0,0,0
82223,0,0,0,0,0
87782,0,0,0,0,0
73726,0,0,0,0,0
44557,0,0,0,0,0
30492,0,0,0,0,0
88470,0,0,0,0,0
33060,0,0,0,0,0
115841,0,0,0,0,0
2181,0,0,0,0,0
84392,0,0,0,0,0
117103,0,0,0,0,0
91174,0,0,0,0,0
110148,0,0,0,0,0
86328,0,0,0,0,0
50311,0,0,0,0,0
69946,0,0,0,0,0
63879,0,0,0,0,0
18354,0,0,0,0,0
83200,0,0,0,0,0
1317,0,0,0,0,0
77867,0,0,0,0,0
32284,0,0,0,0,0
96979,0,0,0,0,0
109154,0,0,0,0,0
1516,0,0,0,0,0
110799,0,0,0,0,0
12550,1,1,1,0,0
62544,0,0,0,0,0
30416,0,0,0,0,0
21261,0,0,0,0,0
31355,0,0,0,0,0
11294,0,0,0,0,0
86101,0,0,0,0,0
103799,0,0,0,0,0
49291,0,0,0,0,0
56959,0,0,0,0,0
27509,0,0,0,0,0
73695,0,0,0,0,0
9313,0,0,0,0,0
86058,0,0,0,0,0
115175,3,3,3,0,0
118656,1,1,1,0,0
9298,0,0,0,0,0
56717,0,0,0,0,0
65640,1,1,1,0,0
49920,0,0,0,0,0
117976,0,0,0,0,0
56897,0,0,0,0,0
27674,0,0,0,0,0
74387,0,0,0,0,0
33724,0,0,0,0,0
26765,0,0,0,0,0
21191,0,0,0,0,0
9045,0,0,0,0,0
8390,0,0,0,0,0
1005,0,0,0,0,0
67796,0,0,0,0,0
68488,0,0,0,0,0
114612,0,0,0,0,0
104454,0,0,0,0,0
2962,1,1,1,0,0
22277,0,0,0,0,0
117682,0,0,0,0,0
84123,0,0,0,0,0
90251,0,0,0,0,0
92016,0,0,0,0,0
25867,0,0,0,0,0
26772,0,0,0,0,0
97265,1,1,1,0,0
108778,0,0,0,0,0
34535,0,0,0,0,0
41756,0,0,0,0,0
26200,0,0,0,0,0
101365,0,0,0,0,0
64679,0,0,0,0,0
12724,0,0,0,0,0
87954,0,0,0,0,0
112586,0,0,0,0,0
69354,0,0,0,0,0
44864,0,0,0,0,0
63980,0,0,0,0,0
81725,0,0,0,0,0
61817,0,0,0,0,0
54089,0,0,0,0,0
14238,0,0,0,0,0
55583,0,0,0,0,0
73185,0,0,0,0,0
51967,0,0,0,0,0
98243,0,0,0,0,0
113398,0,0,0,0,0
1504,0,0,0,0,0
102399,0,0,0,0,0
70912,0,0,0,0,0
108313,0,0,0,0,0
60351,0,0,0,0,0
76522,0,0,0,0,0
111581,0,0,0,0,0
16181,0,0,0,0,0
45997,0,0,0,0,0
71002,0,0,0,0,0
98440,0,0,0,0,0
108676,0,0,0,0,0
41079,0,0,0,0,0
12068,0,0,0,0,0
7913,0,0,0,0,0
61012,0,0,0,0,0
118867,0,0,0,0,0
24861,0,0,0,0,0
88265,0,0,0,0,0
4751,0,0,0,0,0
94878,0,0,0,0,0
57452,0,0,0,0,0
46698,0,0,0,0,0
13535,0,0,0,0,0
41591,0,0,0,0,0
20234,0,0,0,0,0
31648,0,0,0,0,0
11548,0,0,0,0,0
84001,0,0,0,0,0
56458,0,0,0,0,0
103616,0,0,0,0,0
93564,0,0,0,0,0
74820,0,0,0,0,0
6061,0,0,0,0,0
98698,0,0,0,0,0
52591,0,0,0,0,0
28568,0,0,0,0,0
7840,0,0,0,0,0
98562,0,0,0,0,0
18206,0,0,0,0,0
80324,0,0,0,0,0
1647,0,0,0,0,0
117389,0,0,0,0,0
72374,0,0,0,0,0
84735,0,0,0,0,0
62154,0,0,0,0,0
57636,0,0,0,0,0
53673,0,0,0,0,0
40415,0,0,0,0,0
46314,0,0,0,0,0
106069,0,0,0,0,0
91265,0,0,0,0,0
72310,0,0,0,0,0
60150,0,0,0,0,0
2554,0,0,0,0,0
71000,0,0,0,0,0
29752,0,0,0,0,0
117363,0,0,0,0,0
74271,0,0,0,0,0
6813,0,0,0,0,0
12162,0,0,0,0,0
3482,0,0,0,0,0
23886,0,0,0,0,0
20057,0,0,0,0,0
54098,0,0,0,0,0
77324,0,0,0,0,0
120173,0,0,0,0,0
54079,0,0,0,0,0
117288,0,0,0,0,0
25779,0,0,0,0,0
19443,0,0,0,0,0
104440,0,0,0,0,0
12993,4,4,4,0,0
70060,0,0,0,0,0
82445,0,0,0,0,0
93336,0,0,0,0,0
115782,0,0,0,0,0
2328,0,0,0,0,0
91019,0,0,0,0,0
84438,0,0,0,0,0
47844,0,0,0,0,0
12492,0,0,0,0,0
98922,0,0,0,0,0
39778,0,0,0,0,0
70434,0,0,0,0,0
38518,0,0,0,0,0
117554,0,0,0,0,0
72882,0,0,0,0,0
59588,0,0,0,0,0
37932,1,1,1,0,0
114802,0,0,0,0,0
10766,0,0,0,0,0
116262,0,0,0,0,0
70993,0,0,0,0,0
29116,0,0,0,0,0
102125,0,0,0,0,0
30569,0,0,0,0,0
12816,5,5,5,0,0
22406,0,0,0,0,0
109886,0,0,0,0,0
77919,0,0,0,0,0
2359,0,0,0,0,0
88736,0,0,0,0,0
87181,0,0,0,0,0
81223,0,0,0,0,0
11158,0,0,0,0,0
24698,0,0,0,0,0
98559,0,0,0,0,0
103606,0,0,0,0,0
6474,0,0,0,0,0
104796,0,0,0,0,0
7742,0,0,0,0,0
97518,0,0,0,0,0
74801,0,0,0,0,0
43383,0,0,0,0,0
61874,0,0,0,0,0
40840,0,0,0,0,0
119406,0,0,0,0,0
36154,0,0,0,0,0
113133,0,0,0,0,0
41111,0,0,0,0,0
36206,0,0,0,0,0
66342,0,0,0,0,0
16182,0,0,0,0,0
17170,0,0,0,0,0
64012,0,0,0,0,0
82714,0,0,0,0,0
118720,0,0,0,0,0
62640,0,0,0,0,0
114908,0,0,0,0,0
5524,0,0,0,0,0
117657,0,0,0,0,0
60551,0,0,0,0,0
79044,0,0,0,0,0
46257,0,0,0,0,0
47723,0,0,0,0,0
104911,0,0,0,0,0
16901,0,0,0,0,0
32618,0,0,0,0,0
96889,0,0,0,0,0
46622,0,0,0,0,0
66893,0,0,0,0,0
17618,0,0,0,0,0
6433,0,0,0,0,0
65970,0,0,0,0,0
90677,0,0,0,0,0
28387,0,0,0,0,0
46043,0,0,0,0,0
47001,0,0,0,0,0
32374,0,0,0,0,0
21585,0,0,0,0,0
101076,0,0,0,0,0
66080,0,0,0,0,0
82966,0,0,0,0,0
82494,0,0,0,0,0
48913,0,0,0,0,0
82103,0,0,0,0,0
82036,0,0,0,0,0
62971,0,0,0,0,0
50002,0,0,0,0,0
52,0,0,0,0,0
15475,0,0,0,0,0
57453,0,0,0,0,0
107744,0,0,0,0,0
43287,0,0,0,0,0
41623,0,0,0,0,0
32172,0,0,0,0,0
83781,0,0,0,0,0
69737,0,0,0,0,0
24521,0,0,0,0,0
68796,0,0,0,0,0
20791,0,0,0,0,0
23015,0,0,0,0,0
27092,0,0,0,0,0
33157,0,0,0,0,0
46677,0,0,0,0,0
59092,0,0,0,0,0
26860,0,0,0,0,0
39313,0,0,0,0,0
58779,0,0,0,0,0
117011,0,0,0,0,0
104719,0,0,0,0,0
55676,0,0,0,0,0
61333,0,0,0,0,0
101738,0,0,0,0,0
58411,0,0,0,0,0
52472,0,0,0,0,0
88982,0,0,0,0,0
42862,0,0,0,0,0
47682,0,0,0,0,0
13587,0,0,0,0,0
40506,0,0,0,0,0
12779,0,0,0,0,0
31176,0,0,0,0,0
66485,1,1,1,0,0
18997,0,0,0,0,0
89258,0,0,0,0,0
81611,0,0,0,0,0
23980,0,0,0,0,0
28783,0,0,0,0,0
3595,0,0,0,0,0
17703,0,0,0,0,0
117202,0,0,0,0,0
32967,0,0,0,0,0
78981,0,0,0,0,0
59832,0,0,0,0,0
63274,0,0,0,0,0
78585,0,0,0,0,0
24094,0,0,0,0,0
63821,1,1,1,0,0
119433,0,0,0,0,0
2786,1,1,1,0,0
118318,0,0,0,0,0
63335,0,0,0,0,0
71679,0,0,0,0,0
60668,0,0,0,0,0
49266,0,0,0,0,0
47618,0,0,0,0,0
76962,0,0,0,0,0
100603,0,0,0,0,0
70019,0,0,0,0,0
34078,0,0,0,0,0
46171,0,0,0,0,0
61190,0,0,0,0,0
107912,0,0,0,0,0
39636,0,0,0,0,0
17245,0,0,0,0,0
94774,0,0,0,0,0
54367,0,0,0,0,0
106051,0,0,0,0,0
112710,0,0,0,0,0
76465,0,0,0,0,0
43989,0,0,0,0,0
54023,0,0,0,0,0
63479,0,0,0,0,0
46865,0,0,0,0,0
30424,0,0,0,0,0
26569,0,0,0,0,0
52436,0,0,0,0,0
79142,0,0,0,0,0
27323,0,0,0,0,0
21932,6,6,6,0,0
19255,0,0,0,0,0
16535,0,0,0,0,0
114469,1,1,1,0,0
108043,0,0,0,0,0
115705,0,0,0,0,0
98898,0,0,0,0,0
97754,0,0,0,0,0
65,0,0,0,0,0
41953,0,0,0,0,0
26,0,0,0,0,0
11128,0,0,0,0,0
33707,0,0,0,0,0
110940,0,0,0,0,0
67653,0,0,0,0,0
75166,0,0,0,0,0
68305,0,0,0,0,0
78742,0,0,0,0,0
28207,0,0,0,0,0
57067,0,0,0,0,0
33527,0,0,0,0,0
80678,0,0,0,0,0
30689,0,0,0,0,0
69252,0,0,0,0,0
71641,0,0,0,0,0
39934,0,0,0,0,0
76606,0,0,0,0,0
74395,0,0,0,0,0
101354,0,0,0,0,0
87089,0,0,0,0,0
31732,0,0,0,0,0
81155,0,0,0,0,0
120156,0,0,0,0,0
44736,0,0,0,0,0
78698,0,0,0,0,0
68931,0,0,0,0,0
11512,0,0,0,0,0
109859,0,0,0,0,0
120251,0,0,0,0,0
111619,0,0,0,0,0
67977,0,0,0,0,0
17995,0,0,0,0,0
100797,0,0,0,0,0
95285,0,0,0,0,0
103133,0,0,0,0,0
45227,0,0,0,0,0
60288,0,0,0,0,0
37882,0,0,0,0,0
415,0,0,0,0,0
76594,0,0,0,0,0
107065,0,0,0,0,0
32038,0,0,0,0,0
31886,0,0,0,0,0
119942,0,0,0,0,0
5439,0,0,0,0,0
92805,0,0,0,0,0
107464,0,0,0,0,0
38063,0,0,0,0,0
99352,0,0,0,0,0
16260,0,0,0,0,0
41974,0,0,0,0,0
37672,0,0,0,0,0
8235,0,0,0,0,0
77886,0,0,0,0,0
11484,0,0,0,0,0
5954,4,4,4,0,0
77045,0,0,0,0,0
105316,0,0,0,0,0
38099,0,0,0,0,0
34489,0,0,0,0,0
103797,0,0,0,0,0
50111,0,0,0,0,0
88138,0,0,0,0,0
16150,0,0,0,0,0
77328,0,0,0,0,0
86069,0,0,0,0,0
38974,0,0,0,0,0
4761,0,0,0,0,0
64931,0,0,0,0,0
60148,0,0,0,0,0
17109,0,0,0,0,0
112709,0,0,0,0,0
76127,0,0,0,0,0
95773,0,0,0,0,0
116285,0,0,0,0,0
87981,0,0,0,0,0
69823,0,0,0,0,0
29595,0,0,0,0,0
96787,0,0,0,0,0
243,0,0,0,0,0
87409,0,0,0,0,0
51754,0,0,0,0,0
71505,0,0,0,0,0
38315,0,0,0,0,0
68397,0,0,0,0,0
29120,0,0,0,0,0
7886,0,0,0,0,0
117420,0,0,0,0,0
50476,0,0,0,0,0
52510,0,0,0,0,0
101485,0,0,0,0,0
112566,0,0,0,0,0
24843,0,0,0,0,0
22139,0,0,0,0,0
1057,0,0,0,0,0
44486,0,0,0,0,0
118642,0,0,0,0,0
60008,0,0,0,0,0
19855,0,0,0,0,0
39091,0,0,0,0,0
38199,0,0,0,0,0
115882,0,0,0,0,0
82094,0,0,0,0,0
87800,0,0,0,0,0
102522,0,0,0,0,0
109609,1,1,1,0,0
11607,0,0,0,0,0
56734,0,0,0,0,0
81276,0,0,0,0,0
37755,0,0,0,0,0
25518,0,0,0,0,0
10166,0,0,0,0,0
23919,0,0,0,0,0
13401,0,0,0,0,0
23280,0,0,0,0,0
13041,0,0,0,0,0
92736,0,0,0,0,0
76452,0,0,0,0,0
96853,0,0,0,0,0
1503,0,0,0,0,0
106731,0,0,0,0,0
11996,0,0,0,0,0
411,0,0,0,0,0
21015,0,0,0,0,0
20616,0,0,0,0,0
45455,0,0,0,0,0
92509,0,0,0,0,0
95367,0,0,0,0,0
60478,0,0,0,0,0
54558,0,0,0,0,0
43113,0,0,0,0,0
99727,0,0,0,0,0
100119,0,0,0,0,0
73896,0,0,0,0,0
73437,0,0,0,0,0
12948,0,0,0,0,0
109103,0,0,0,0,0
39957,0,0,0,0,0
45845,0,0,0,0,0
103504,0,0,0,0,0
99988,0,0,0,0,0
74129,0,0,0,0,0
21177,0,0,0,0,0
116996,0,0,0,0,0
5709,4,4,4,0,0
66489,0,0,0,0,0
20502,0,0,0,0,0
9961,0,0,0,0,0
83392,0,0,0,0,0
116881,0,0,0,0,0
62878,0,0,0,0,0
4141,0,0,0,0,0
79203,0,0,0,0,0
56916,0,0,0,0,0
26579,0,0,0,0,0
57581,0,0,0,0,0
99605,0,0,0,0,0
111052,0,0,0,0,0
77828,0,0,0,0,0
49172,0,0,0,0,0
87428,0,0,0,0,0
80757,0,0,0,0,0
21806,0,0,0,0,0
85623,0,0,0,0,0
80005,0,0,0,0,0
89770,0,0,0,0,0
49943,0,0,0,0,0
118100,0,0,0,0,0
109494,0,0,0,0,0
87182,0,0,0,0,0
85982,0,0,0,0,0
99556,0,0,0,0,0
48971,0,0,0,0,0
65320,0,0,0,0,0
44114,0,0,0,0,0
55290,0,0,0,0,0
64905,0,0,0,0,0
2171,0,0,0,0,0
118773,0,0,0,0,0
8050,0,0,0,0,0
87901,0,0,0,0,0
81917,0,0,0,0,0
77580,0,0,0,0,0
95726,0,0,0,0,0
113999,0,0,0,0,0
86875,0,0,0,0,0
78469,0,0,0,0,0
83927,0,0,0,0,0
55417,0,0,0,0,0
116795,0,0,0,0,0
5128,1,1,1,0,0
82049,0,0,0,0,0
21956,0,0,0,0,0
34530,0,0,0,0,0
18936,0,0,0,0,0
61224,0,0,0,0,0
107147,0,0,0,0,0
93333,0,0,0,0,0
4545,0,0,0,0,0
51706,0,0,0,0,0
13797,0,0,0,0,0
79053,0,0,0,0,0
8715,0,0,0,0,0
56923,0,0,0,0,0
82419,0,0,0,0,0
30502,0,0,0,0,0
71162,0,0,0,0,0
26471,0,0,0,0,0
102321,0,0,0,0,0
96449,0,0,0,0,0
108906,0,0,0,0,0
90336,0,0,0,0,0
26034,0,0,0,0,0
69233,0,0,0,0,0
102389,0,0,0,0,0
67576,0,0,0,0,0
23168,0,0,0,0,0
112307,0,0,0,0,0
23293,0,0,0,0,0
100402,0,0,0,0,0
72058,0,0,0,0,0
86008,0,0,0,0,0
108344,0,0,0,0,0
16766,0,0,0,0,0
84408,0,0,0,0,0
76934,0,0,0,0,0
6693,0,0,0,0,0
101355,0,0,0,0,0
96657,0,0,0,0,0
37985,0,0,0,0,0
47302,0,0,0,0,0
82255,0,0,0,0,0
71361,0,0,0,0,0
105109,0,0,0,0,0
9673,0,0,0,0,0
92656,0,0,0,0,0
75676,0,0,0,0,0
107349,0,0,0,0,0
24185,0,0,0,0,0
108777,0,0,0,0,0
107339,0,0,0,0,0
115028,0,0,0,0,0
48190,0,0,0,0,0
115254,0,0,0,0,0
58361,0,0,0,0,0
73548,0,0,0,0,0
86664,0,0,0,0,0
29746,0,0,0,0,0
59023,0,0,0,0,0
56723,0,0,0,0,0
3921,0,0,0,0,0
98558,0,0,0,0,0
13175,0,0,0,0,0
19575,0,0,0,0,0
9114,0,0,0,0,0
82245,0,0,0,0,0
100595,0,0,0,0,0
117414,0,0,0,0,0
47816,0,0,0,0,0
104690,0,0,0,0,0
83935,0,0,0,0,0
51868,0,0,0,0,0
46472,0,0,0,0,0
70672,0,0,0,0,0
114063,0,0,0,0,0
67633,0,0,0,0,0
113827,0,0,0,0,0
9219,0,0,0,0,0
962,0,0,0,0,0
47060,0,0,0,0,0
92468,0,0,0,0,0
13518,0,0,0,0,0
27675,0,0,0,0,0
90479,0,0,0,0,0
94041,0,0,0,0,0
25897,0,0,0,0,0
31069,0,0,0,0,0
111507,0,0,0,0,0
117840,0,0,0,0,0
115216,0,0,0,0,0
93508,0,0,0,0,0
60153,0,0,0,0,0
107030,0,0,0,0,0
35403,0,0,0,0,0
23039,0,0,0,0,0
6387,0,0,0,0,0
119957,0,0,0,0,0
63321,0,0,0,0,0
15985,0,0,0,0,0
78926,0,0,0,0,0
87872,0,0,0,0,0
60964,0,0,0,0,0
38675,0,0,0,0,0
4064,0,0,0,0,0
27877,0,0,0,0,0
77522,0,0,0,0,0
30748,0,0,0,0,0
36108,0,0,0,0,0
54996,0,0,0,0,0
67788,0,0,0,0,0
98818,0,0,0,0,0
112186,0,0,0,0,0
21085,0,0,0,0,0
24006,0,0,0,0,0
118047,0,0,0,0,0
36891,0,0,0,0,0
41215,0,0,0,0,0
18119,0,0,0,0,0
68847,0,0,0,0,0
28136,0,0,0,0,0
57444,0,0,0,0,0
36340,0,0,0,0,0
61000,0,0,0,0,0
57898,0,0,0,0,0
47686,0,0,0,0,0
54632,0,0,0,0,0
7682,0,0,0,0,0
115853,0,0,0,0,0
113558,0,0,0,0,0
14026,0,0,0,0,0
50265,0,0,0,0,0
19669,0,0,0,0,0
4490,0,0,0,0,0
63603,0,0,0,0,0
10687,0,0,0,0,0
101070,0,0,0,0,0
4241,0,0,0,0,0
32888,0,0,0,0,0
84103,0,0,0,0,0
102213,0,0,0,0,0
48414,0,0,0,0,0
108363,0,0,0,0,0
60758,0,0,0,0,0
43751,0,0,0,0,0
102618,0,0,0,0,0
4355,0,0,0,0,0
106702,0,0,0,0,0
36038,0,0,0,0,0
106520,0,0,0,0,0
15660,0,0,0,0,0
43955,0,0,0,0,0
22635,0,0,0,0,0
110037,0,0,0,0,0
110208,0,0,0,0,0
56630,0,0,0,0,0
2727,0,0,0,0,0
109402,0,0,0,0,0
12028,0,0,0,0,0
110308,0,0,0,0,0
88437,0,0,0,0,0
56211,0,0,0,0,0
91128,0,0,0,0,0
50790,0,0,0,0,0
48473,0,0,0,0,0
112958,0,0,0,0,0
77714,0,0,0,0,0
99215,0,0,0,0,0
31451,0,0,0,0,0
78641,0,0,0,0,0
21696,0,0,0,0,0
9174,0,0,0,0,0
14227,0,0,0,0,0
82949,0,0,0,0,0
53733,0,0,0,0,0
1934,0,0,0,0,0
101130,0,0,0,0,0
4640,0,0,0,0,0
1796,0,0,0,0,0
97777,0,0,0,0,0
51665,0,0,0,0,0
39501,0,0,0,0,0
119901,0,0,0,0,0
35041,0,0,0,0,0
52670,0,0,0,0,0
60355,0,0,0,0,0
53109,0,0,0,0,0
72207,0,0,0,0,0
8619,0,0,0,0,0
112770,0,0,0,0,0
1074,0,0,0,0,0
69782,0,0,0,0,0
114499,2,2,2,0,0
108970,0,0,0,0,0
35018,0,0,0,0,0
50670,0,0,0,0,0
20316,0,0,0,0,0
10913,0,0,0,0,0
103745,0,0,0,0,0
82663,0,0,0,0,0
71443,0,0,0,0,0
96027,0,0,0,0,0
19392,0,0,0,0,0
12332,0,0,0,0,0
80559,0,0,0,0,0
81659,0,0,0,0,0
71598,0,0,0,0,0
48073,0,0,0,0,0
52180,0,0,0,0,0
59264,0,0,0,0,0
31409,0,0,0,0,0
104214,0,0,0,0,0
65902,0,0,0,0,0
45839,0,0,0,0,0
12972,0,0,0,0,0
37773,0,0,0,0,0
78795,0,0,0,0,0
24020,0,0,0,0,0
58079,0,0,0,0,0
49964,0,0,0,0,0
92802,0,0,0,0,0
48993,0,0,0,0,0
25661,1,1,1,0,0
11440,0,0,0,0,0
19028,0,0,0,0,0
36441,0,0,0,0,0
35915,0,0,0,0,0
98214,0,0,0,0,0
118763,0,0,0,0,0
105030,0,0,0,0,0
4541,0,0,0,0,0
33287,0,0,0,0,0
47200,0,0,0,0,0
76978,0,0,0,0,0
11811,0,0,0,0,0
3108,0,0,0,0,0
32555,0,0,0,0,0
13263,0,0,0,0,0
86789,0,0,0,0,0
95810,0,0,0,0,0
6113,0,0,0,0,0
11469,0,0,0,0,0
114840,0,0,0,0,0
85308,0,0,0,0,0
65651,0,0,0,0,0
75443,0,0,0,0,0
78939,0,0,0,0,0
105890,0,0,0,0,0
3942,0,0,0,0,0
39978,0,0,0,0,0
49551,0,0,0,0,0
11177,0,0,0,0,0
50807,0,0,0,0,0
62706,0,0,0,0,0
92180,0,0,0,0,0
7338,0,0,0,0,0
95561,0,0,0,0,0
18789,3,3,3,0,0
74047,0,0,0,0,0
112720,0,0,0,0,0
99870,0,0,0,0,0
9640,0,0,0,0,0
10816,0,0,0,0,0
95474,0,0,0,0,0
67329,0,0,0,0,0
54190,0,0,0,0,0
5976,0,0,0,0,0
98089,0,0,0,0,0
88159,0,0,0,0,0
59681,0,0,0,0,0
27477,0,0,0,0,0
53814,0,0,0,0,0
55432,0,0,0,0,0
92316,0,0,0,0,0
85761,0,0,0,0,0
61511,0,0,0,0,0
81138,0,0,0,0,0
84641,0,0,0,0,0
9343,0,0,0,0,0
117786,0,0,0,0,0
40545,0,0,0,0,0
5029,0,0,0,0,0
94383,0,0,0,0,0
117681,0,0,0,0,0
70270,0,0,0,0,0
29734,0,0,0,0,0
59615,0,0,0,0,0
12400,0,0,0,0,0
3261,0,0,0,0,0
107515,0,0,0,0,0
74297,0,0,0,0,0
97679,0,0,0,0,0
116495,0,0,0,0,0
91632,0,0,0,0,0
81443,0,0,0,0,0
114271,0,0,0,0,0
19644,0,0,0,0,0
17217,0,0,0,0,0
54426,0,0,0,0,0
16760,0,0,0,0,0
105767,0,0,0,0,0
26013,0,0,0,0,0
111702,0,0,0,0,0
10835,0,0,0,0,0
59323,0,0,0,0,0
62181,0,0,0,0,0
65179,0,0,0,0,0
23630,0,0,0,0,0
59449,0,0,0,0,0
49429,0,0,0,0,0
104212,0,0,0,0,0
45043,0,0,0,0,0
97396,0,0,0,0,0
108761,0,0,0,0,0
49695,0,0,0,0,0
70173,0,0,0,0,0
44365,0,0,0,0,0
87494,0,0,0,0,0
62420,0,0,0,0,0
84228,0,0,0,0,0
64922,0,0,0,0,0
96387,0,0,0,0,0
34597,0,0,0,0,0
12952,0,0,0,0,0
53288,0,0,0,0,0
28084,0,0,0,0,0
80146,0,0,0,0,0
58044,0,0,0,0,0
77382,0,0,0,0,0
102215,0,0,0,0,0
32872,0,0,0,0,0
87146,1,1,1,0,0
109695,1,1,1,0,0
50630,0,0,0,0,0
45896,0,0,0,0,0
73058,0,0,0,0,0
118881,0,0,0,0,0
96677,0,0,0,0,0
54115,0,0,0,0,0
59136,0,0,0,0,0
111825,0,0,0,0,0
84386,0,0,0,0,0
40780,0,0,0,0,0
83203,0,0,0,0,0
48067,0,0,0,0,0
62534,0,0,0,0,0
76007,0,0,0,0,0
20792,0,0,0,0,0
33758,0,0,0,0,0
35249,0,0,0,0,0
10698,0,0,0,0,0
98350,0,0,0,0,0
113846,0,0,0,0,0
20394,0,0,0,0,0
90107,0,0,0,0,0
80902,0,0,0,0,0
70800,0,0,0,0,0
39743,0,0,0,0,0
93003,0,0,0,0,0
25951,0,0,0,0,0
88830,0,0,0,0,0
40611,0,0,0,0,0
55493,0,0,0,0,0
116540,5,5,5,0,0
62381,0,0,0,0,0
82121,0,0,0,0,0
107225,0,0,0,0,0
36492,0,0,0,0,0
89490,0,0,0,0,0
41982,0,0,0,0,0
54503,0,0,0,0,0
119041,0,0,0,0,0
61580,0,0,0,0,0
119002,0,0,0,0,0
15459,0,0,0,0,0
10758,0,0,0,0,0
115748,0,0,0,0,0
23101,0,0,0,0,0
21040,0,0,0,0,0
76322,0,0,0,0,0
118097,0,0,0,0,0
114905,0,0,0,0,0
24845,0,0,0,0,0
98641,0,0,0,0,0
60326,0,0,0,0,0
27913,0,0,0,0,0
49316,0,0,0,0,0
32754,0,0,0,0,0
88301,0,0,0,0,0
16588,0,0,0,0,0
25543,0,0,0,0,0
26252,0,0,0,0,0
85012,0,0,0,0,0
39274,0,0,0,0,0
13849,0,0,0,0,0
85383,0,0,0,0,0
42017,0,0,0,0,0
39270,0,0,0,0,0
53119,0,0,0,0,0
13592,0,0,0,0,0
80952,0,0,0,0,0
104987,0,0,0,0,0
90932,0,0,0,0,0
50431,0,0,0,0,0
32212,0,0,0,0,0
114540,0,0,0,0,0
12020,0,0,0,0,0
31465,0,0,0,0,0
114708,0,0,0,0,0
82954,0,0,0,0,0
90841,0,0,0,0,0
102955,0,0,0,0,0
101843,0,0,0,0,0
117826,1,1,1,0,0
40672,0,0,0,0,0
25842,0,0,0,0,0
94731,0,0,0,0,0
61975,0,0,0,0,0
44814,0,0,0,0,0
95728,0,0,0,0,0
109910,0,0,0,0,0
12919,0,0,0,0,0
59356,0,0,0,0,0
9881,0,0,0,0,0
33379,0,0,0,0,0
106086,0,0,0,0,0
108869,0,0,0,0,0
11765,0,0,0,0,0
9971,0,0,0,0,0
21971,0,0,0,0,0
66540,0,0,0,0,0
79654,0,0,0,0,0
58119,0,0,0,0,0
94815,0,0,0,0,0
42007,0,0,0,0,0
41258,0,0,0,0,0
118245,0,0,0,0,0
100445,0,0,0,0,0
14786,0,0,0,0,0
112336,0,0,0,0,0
87902,0,0,0,0,0
100759,0,0,0,0,0
80777,0,0,0,0,0
38119,0,0,0,0,0
4162,0,0,0,0,0
77570,0,0,0,0,0
22873,0,0,0,0,0
51337,0,0,0,0,0
49173,0,0,0,0,0
103899,0,0,0,0,0
43954,0,0,0,0,0
96764,0,0,0,0,0
98432,0,0,0,0,0
31257,0,0,0,0,0
69671,0,0,0,0,0
26682,0,0,0,0,0
35820,0,0,0,0,0
866,0,0,0,0,0
54556,0,0,0,0,0
31607,0,0,0,0,0
60067,0,0,0,0,0
30366,0,0,0,0,0
108601,0,0,0,0,0
88842,0,0,0,0,0
7368,0,0,0,0,0
46349,0,0,0,0,0
17092,0,0,0,0,0
64812,0,0,0,0,0
17463,0,0,0,0,0
46984,0,0,0,0,0
109482,0,0,0,0,0
60017,0,0,0,0,0
66321,0,0,0,0,0
32693,0,0,0,0,0
21361,0,0,0,0,0
23690,0,0,0,0,0
69591,0,0,0,0,0
68117,0,0,0,0,0
35072,0,0,0,0,0
12987,0,0,0,0,0
18255,0,0,0,0,0
39139,0,0,0,0,0
116116,0,0,0,0,0
95417,0,0,0,0,0
94992,2,2,2,0,0
7346,0,0,0,0,0
96425,0,0,0,0,0
19471,0,0,0,0,0
105709,0,0,0,0,0
42058,0,0,0,0,0
102411,0,0,0,0,0
104002,0,0,0,0,0
25146,0,0,0,0,0
8373,0,0,0,0,0
40676,0,0,0,0,0
112952,0,0,0,0,0
84617,0,0,0,0,0
103231,0,0,0,0,0
33120,0,0,0,0,0
115356,0,0,0,0,0
46186,0,0,0,0,0
100895,0,0,0,0,0
112114,0,0,0,0,0
56559,0,0,0,0,0
106827,0,0,0,0,0
25568,0,0,0,0,0
113157,0,0,0,0,0
91001,0,0,0,0,0
40925,0,0,0,0,0
71707,0,0,0,0,0
5190,0,0,0,0,0
77379,0,0,0,0,0
98442,0,0,0,0,0
105342,0,0,0,0,0
74066,0,0,0,0,0
113532,0,0,0,0,0
41611,0,0,0,0,0
8936,0,0,0,0,0
71015,0,0,0,0,0
40819,0,0,0,0,0
111610,3,3,3,0,0
67195,0,0,0,0,0
56433,0,0,0,0,0
118581,0,0,0,0,0
109510,0,0,0,0,0
24417,0,0,0,0,0
37938,0,0,0,0,0
6543,0,0,0,0,0
12029,1,1,1,0,0
28232,0,0,0,0,0
4305,0,0,0,0,0
64976,0,0,0,0,0
52938,0,0,0,0,0
119935,0,0,0,0,0
6383,0,0,0,0,0
14448,0,0,0,0,0
63068,0,0,0,0,0
16345,0,0,0,0,0
8085,0,0,0,0,0
88186,0,0,0,0,0
11530,0,0,0,0,0
73659,0,0,0,0,0
57641,0,0,0,0,0
17273,0,0,0,0,0
19164,0,0,0,0,0
96713,0,0,0,0,0
17555,0,0,0,0,0
85003,0,0,0,0,0
29680,0,0,0,0,0
68834,0,0,0,0,0
90950,0,0,0,0,0
8634,0,0,0,0,0
106469,0,0,0,0,0
4268,0,0,0,0,0
5116,0,0,0,0,0
24518,0,0,0,0,0
18021,0,0,0,0,0
107821,0,0,0,0,0
58133,0,0,0,0,0
119672,0,0,0,0,0
76994,0,0,0,0,0
110484,0,0,0,0,0
68642,0,0,0,0,0
90264,2,2,2,0,0
27909,0,0,0,0,0
20561,0,0,0,0,0
118280,0,0,0,0,0
95320,0,0,0,0,0
54082,0,0,0,0,0
16276,0,0,0,0,0
33220,0,0,0,0,0
77687,0,0,0,0,0
112806,0,0,0,0,0
3890,0,0,0,0,0
99303,0,0,0,0,0
63640,0,0,0,0,0
31068,0,0,0,0,0
10544,0,0,0,0,0
47557,0,0,0,0,0
60959,0,0,0,0,0
90445,0,0,0,0,0
65395,1,1,1,0,0
97540,0,0,0,0,0
60755,0,0,0,0,0
113703,0,0,0,0,0
45786,0,0,0,0,0
39478,0,0,0,0,0
89880,2,2,2,0,0
83116,0,0,0,0,0
31793,0,0,0,0,0
100497,0,0,0,0,0
44940,0,0,0,0,0
26278,0,0,0,0,0
11521,0,0,0,0,0
85146,0,0,0,0,0
43568,0,0,0,0,0
79727,0,0,0,0,0
28560,0,0,0,0,0
86854,0,0,0,0,0
24695,0,0,0,0,0
26864,0,0,0,0,0
64095,0,0,0,0,0
14347,0,0,0,0,0
94130,0,0,0,0,0
102382,0,0,0,0,0
17987,0,0,0,0,0
84076,0,0,0,0,0
32255,0,0,0,0,0
67999,0,0,0,0,0
70637,0,0,0,0,0
106538,0,0,0,0,0
101668,0,0,0,0,0
114695,0,0,0,0,0
20822,0,0,0,0,0
85358,0,0,0,0,0
119022,0,0,0,0,0
45288,0,0,0,0,0
56179,0,0,0,0,0
22082,0,0,0,0,0
102245,0,0,0,0,0
118009,0,0,0,0,0
102993,0,0,0,0,0
18398,0,0,0,0,0
69993,0,0,0,0,0
103065,0,0,0,0,0
3462,0,0,0,0,0
96495,0,0,0,0,0
78450,2,2,2,0,0
9164,0,0,0,0,0
95385,0,0,0,0,0
14641,0,0,0,0,0
18657,0,0,0,0,0
63064,0,0,0,0,0
58068,0,0,0,0,0
32182,0,0,0,0,0
38927,0,0,0,0,0
53855,0,0,0,0,0
83267,0,0,0,0,0
26922,0,0,0,0,0
74841,0,0,0,0,0
80299,0,0,0,0,0
31996,0,0,0,0,0
36326,0,0,0,0,0
66359,0,0,0,0,0
78839,0,0,0,0,0
26821,0,0,0,0,0
35528,0,0,0,0,0
42638,0,0,0,0,0
28001,0,0,0,0,0
81859,0,0,0,0,0
52571,0,0,0,0,0
2438,0,0,0,0,0
103251,0,0,0,0,0
114483,1,1,1,0,0
70594,0,0,0,0,0
68356,2,2,2,0,0
49907,0,0,0,0,0
103770,0,0,0,0,0
49466,0,0,0,0,0
91518,0,0,0,0,0
65667,0,0,0,0,0
97942,0,0,0,0,0
52041,0,0,0,0,0
54702,0,0,0,0,0
92639,0,0,0,0,0
860,0,0,0,0,0
69097,0,0,0,0,0
58037,0,0,0,0,0
84841,0,0,0,0,0
105599,0,0,0,0,0
17444,0,0,0,0,0
34153,0,0,0,0,0
40012,0,0,0,0,0
109986,0,0,0,0,0
6051,0,0,0,0,0
55139,0,0,0,0,0
69346,0,0,0,0,0
109267,0,0,0,0,0
10390,0,0,0,0,0
84079,0,0,0,0,0
34534,0,0,0,0,0
84880,0,0,0,0,0
83395,0,0,0,0,0
16002,0,0,0,0,0
2946,0,0,0,0,0
9322,0,0,0,0,0
24633,0,0,0,0,0
14463,0,0,0,0,0
1481,0,0,0,0,0
62699,0,0,0,0,0
18032,0,0,0,0,0
112016,0,0,0,0,0
92825,0,0,0,0,0
55176,0,0,0,0,0
55031,0,0,0,0,0
10068,0,0,0,0,0
75510,0,0,0,0,0
16027,0,0,0,0,0
39240,0,0,0,0,0
118417,0,0,0,0,0
36648,0,0,0,0,0
82980,0,0,0,0,0
113493,0,0,0,0,0
35714,0,0,0,0,0
110910,0,0,0,0,0
110590,0,0,0,0,0
7136,0,0,0,0,0
28512,0,0,0,0,0
44449,0,0,0,0,0
35253,0,0,0,0,0
25108,0,0,0,0,0
89165,0,0,0,0,0
103564,0,0,0,0,0
93703,0,0,0,0,0
115420,0,0,0,0,0
117406,0,0,0,0,0
75545,0,0,0,0,0
67860,0,0,0,0,0
61469,0,0,0,0,0
61628,0,0,0,0,0
16737,0,0,0,0,0
35815,0,0,0,0,0
70263,0,0,0,0,0
44521,0,0,0,0,0
63937,0,0,0,0,0
52764,0,0,0,0,0
40724,0,0,0,0,0
35311,0,0,0,0,0
100849,0,0,0,0,0
187,0,0,0,0,0
62143,0,0,0,0,0
110985,0,0,0,0,0
73261,0,0,0,0,0
116989,0,0,0,0,0
58776,0,0,0,0,0
105616,0,0,0,0,0
83535,0,0,0,0,0
57423,0,0,0,0,0
13756,0,0,0,0,0
110203,0,0,0,0,0
118825,0,0,0,0,0
62080,0,0,0,0,0
26739,0,0,0,0,0
76946,0,0,0,0,0
112481,0,0,0,0,0
72194,0,0,0,0,0
66941,0,0,0,0,0
32143,0,0,0,0,0
55822,0,0,0,0,0
27979,0,0,0,0,0
59651,0,0,0,0,0
74113,0,0,0,0,0
37568,0,0,0,0,0
81173,0,0,0,0,0
42871,0,0,0,0,0
32437,0,0,0,0,0
69748,0,0,0,0,0
95901,0,0,0,0,0
95058,0,0,0,0,0
32319,0,0,0,0,0
110247,0,0,0,0,0
38928,0,0,0,0,0
115810,1,1,1,0,0
31862,0,0,0,0,0
11761,0,0,0,0,0
44011,0,0,0,0,0
112379,0,0,0,0,0
13226,0,0,0,0,0
68570,0,0,0,0,0
80097,0,0,0,0,0
6973,0,0,0,0,0
82812,0,0,0,0,0
4405,0,0,0,0,0
55324,0,0,0,0,0
87649,0,0,0,0,0
102351,0,0,0,0,0
6517,0,0,0,0,0
63950,0,0,0,0,0
20650,0,0,0,0,0
71904,0,0,0,0,0
28359,0,0,0,0,0
79566,0,0,0,0,0
48452,0,0,0,0,0
59703,0,0,0,0,0
14056,0,0,0,0,0
76605,0,0,0,0,0
45054,0,0,0,0,0
106245,0,0,0,0,0
36446,0,0,0,0,0
70641,0,0,0,0,0
26436,0,0,0,0,0
69344,0,0,0,0,0
48541,0,0,0,0,0
98364,0,0,0,0,0
96271,0,0,0,0,0
80045,0,0,0,0,0
84455,0,0,0,0,0
21285,0,0,0,0,0
20074,0,0,0,0,0
73176,0,0,0,0,0
38376,0,0,0,0,0
17686,0,0,0,0,0
92604,0,0,0,0,0
82569,0,0,0,0,0
118384,0,0,0,0,0
93297,0,0,0,0,0
3378,0,0,0,0,0
98492,0,0,0,0,0
70242,0,0,0,0,0
105875,0,0,0,0,0
86748,0,0,0,0,0
74224,0,0,0,0,0
12941,0,0,0,0,0
13986,0,0,0,0,0
110384,0,0,0,0,0
113644,0,0,0,0,0
26161,0,0,0,0,0
70978,0,0,0,0,0
90426,0,0,0,0,0
27109,0,0,0,0,0
41869,0,0,0,0,0
65242,0,0,0,0,0
79066,0,0,0,0,0
24285,0,0,0,0,0
10080,0,0,0,0,0
8336,0,0,0,0,0
79773,0,0,0,0,0
20705,0,0,0,0,0
113121,0,0,0,0,0
73153,0,0,0,0,0
22655,0,0,0,0,0
103930,0,0,0,0,0
77142,0,0,0,0,0
72998,0,0,0,0,0
44887,0,0,0,0,0
71066,0,0,0,0,0
109485,0,0,0,0,0
39043,0,0,0,0,0
76069,0,0,0,0,0
95064,0,0,0,0,0
20436,0,0,0,0,0
60359,0,0,0,0,0
94568,0,0,0,0,0
84875,0,0,0,0,0
88841,0,0,0,0,0
61135,0,0,0,0,0
118499,0,0,0,0,0
934,0,0,0,0,0
88245,0,0,0,0,0
64286,0,0,0,0,0
49072,0,0,0,0,0
33093,0,0,0,0,0
50537,0,0,0,0,0
747,0,0,0,0,0
45693,0,0,0,0,0
54167,0,0,0,0,0
90018,0,0,0,0,0
67664,0,0,0,0,0
119278,0,0,0,0,0
107173,0,0,0,0,0
106279,0,0,0,0,0
64681,2,2,2,0,0
93960,3,3,3,0,0
65523,0,0,0,0,0
108139,0,0,0,0,0
74154,0,0,0,0,0
71858,0,0,0,0,0
76031,0,0,0,0,0
81255,0,0,0,0,0
89029,0,0,0,0,0
804,0,0,0,0,0
39693,0,0,0,0,0
20526,0,0,0,0,0
27402,0,0,0,0,0
93083,0,0,0,0,0
71402,0,0,0,0,0
45248,0,0,0,0,0
14882,0,0,0,0,0
14870,0,0,0,0,0
8476,0,0,0,0,0
50513,0,0,0,0,0
57583,0,0,0,0,0
93728,0,0,0,0,0
17117,0,0,0,0,0
49564,0,0,0,0,0
110375,0,0,0,0,0
15560,0,0,0,0,0
56853,0,0,0,0,0
13390,0,0,0,0,0
118648,0,0,0,0,0
33388,0,0,0,0,0
8771,0,0,0,0,0
32438,0,0,0,0,0
58144,0,0,0,0,0
99025,0,0,0,0,0
2937,0,0,0,0,0
46739,0,0,0,0,0
72231,0,0,0,0,0
119749,0,0,0,0,0
78880,0,0,0,0,0
89759,0,0,0,0,0
116872,2,2,2,0,0
65676,0,0,0,0,0
74961,0,0,0,0,0
45625,0,0,0,0,0
23699,0,0,0,0,0
116680,0,0,0,0,0
60166,0,0,0,0,0
118912,0,0,0,0,0
91514,0,0,0,0,0
93145,0,0,0,0,0
12064,0,0,0,0,0
54496,0,0,0,0,0
49868,0,0,0,0,0
23331,0,0,0,0,0
44323,0,0,0,0,0
71062,0,0,0,0,0
80973,0,0,0,0,0
28185,0,0,0,0,0
48025,0,0,0,0,0
6196,0,0,0,0,0
116186,0,0,0,0,0
73233,0,0,0,0,0
11207,0,0,0,0,0
113859,0,0,0,0,0
64218,1,1,1,0,0
196,0,0,0,0,0
102093,0,0,0,0,0
73251,0,0,0,0,0
91140,0,0,0,0,0
10461,0,0,0,0,0
43338,0,0,0,0,0
93862,0,0,0,0,0
63747,0,0,0,0,0
63731,0,0,0,0,0
65915,0,0,0,0,0
83405,0,0,0,0,0
80535,0,0,0,0,0
36751,0,0,0,0,0
52258,0,0,0,0,0
6122,0,0,0,0,0
108632,0,0,0,0,0
94497,0,0,0,0,0
21547,0,0,0,0,0
109872,0,0,0,0,0
59662,0,0,0,0,0
3265,0,0,0,0,0
12774,0,0,0,0,0
78039,0,0,0,0,0
73906,0,0,0,0,0
107804,0,0,0,0,0
60238,0,0,0,0,0
40616,0,0,0,0,0
22325,0,0,0,0,0
83576,0,0,0,0,0
7371,0,0,0,0,0
111834,0,0,0,0,0
35984,0,0,0,0,0
104275,0,0,0,0,0
98272,0,0,0,0,0
16379,0,0,0,0,0
117901,0,0,0,0,0
32737,0,0,0,0,0
42123,0,0,0,0,0
24775,0,0,0,0,0
36312,0,0,0,0,0
78341,0,0,0,0,0
56387,0,0,0,0,0
7441,0,0,0,0,0
87577,0,0,0,0,0
48007,0,0,0,0,0
83909,0,0,0,0,0
91106,0,0,0,0,0
84799,0,0,0,0,0
94919,0,0,0,0,0
17261,0,0,0,0,0
82838,0,0,0,0,0
33225,0,0,0,0,0
34902,0,0,0,0,0
113254,0,0,0,0,0
117229,0,0,0,0,0
51529,0,0,0,0,0
64504,0,0,0,0,0
2115,0,0,0,0,0
115194,0,0,0,0,0
71103,0,0,0,0,0
82153,0,0,0,0,0
61422,0,0,0,0,0
15307,0,0,0,0,0
54629,0,0,0,0,0
101071,0,0,0,0,0
107166,0,0,0,0,0
62820,0,0,0,0,0
13386,0,0,0,0,0
100715,0,0,0,0,0
3297,0,0,0,0,0
98633,0,0,0,0,0
37776,0,0,0,0,0
55091,0,0,0,0,0
21689,1,1,1,0,0
93046,0,0,0,0,0
56797,0,0,0,0,0
105125,0,0,0,0,0
96184,0,0,0,0,0
9929,0,0,0,0,0
53470,0,0,0,0,0
116653,0,0,0,0,0
30662,0,0,0,0,0
103758,0,0,0,0,0
25309,0,0,0,0,0
77771,0,0,0,0,0
95618,0,0,0,0,0
52951,0,0,0,0,0
112031,0,0,0,0,0
47536,0,0,0,0,0
19741,0,0,0,0,0
30553,0,0,0,0,0
12420,0,0,0,0,0
55639,0,0,0,0,0
101479,0,0,0,0,0
2079,0,0,0,0,0
74464,0,0,0,0,0
105375,0,0,0,0,0
55850,0,0,0,0,0
46351,0,0,0,0,0
12845,0,0,0,0,0
114045,0,0,0,0,0
15192,0,0,0,0,0
21878,0,0,0,0,0
51631,0,0,0,0,0
68962,0,0,0,0,0
11478,0,0,0,0,0
13399,0,0,0,0,0
43055,0,0,0,0,0
59559,0,0,0,0,0
22836,0,0,0,0,0
84182,0,0,0,0,0
33200,0,0,0,0,0
83109,0,0,0,0,0
21253,0,0,0,0,0
116038,1,1,1,0,0
112217,0,0,0,0,0
4980,0,0,0,0,0
18219,0,0,0,0,0
6945,0,0,0,0,0
102904,0,0,0,0,0
52815,0,0,0,0,0
80627,0,0,0,0,0
85054,0,0,0,0,0
59658,0,0,0,0,0
19442,0,0,0,0,0
56663,0,0,0,0,0
5112,0,0,0,0,0
68415,0,0,0,0,0
91762,0,0,0,0,0
66219,0,0,0,0,0
64377,0,0,0,0,0
47678,0,0,0,0,0
106943,0,0,0,0,0
21677,0,0,0,0,0
41207,0,0,0,0,0
14237,0,0,0,0,0
53590,0,0,0,0,0
24089,0,0,0,0,0
58425,0,0,0,0,0
34540,0,0,0,0,0
84222,0,0,0,0,0
36963,0,0,0,0,0
85489,0,0,0,0,0
103042,0,0,0,0,0
116818,0,0,0,0,0
65497,0,0,0,0,0
18459,0,0,0,0,0
114854,0,0,0,0,0
29936,0,0,0,0,0
36771,0,0,0,0,0
90361,0,0,0,0,0
16099,0,0,0,0,0
105121,0,0,0,0,0
51781,0,0,0,0,0
115843,0,0,0,0,0
78278,10,10,10,0,0
32594,0,0,0,0,0
3563,0,0,0,0,0
58522,0,0,0,0,0
49298,0,0,0,0,0
88139,0,0,0,0,0
80150,0,0,0,0,0
112947,0,0,0,0,0
6570,0,0,0,0,0
328,0,0,0,0,0
36145,0,0,0,0,0
51907,0,0,0,0,0
25519,0,0,0,0,0
83155,0,0,0,0,0
85762,0,0,0,0,0
21211,0,0,0,0,0
18660,0,0,0,0,0
15306,0,0,0,0,0
97995,0,0,0,0,0
116180,0,0,0,0,0
91199,0,0,0,0,0
56699,0,0,0,0,0
30299,0,0,0,0,0
18037,0,0,0,0,0
10226,0,0,0,0,0
33308,0,0,0,0,0
4952,0,0,0,0,0
66929,0,0,0,0,0
9293,0,0,0,0,0
114776,0,0,0,0,0
48129,0,0,0,0,0
103234,0,0,0,0,0
59680,0,0,0,0,0
110563,0,0,0,0,0
7259,0,0,0,0,0
81846,0,0,0,0,0
85396,0,0,0,0,0
13571,0,0,0,0,0
20979,0,0,0,0,0
27887,0,0,0,0,0
46697,0,0,0,0,0
85965,0,0,0,0,0
26998,0,0,0,0,0
6149,0,0,0,0,0
53311,0,0,0,0,0
3049,0,0,0,0,0
103437,0,0,0,0,0
46720,0,0,0,0,0
35313,0,0,0,0,0
81989,0,0,0,0,0
104181,0,0,0,0,0
44379,0,0,0,0,0
9370,0,0,0,0,0
39234,0,0,0,0,0
7817,0,0,0,0,0
76202,0,0,0,0,0
55285,0,0,0,0,0
57813,0,0,0,0,0
68224,0,0,0,0,0
10363,0,0,0,0,0
118932,0,0,0,0,0
56397,0,0,0,0,0
57567,0,0,0,0,0
8141,0,0,0,0,0
117568,0,0,0,0,0
35226,0,0,0,0,0
23574,0,0,0,0,0
16155,0,0,0,0,0
119686,0,0,0,0,0
32,0,0,0,0,0
74821,0,0,0,0,0
87861,0,0,0,0,0
94900,0,0,0,0,0
51862,0,0,0,0,0
44188,0,0,0,0,0
102420,0,0,0,0,0
68739,0,0,0,0,0
110581,0,0,0,0,0
94004,0,0,0,0,0
29431,0,0,0,0,0
24709,0,0,0,0,0
117383,0,0,0,0,0
96502,0,0,0,0,0
30378,0,0,0,0,0
59244,0,0,0,0,0
80458,0,0,0,0,0
33087,0,0,0,0,0
118193,0,0,0,0,0
32420,0,0,0,0,0
10995,0,0,0,0,0
62234,0,0,0,0,0
44652,0,0,0,0,0
51079,0,0,0,0,0
19424,0,0,0,0,0
104397,0,0,0,0,0
38167,0,0,0,0,0
6853,0,0,0,0,0
52936,0,0,0,0,0
86304,0,0,0,0,0
12379,0,0,0,0,0
94649,0,0,0,0,0
58934,0,0,0,0,0
100564,0,0,0,0,0
22343,0,0,0,0,0
23631,0,0,0,0,0
95274,0,0,0,0,0
29881,0,0,0,0,0
84401,0,0,0,0,0
71194,0,0,0,0,0
8049,0,0,0,0,0
103341,0,0,0,0,0
95691,0,0,0,0,0
65813,0,0,0,0,0
40223,0,0,0,0,0
48966,0,0,0,0,0
67258,0,0,0,0,0
78781,0,0,0,0,0
55649,0,0,0,0,0
105447,0,0,0,0,0
34868,0,0,0,0,0
60422,0,0,0,0,0
103791,1,1,1,0,0
26053,0,0,0,0,0
12210,0,0,0,0,0
16128,0,0,0,0,0
102679,0,0,0,0,0
77056,0,0,0,0,0
45838,0,0,0,0,0
27663,0,0,0,0,0
63390,0,0,0,0,0
57697,0,0,0,0,0
53495,0,0,0,0,0
53223,0,0,0,0,0
97019,0,0,0,0,0
45995,0,0,0,0,0
107940,0,0,0,0,0
79557,0,0,0,0,0
103750,0,0,0,0,0
21592,0,0,0,0,0
106231,0,0,0,0,0
58063,0,0,0,0,0
73590,0,0,0,0,0
110051,0,0,0,0,0
57112,0,0,0,0,0
1560,0,0,0,0,0
99532,0,0,0,0,0
102437,0,0,0,0,0
115376,0,0,0,0,0
64660,0,0,0,0,0
85755,0,0,0,0,0
26962,0,0,0,0,0
35246,0,0,0,0,0
54994,0,0,0,0,0
57888,0,0,0,0,0
68949,0,0,0,0,0
57367,0,0,0,0,0
27187,0,0,0,0,0
44097,0,0,0,0,0
114012,0,0,0,0,0
104704,0,0,0,0,0
56788,0,0,0,0,0
100339,0,0,0,0,0
36485,0,0,0,0,0
76963,0,0,0,0,0
4347,0,0,0,0,0
76457,0,0,0,0,0
32262,0,0,0,0,0
13410,0,0,0,0,0
42006,0,0,0,0,0
107689,0,0,0,0,0
57025,0,0,0,0,0
75141,0,0,0,0,0
119052,0,0,0,0,0
97003,0,0,0,0,0
33676,0,0,0,0,0
97570,0,0,0,0,0
17483,0,0,0,0,0
114982,0,0,0,0,0
67319,0,0,0,0,0
50019,0,0,0,0,0
33868,0,0,0,0,0
86627,0,0,0,0,0
46154,0,0,0,0,0
90112,1,1,1,0,0
56441,0,0,0,0,0
35231,0,0,0,0,0
100365,2,2,2,0,0
27233,0,0,0,0,0
97719,0,0,0,0,0
73927,0,0,0,0,0
42135,0,0,0,0,0
115938,0,0,0,0,0
82305,0,0,0,0,0
107440,0,0,0,0,0
9006,0,0,0,0,0
4738,0,0,0,0,0
107443,0,0,0,0,0
61789,0,0,0,0,0
70806,0,0,0,0,0
13487,0,0,0,0,0
114389,0,0,0,0,0
71287,0,0,0,0,0
114273,0,0,0,0,0
47393,0,0,0,0,0
37543,0,0,0,0,0
50492,0,0,0,0,0
5717,0,0,0,0,0
65556,0,0,0,0,0
82880,0,0,0,0,0
18413,0,0,0,0,0
36037,0,0,0,0,0
99346,0,0,0,0,0
94817,0,0,0,0,0
25299,0,0,0,0,0
12436,0,0,0,0,0
89458,0,0,0,0,0
36241,0,0,0,0,0
103733,0,0,0,0,0
52173,0,0,0,0,0
55785,0,0,0,0,0
46398,0,0,0,0,0
33265,0,0,0,0,0
98201,0,0,0,0,0
78597,0,0,0,0,0
62362,0,0,0,0,0
24867,0,0,0,0,0
34875,0,0,0,0,0
63653,0,0,0,0,0
67270,0,0,0,0,0
70500,0,0,0,0,0
44790,0,0,0,0,0
79297,0,0,0,0,0
109335,0,0,0,0,0
45241,0,0,0,0,0
38102,0,0,0,0,0
30581,0,0,0,0,0
29501,0,0,0,0,0
104573,0,0,0,0,0
24566,0,0,0,0,0
23173,0,0,0,0,0
103311,0,0,0,0,0
25472,0,0,0,0,0
100693,0,0,0,0,0
48224,0,0,0,0,0
50617,0,0,0,0,0
26424,0,0,0,0,0
5611,0,0,0,0,0
74225,0,0,0,0,0
47125,0,0,0,0,0
18440,0,0,0,0,0
41172,0,0,0,0,0
5398,1,1,1,0,0
72776,0,0,0,0,0
23760,0,0,0,0,0
89294,0,0,0,0,0
102305,0,0,0,0,0
15446,0,0,0,0,0
66559,1,1,1,0,0
73275,0,0,0,0,0
103948,0,0,0,0,0
99434,0,0,0,0,0
80143,0,0,0,0,0
22701,0,0,0,0,0
70297,0,0,0,0,0
6143,0,0,0,0,0
94732,0,0,0,0,0
96647,0,0,0,0,0
58829,0,0,0,0,0
73764,0,0,0,0,0
75352,0,0,0,0,0
117526,0,0,0,0,0
114308,0,0,0,0,0
22840,0,0,0,0,0
113648,1,1,1,0,0
14143,0,0,0,0,0
107699,0,0,0,0,0
63016,0,0,0,0,0
10606,0,0,0,0,0
95319,2,2,2,0,0
81888,0,0,0,0,0
16286,0,0,0,0,0
106679,0,0,0,0,0
90771,0,0,0,0,0
5908,0,0,0,0,0
52005,0,0,0,0,0
4334,0,0,0,0,0
83556,0,0,0,0,0
115788,0,0,0,0,0
50450,0,0,0,0,0
80211,0,0,0,0,0
25545,0,0,0,0,0
46512,0,0,0,0,0
27731,0,0,0,0,0
50932,0,0,0,0,0
54605,0,0,0,0,0
11184,0,0,0,0,0
54657,0,0,0,0,0
73283,0,0,0,0,0
51455,0,0,0,0,0
3593,0,0,0,0,0
71597,0,0,0,0,0
54076,0,0,0,0,0
29282,0,0,0,0,0
61169,2,2,2,0,0
117157,0,0,0,0,0
37541,0,0,0,0,0
58277,0,0,0,0,0
6835,0,0,0,0,0
107099,0,0,0,0,0
99208,0,0,0,0,0
104852,0,0,0,0,0
91252,0,0,0,0,0
41792,1,1,1,0,0
4127,0,0,0,0,0
51054,0,0,0,0,0
75634,0,0,0,0,0
47458,0,0,0,0,0
74022,0,0,0,0,0
61764,0,0,0,0,0
116873,0,0,0,0,0
38491,0,0,0,0,0
36452,0,0,0,0,0
218,0,0,0,0,0
81737,0,0,0,0,0
57350,0,0,0,0,0
9675,0,0,0,0,0
110886,0,0,0,0,0
23546,0,0,0,0,0
10762,0,0,0,0,0
22185,0,0,0,0,0
40956,0,0,0,0,0
27364,0,0,0,0,0
65859,0,0,0,0,0
11743,0,0,0,0,0
59673,0,0,0,0,0
102052,0,0,0,0,0
82334,0,0,0,0,0
34123,0,0,0,0,0
48634,0,0,0,0,0
26078,0,0,0,0,0
2867,0,0,0,0,0
69900,0,0,0,0,0
66762,0,0,0,0,0
56984,0,0,0,0,0
19714,0,0,0,0,0
108651,0,0,0,0,0
104599,0,0,0,0,0
99982,0,0,0,0,0
83464,0,0,0,0,0
91656,0,0,0,0,0
103039,0,0,0,0,0
70869,0,0,0,0,0
16004,0,0,0,0,0
102200,0,0,0,0,0
103481,0,0,0,0,0
30283,0,0,0,0,0
3116,0,0,0,0,0
70329,0,0,0,0,0
91771,0,0,0,0,0
49555,0,0,0,0,0
46923,0,0,0,0,0
6680,0,0,0,0,0
45945,0,0,0,0,0
118712,0,0,0,0,0
72479,0,0,0,0,0
83847,0,0,0,0,0
7303,0,0,0,0,0
115655,0,0,0,0,0
4279,0,0,0,0,0
79421,0,0,0,0,0
117021,0,0,0,0,0
11046,0,0,0,0,0
87910,0,0,0,0,0
100560,0,0,0,0,0
27161,0,0,0,0,0
14020,0,0,0,0,0
95305,0,0,0,0,0
29652,0,0,0,0,0
112975,0,0,0,0,0
68902,1,1,1,0,0
71383,0,0,0,0,0
108914,0,0,0,0,0
99330,0,0,0,0,0
79933,0,0,0,0,0
109586,0,0,0,0,0
87196,0,0,0,0,0
38887,0,0,0,0,0
100494,0,0,0,0,0
29196,0,0,0,0,0
100827,0,0,0,0,0
42658,0,0,0,0,0
2686,0,0,0,0,0
95187,0,0,0,0,0
11009,0,0,0,0,0
32056,0,0,0,0,0
63387,0,0,0,0,0
17551,0,0,0,0,0
104392,0,0,0,0,0
9391,0,0,0,0,0
68142,0,0,0,0,0
70597,0,0,0,0,0
25204,0,0,0,0,0
87259,0,0,0,0,0
96089,0,0,0,0,0
39851,0,0,0,0,0
10813,0,0,0,0,0
19086,0,0,0,0,0
20603,0,0,0,0,0
99666,0,0,0,0,0
112923,1,1,1,0,0
38693,0,0,0,0,0
109269,0,0,0,0,0
18073,0,0,0,0,0
5336,0,0,0,0,0
88786,0,0,0,0,0
64461,0,0,0,0,0
96448,0,0,0,0,0
100418,0,0,0,0,0
30620,0,0,0,0,0
90865,0,0,0,0,0
118253,0,0,0,0,0
62348,0,0,0,0,0
53450,0,0,0,0,0
32952,0,0,0,0,0
118571,0,0,0,0,0
19645,0,0,0,0,0
106143,0,0,0,0,0
48566,0,0,0,0,0
20587,0,0,0,0,0
75268,0,0,0,0,0
96417,0,0,0,0,0
85094,0,0,0,0,0
108036,0,0,0,0,0
84870,0,0,0,0,0
75041,0,0,0,0,0
76234,0,0,0,0,0
43943,0,0,0,0,0
105669,0,0,0,0,0
38018,0,0,0,0,0
61991,0,0,0,0,0
87131,0,0,0,0,0
103304,0,0,0,0,0
6103,0,0,0,0,0
24502,0,0,0,0,0
113987,0,0,0,0,0
103852,0,0,0,0,0
97241,0,0,0,0,0
35838,0,0,0,0,0
110003,0,0,0,0,0
271,0,0,0,0,0
55831,0,0,0,0,0
111647,0,0,0,0,0
5807,1,1,1,0,0
60234,0,0,0,0,0
88090,0,0,0,0,0
102586,0,0,0,0,0
64294,0,0,0,0,0
56024,0,0,0,0,0
54566,0,0,0,0,0
82556,0,0,0,0,0
105843,0,0,0,0,0
24212,0,0,0,0,0
62776,0,0,0,0,0
95512,0,0,0,0,0
9407,0,0,0,0,0
98714,0,0,0,0,0
14689,0,0,0,0,0
31857,0,0,0,0,0
81652,0,0,0,0,0
66034,0,0,0,0,0
113997,0,0,0,0,0
87450,0,0,0,0,0
60237,0,0,0,0,0
69098,0,0,0,0,0
82373,0,0,0,0,0
1307,0,0,0,0,0
72728,0,0,0,0,0
34681,0,0,0,0,0
31495,0,0,0,0,0
17721,0,0,0,0,0
67757,0,0,0,0,0
73785,0,0,0,0,0
56439,0,0,0,0,0
49615,0,0,0,0,0
70308,0,0,0,0,0
67133,0,0,0,0,0
13372,0,0,0,0,0
101909,0,0,0,0,0
50901,0,0,0,0,0
13474,0,0,0,0,0
93148,0,0,0,0,0
90075,0,0,0,0,0
111854,0,0,0,0,0
95381,0,0,0,0,0
16221,0,0,0,0,0
26875,0,0,0,0,0
89678,0,0,0,0,0
13549,0,0,0,0,0
80333,0,0,0,0,0
3427,0,0,0,0,0
3591,0,0,0,0,0
54234,0,0,0,0,0
66341,0,0,0,0,0
113290,0,0,0,0,0
38504,0,0,0,0,0
115003,0,0,0,0,0
43809,0,0,0,0,0
81487,0,0,0,0,0
2518,0,0,0,0,0
68919,0,0,0,0,0
114112,0,0,0,0,0
66318,0,0,0,0,0
35563,0,0,0,0,0
91902,0,0,0,0,0
107948,0,0,0,0,0
32350,0,0,0,0,0
45910,0,0,0,0,0
33857,0,0,0,0,0
70388,0,0,0,0,0
29564,0,0,0,0,0
81235,0,0,0,0,0
54970,0,0,0,0,0
43983,0,0,0,0,0
35777,0,0,0,0,0
107485,0,0,0,0,0
102548,0,0,0,0,0
40217,0,0,0,0,0
54266,0,0,0,0,0
75667,0,0,0,0,0
65760,0,0,0,0,0
65234,0,0,0,0,0
5511,0,0,0,0,0
55774,0,0,0,0,0
60196,0,0,0,0,0
24132,0,0,0,0,0
113699,0,0,0,0,0
102556,0,0,0,0,0
44481,0,0,0,0,0
583,0,0,0,0,0
4276,0,0,0,0,0
29261,0,0,0,0,0
119323,0,0,0,0,0
30052,0,0,0,0,0
87212,0,0,0,0,0
31237,0,0,0,0,0
46963,0,0,0,0,0
85731,0,0,0,0,0
18795,0,0,0,0,0
71223,0,0,0,0,0
7851,0,0,0,0,0
55909,0,0,0,0,0
85355,0,0,0,0,0
47912,0,0,0,0,0
92366,0,0,0,0,0
112908,0,0,0,0,0
90373,0,0,0,0,0
58156,0,0,0,0,0
108086,0,0,0,0,0
111461,0,0,0,0,0
3070,0,0,0,0,0
89138,0,0,0,0,0
80765,0,0,0,0,0
57504,0,0,0,0,0
65272,0,0,0,0,0
25564,0,0,0,0,0
85521,0,0,0,0,0
70639,0,0,0,0,0
10625,0,0,0,0,0
74953,0,0,0,0,0
84622,0,0,0,0,0
101091,0,0,0,0,0
1231,0,0,0,0,0
31261,0,0,0,0,0
53120,0,0,0,0,0
8154,0,0,0,0,0
13049,0,0,0,0,0
79734,0,0,0,0,0
57965,0,0,0,0,0
35868,0,0,0,0,0
30322,0,0,0,0,0
93805,0,0,0,0,0
31206,0,0,0,0,0
81902,0,0,0,0,0
85855,0,0,0,0,0
94125,0,0,0,0,0
69613,0,0,0,0,0
13615,0,0,0,0,0
47799,0,0,0,0,0
21957,0,0,0,0,0
96077,0,0,0,0,0
61560,0,0,0,0,0
39631,0,0,0,0,0
97609,0,0,0,0,0
51843,0,0,0,0,0
85421,0,0,0,0,0
76822,0,0,0,0,0
109355,0,0,0,0,0
54182,1,1,1,0,0
64254,0,0,0,0,0
25252,0,0,0,0,0
120061,0,0,0,0,0
68394,0,0,0,0,0
52555,0,0,0,0,0
92955,0,0,0,0,0
96984,0,0,0,0,0
75862,0,0,0,0,0
76087,0,0,0,0,0
98848,0,0,0,0,0
16295,0,0,0,0,0
69733,0,0,0,0,0
90476,0,0,0,0,0
97416,0,0,0,0,0
23188,0,0,0,0,0
82491,0,0,0,0,0
15537,0,0,0,0,0
8224,0,0,0,0,0
94562,0,0,0,0,0
15071,0,0,0,0,0
118783,0,0,0,0,0
53534,0,0,0,0,0
60929,0,0,0,0,0
40791,0,0,0,0,0
31667,0,0,0,0,0
30200,0,0,0,0,0
26012,0,0,0,0,0
63582,0,0,0,0,0
118682,0,0,0,0,0
46355,0,0,0,0,0
49122,0,0,0,0,0
76811,0,0,0,0,0
92743,0,0,0,0,0
7402,0,0,0,0,0
73212,1,1,1,0,0
19294,0,0,0,0,0
63811,0,0,0,0,0
46969,0,0,0,0,0
11623,0,0,0,0,0
30952,0,0,0,0,0
78038,1,1,1,0,0
111503,0,0,0,0,0
34355,0,0,0,0,0
15291,0,0,0,0,0
42196,0,0,0,0,0
66322,0,0,0,0,0
72657,0,0,0,0,0
77492,0,0,0,0,0
99787,0,0,0,0,0
48303,0,0,0,0,0
39680,0,0,0,0,0
116713,0,0,0,0,0
36093,0,0,0,0,0
45111,0,0,0,0,0
22349,0,0,0,0,0
14999,0,0,0,0,0
20513,0,0,0,0,0
77083,0,0,0,0,0
95353,0,0,0,0,0
5685,0,0,0,0,0
34216,0,0,0,0,0
55469,0,0,0,0,0
21901,0,0,0,0,0
22379,3,3,3,0,0
114831,0,0,0,0,0
16911,0,0,0,0,0
104238,0,0,0,0,0
43066,0,0,0,0,0
36001,0,0,0,0,0
95117,0,0,0,0,0
37177,0,0,0,0,0
18165,0,0,0,0,0
26208,0,0,0,0,0
59520,0,0,0,0,0
105712,0,0,0,0,0
113914,0,0,0,0,0
89872,0,0,0,0,0
106203,0,0,0,0,0
45815,0,0,0,0,0
95761,0,0,0,0,0
96943,0,0,0,0,0
113297,0,0,0,0,0
75435,0,0,0,0,0
110193,0,0,0,0,0
76495,0,0,0,0,0
12265,0,0,0,0,0
85431,0,0,0,0,0
91393,0,0,0,0,0
37036,0,0,0,0,0
29333,0,0,0,0,0
17220,0,0,0,0,0
33129,0,0,0,0,0
80142,0,0,0,0,0
18175,0,0,0,0,0
62916,0,0,0,0,0
93357,0,0,0,0,0
55132,0,0,0,0,0
77737,0,0,0,0,0
120453,0,0,0,0,0
101863,0,0,0,0,0
54284,0,0,0,0,0
75110,0,0,0,0,0
5389,0,0,0,0,0
54738,0,0,0,0,0
28857,0,0,0,0,0
67925,0,0,0,0,0
99475,0,0,0,0,0
116601,0,0,0,0,0
58556,0,0,0,0,0
58362,0,0,0,0,0
19819,0,0,0,0,0
59728,0,0,0,0,0
10898,0,0,0,0,0
113589,0,0,0,0,0
55575,0,0,0,0,0
76242,0,0,0,0,0
48436,0,0,0,0,0
119707,0,0,0,0,0
28871,0,0,0,0,0
103433,0,0,0,0,0
80897,0,0,0,0,0
49631,0,0,0,0,0
27596,0,0,0,0,0
32209,0,0,0,0,0
67668,0,0,0,0,0
103768,0,0,0,0,0
15159,0,0,0,0,0
679,0,0,0,0,0
20731,0,0,0,0,0
61596,0,0,0,0,0
107439,0,0,0,0,0
79476,0,0,0,0,0
42748,0,0,0,0,0
91487,0,0,0,0,0
766,4,4,4,0,0
34282,0,0,0,0,0
104562,0,0,0,0,0
81030,5,5,5,0,0
10656,1,1,1,0,0
35366,0,0,0,0,0
104511,0,0,0,0,0
41491,0,0,0,0,0
62750,0,0,0,0,0
27538,0,0,0,0,0
93404,0,0,0,0,0
93644,0,0,0,0,0
2442,0,0,0,0,0
29235,0,0,0,0,0
93614,0,0,0,0,0
37546,0,0,0,0,0
116962,0,0,0,0,0
95555,0,0,0,0,0
29513,0,0,0,0,0
110089,0,0,0,0,0
20886,0,0,0,0,0
80309,0,0,0,0,0
97246,0,0,0,0,0
86455,0,0,0,0,0
24305,0,0,0,0,0
105462,0,0,0,0,0
71588,0,0,0,0,0
54525,0,0,0,0,0
19767,0,0,0,0,0
32885,0,0,0,0,0
78960,0,0,0,0,0
116695,0,0,0,0,0
119492,0,0,0,0,0
18772,0,0,0,0,0
32185,0,0,0,0,0
46104,0,0,0,0,0
20507,0,0,0,0,0
95930,0,0,0,0,0
112988,0,0,0,0,0
11115,0,0,0,0,0
22409,0,0,0,0,0
117610,0,0,0,0,0
94736,0,0,0,0,0
107961,0,0,0,0,0
94480,0,0,0,0,0
102235,0,0,0,0,0
106980,0,0,0,0,0
570,0,0,0,0,0
72109,0,0,0,0,0
24846,0,0,0,0,0
36645,0,0,0,0,0
109334,4,4,4,0,0
71182,0,0,0,0,0
86260,0,0,0,0,0
3247,0,0,0,0,0
42950,0,0,0,0,0
104412,0,0,0,0,0
103867,0,0,0,0,0
30965,0,0,0,0,0
66117,0,0,0,0,0
112965,0,0,0,0,0
2883,0,0,0,0,0
73374,0,0,0,0,0
100067,0,0,0,0,0
94438,0,0,0,0,0
69879,0,0,0,0,0
34646,0,0,0,0,0
71873,0,0,0,0,0
102695,0,0,0,0,0
70529,0,0,0,0,0
55562,0,0,0,0,0
31963,0,0,0,0,0
27121,0,0,0,0,0
119589,0,0,0,0,0
108007,0,0,0,0,0
51626,0,0,0,0,0
30385,0,0,0,0,0
32006,0,0,0,0,0
37929,0,0,0,0,0
79374,0,0,0,0,0
88785,0,0,0,0,0
8461,0,0,0,0,0
25191,0,0,0,0,0
32569,0,0,0,0,0
101143,0,0,0,0,0
9981,0,0,0,0,0
6682,0,0,0,0,0
21601,0,0,0,0,0
111889,0,0,0,0,0
37576,0,0,0,0,0
11055,0,0,0,0,0
50397,0,0,0,0,0
78735,0,0,0,0,0
119330,0,0,0,0,0
90640,0,0,0,0,0
60328,0,0,0,0,0
60910,0,0,0,0,0
51227,0,0,0,0,0
110357,0,0,0,0,0
21341,0,0,0,0,0
60763,0,0,0,0,0
44827,0,0,0,0,0
15676,0,0,0,0,0
58253,0,0,0,0,0
34739,0,0,0,0,0
64487,0,0,0,0,0
29948,0,0,0,0,0
97653,0,0,0,0,0
37271,0,0,0,0,0
32996,0,0,0,0,0
38473,0,0,0,0,0
81085,0,0,0,0,0
92153,0,0,0,0,0
49004,0,0,0,0,0
36735,0,0,0,0,0
109716,0,0,0,0,0
12056,0,0,0,0,0
46200,0,0,0,0,0
12,0,0,0,0,0
64238,0,0,0,0,0
32496,0,0,0,0,0
50698,0,0,0,0,0
16115,0,0,0,0,0
62835,0,0,0,0,0
97333,0,0,0,0,0
113956,0,0,0,0,0
8697,0,0,0,0,0
81397,2,2,2,0,0
103715,0,0,0,0,0
88789,0,0,0,0,0
110992,0,0,0,0,0
61494,0,0,0,0,0
86254,0,0,0,0,0
108572,0,0,0,0,0
66906,0,0,0,0,0
76967,0,0,0,0,0
8834,0,0,0,0,0
68285,0,0,0,0,0
99626,0,0,0,0,0
33121,3,3,3,0,0
63989,0,0,0,0,0
27510,0,0,0,0,0
25540,0,0,0,0,0
19402,1,1,1,0,0
90150,0,0,0,0,0
45212,0,0,0,0,0
75172,0,0,0,0,0
28840,0,0,0,0,0
22558,0,0,0,0,0
20832,0,0,0,0,0
11196,0,0,0,0,0
30343,0,0,0,0,0
104070,0,0,0,0,0
48401,0,0,0,0,0
118638,0,0,0,0,0
46165,0,0,0,0,0
110978,0,0,0,0,0
60494,0,0,0,0,0
99413,0,0,0,0,0
5379,0,0,0,0,0
105675,0,0,0,0,0
70391,0,0,0,0,0
40470,0,0,0,0,0
113861,0,0,0,0,0
118902,2,2,2,0,0
89451,0,0,0,0,0
5930,0,0,0,0,0
6832,0,0,0,0,0
63035,0,0,0,0,0
6434,0,0,0,0,0
32048,0,0,0,0,0
43228,0,0,0,0,0
11003,0,0,0,0,0
1735,0,0,0,0,0
55328,0,0,0,0,0
75826,0,0,0,0,0
41556,0,0,0,0,0
83804,0,0,0,0,0
43002,0,0,0,0,0
12650,0,0,0,0,0
40426,0,0,0,0,0
92038,0,0,0,0,0
111510,0,0,0,0,0
112558,0,0,0,0,0
115053,0,0,0,0,0
52505,0,0,0,0,0
106436,0,0,0,0,0
45961,0,0,0,0,0
11565,0,0,0,0,0
26155,0,0,0,0,0
72253,0,0,0,0,0
12708,0,0,0,0,0
23488,0,0,0,0,0
38691,0,0,0,0,0
8534,0,0,0,0,0
71967,0,0,0,0,0
47442,0,0,0,0,0
105701,0,0,0,0,0
40938,0,0,0,0,0
21949,0,0,0,0,0
105339,0,0,0,0,0
47750,0,0,0,0,0
112688,0,0,0,0,0
28024,0,0,0,0,0
26976,0,0,0,0,0
18566,0,0,0,0,0
9301,0,0,0,0,0
54609,0,0,0,0,0
118330,0,0,0,0,0
92347,0,0,0,0,0
16982,0,0,0,0,0
39823,0,0,0,0,0
17809,0,0,0,0,0
41439,0,0,0,0,0
84280,0,0,0,0,0
76500,0,0,0,0,0
15801,0,0,0,0,0
80094,0,0,0,0,0
11752,0,0,0,0,0
3743,0,0,0,0,0
82871,0,0,0,0,0
957,0,0,0,0,0
15300,0,0,0,0,0
14000,0,0,0,0,0
81197,0,0,0,0,0
119718,1,1,1,0,0
108978,0,0,0,0,0
5616,0,0,0,0,0
14756,0,0,0,0,0
115620,0,0,0,0,0
111952,0,0,0,0,0
37632,0,0,0,0,0
116919,0,0,0,0,0
100005,0,0,0,0,0
95678,0,0,0,0,0
38155,4,4,4,0,0
95266,0,0,0,0,0
115209,0,0,0,0,0
64897,0,0,0,0,0
31398,0,0,0,0,0
92795,0,0,0,0,0
104744,0,0,0,0,0
92295,0,0,0,0,0
78630,0,0,0,0,0
99641,0,0,0,0,0
214,0,0,0,0,0
59783,0,0,0,0,0
104471,0,0,0,0,0
8337,0,0,0,0,0
49725,0,0,0,0,0
23487,0,0,0,0,0
107525,0,0,0,0,0
100478,0,0,0,0,0
28707,0,0,0,0,0
11941,0,0,0,0,0
94439,0,0,0,0,0
108396,0,0,0,0,0
10778,0,0,0,0,0
55234,0,0,0,0,0
118830,0,0,0,0,0
38999,0,0,0,0,0
56048,0,0,0,0,0
78871,0,0,0,0,0
100219,0,0,0,0,0
116410,0,0,0,0,0
12792,0,0,0,0,0
71178,0,0,0,0,0
3046,0,0,0,0,0
62361,0,0,0,0,0
39230,0,0,0,0,0
11226,0,0,0,0,0
44896,0,0,0,0,0
12166,0,0,0,0,0
107917,0,0,0,0,0
77856,0,0,0,0,0
118960,0,0,0,0,0
7289,0,0,0,0,0
64633,0,0,0,0,0
41767,0,0,0,0,0
53562,0,0,0,0,0
51992,0,0,0,0,0
48791,4,4,4,0,0
41462,0,0,0,0,0
84428,0,0,0,0,0
62959,0,0,0,0,0
79006,0,0,0,0,0
102851,0,0,0,0,0
29863,0,0,0,0,0
41821,0,0,0,0,0
73128,0,0,0,0,0
35354,0,0,0,0,0
88748,0,0,0,0,0
8844,0,0,0,0,0
59768,0,0,0,0,0
87680,0,0,0,0,0
111481,0,0,0,0,0
43791,0,0,0,0,0
25500,0,0,0,0,0
19408,0,0,0,0,0
105027,0,0,0,0,0
103202,0,0,0,0,0
33058,0,0,0,0,0
97049,0,0,0,0,0
72820,0,0,0,0,0
50802,0,0,0,0,0
75827,0,0,0,0,0
1003,0,0,0,0,0
116530,0,0,0,0,0
118785,0,0,0,0,0
89602,0,0,0,0,0
96136,0,0,0,0,0
12596,0,0,0,0,0
93182,0,0,0,0,0
67242,0,0,0,0,0
23189,0,0,0,0,0
22848,0,0,0,0,0
111153,0,0,0,0,0
37009,0,0,0,0,0
29049,0,0,0,0,0
32229,0,0,0,0,0
108484,0,0,0,0,0
81194,0,0,0,0,0
22220,0,0,0,0,0
100619,0,0,0,0,0
104639,0,0,0,0,0
93228,0,0,0,0,0
90200,0,0,0,0,0
54212,0,0,0,0,0
72735,0,0,0,0,0
48545,0,0,0,0,0
98190,0,0,0,0,0
19192,0,0,0,0,0
93503,0,0,0,0,0
56242,0,0,0,0,0
71346,0,0,0,0,0
5578,0,0,0,0,0
34036,0,0,0,0,0
99629,0,0,0,0,0
86168,0,0,0,0,0
53660,0,0,0,0,0
88916,0,0,0,0,0
62108,0,0,0,0,0
6204,0,0,0,0,0
25811,0,0,0,0,0
58132,0,0,0,0,0
19696,0,0,0,0,0
115425,0,0,0,0,0
98847,0,0,0,0,0
53201,0,0,0,0,0
82288,0,0,0,0,0
115036,0,0,0,0,0
54903,0,0,0,0,0
81907,0,0,0,0,0
52139,0,0,0,0,0
18813,0,0,0,0,0
37604,0,0,0,0,0
98829,0,0,0,0,0
96575,0,0,0,0,0
72096,0,0,0,0,0
57553,0,0,0,0,0
43650,0,0,0,0,0
103275,0,0,0,0,0
110770,0,0,0,0,0
78505,0,0,0,0,0
59937,0,0,0,0,0
21005,0,0,0,0,0
61471,0,0,0,0,0
119006,0,0,0,0,0
1466,0,0,0,0,0
26824,0,0,0,0,0
37552,0,0,0,0,0
6503,0,0,0,0,0
113709,0,0,0,0,0
24098,0,0,0,0,0
28212,0,0,0,0,0
4727,0,0,0,0,0
17530,0,0,0,0,0
62027,0,0,0,0,0
95076,0,0,0,0,0
39608,0,0,0,0,0
118954,0,0,0,0,0
42565,0,0,0,0,0
1530,0,0,0,0,0
105649,0,0,0,0,0
40249,0,0,0,0,0
18919,0,0,0,0,0
39029,0,0,0,0,0
56777,0,0,0,0,0
34614,0,0,0,0,0
24980,4,4,4,0,0
60658,0,0,0,0,0
96841,0,0,0,0,0
14850,0,0,0,0,0
73758,0,0,0,0,0
12955,0,0,0,0,0
13407,0,0,0,0,0
42709,0,0,0,0,0
33406,0,0,0,0,0
23715,1,1,1,0,0
13138,0,0,0,0,0
86862,0,0,0,0,0
71193,0,0,0,0,0
24386,0,0,0,0,0
63383,0,0,0,0,0
71799,0,0,0,0,0
105079,0,0,0,0,0
115153,0,0,0,0,0
81778,0,0,0,0,0
71773,0,0,0,0,0
40342,0,0,0,0,0
39642,0,0,0,0,0
113506,0,0,0,0,0
114304,0,0,0,0,0
54351,0,0,0,0,0
6232,0,0,0,0,0
46400,0,0,0,0,0
116452,0,0,0,0,0
56900,0,0,0,0,0
111765,0,0,0,0,0
106379,0,0,0,0,0
16432,0,0,0,0,0
93064,0,0,0,0,0
87664,0,0,0,0,0
37109,0,0,0,0,0
46702,0,0,0,0,0
103612,0,0,0,0,0
45366,3,3,3,0,0
27388,0,0,0,0,0
96324,0,0,0,0,0
22601,0,0,0,0,0
114221,0,0,0,0,0
118622,0,0,0,0,0
20089,0,0,0,0,0
11627,0,0,0,0,0
96806,0,0,0,0,0
110624,0,0,0,0,0
67513,0,0,0,0,0
7740,0,0,0,0,0
108609,0,0,0,0,0
56530,0,0,0,0,0
107369,0,0,0,0,0
57925,0,0,0,0,0
81673,0,0,0,0,0
86626,0,0,0,0,0
42720,0,0,0,0,0
119313,0,0,0,0,0
49950,0,0,0,0,0
23512,0,0,0,0,0
57267,0,0,0,0,0
51097,0,0,0,0,0
96608,0,0,0,0,0
100677,0,0,0,0,0
42931,0,0,0,0,0
116423,0,0,0,0,0
97675,0,0,0,0,0
21325,0,0,0,0,0
76362,0,0,0,0,0
57466,0,0,0,0,0
15889,0,0,0,0,0
107251,0,0,0,0,0
3432,1,1,1,0,0
82764,0,0,0,0,0
66789,0,0,0,0,0
22312,0,0,0,0,0
99911,0,0,0,0,0
87476,0,0,0,0,0
29222,0,0,0,0,0
52497,0,0,0,0,0
41677,0,0,0,0,0
95709,0,0,0,0,0
110938,0,0,0,0,0
20801,0,0,0,0,0
36160,0,0,0,0,0
38234,0,0,0,0,0
54324,0,0,0,0,0
81042,1,1,1,0,0
82889,0,0,0,0,0
40425,0,0,0,0,0
45547,0,0,0,0,0
58091,0,0,0,0,0
27988,0,0,0,0,0
9876,0,0,0,0,0
8308,0,0,0,0,0
96268,0,0,0,0,0
15813,0,0,0,0,0
28735,0,0,0,0,0
105776,4,4,4,0,0
62399,0,0,0,0,0
113649,0,0,0,0,0
86177,0,0,0,0,0
112163,0,0,0,0,0
47478,0,0,0,0,0
109458,0,0,0,0,0
95382,0,0,0,0,0
29434,0,0,0,0,0
43872,0,0,0,0,0
41310,0,0,0,0,0
40371,0,0,0,0,0
22504,0,0,0,0,0
116615,0,0,0,0,0
16051,0,0,0,0,0
48741,0,0,0,0,0
76768,0,0,0,0,0
35642,0,0,0,0,0
14664,0,0,0,0,0
75583,0,0,0,0,0
107083,0,0,0,0,0
64626,0,0,0,0,0
45392,0,0,0,0,0
67616,0,0,0,0,0
110945,0,0,0,0,0
30444,0,0,0,0,0
107262,0,0,0,0,0
28752,0,0,0,0,0
38428,0,0,0,0,0
31883,0,0,0,0,0
4156,0,0,0,0,0
75705,0,0,0,0,0
34353,0,0,0,0,0
69668,0,0,0,0,0
92577,0,0,0,0,0
55858,0,0,0,0,0
1412,0,0,0,0,0
107776,0,0,0,0,0
28029,0,0,0,0,0
37314,0,0,0,0,0
44750,0,0,0,0,0
6848,0,0,0,0,0
34352,0,0,0,0,0
106432,0,0,0,0,0
85425,0,0,0,0,0
43073,0,0,0,0,0
88413,0,0,0,0,0
71041,0,0,0,0,0
73262,0,0,0,0,0
17564,0,0,0,0,0
31395,0,0,0,0,0
14932,0,0,0,0,0
63515,0,0,0,0,0
108573,0,0,0,0,0
104366,0,0,0,0,0
63763,0,0,0,0,0
82662,0,0,0,0,0
45800,0,0,0,0,0
55955,0,0,0,0,0
93504,0,0,0,0,0
73360,0,0,0,0,0
49674,0,0,0,0,0
73937,0,0,0,0,0
34299,0,0,0,0,0
115034,0,0,0,0,0
88642,0,0,0,0,0
51901,0,0,0,0,0
20854,0,0,0,0,0
50469,0,0,0,0,0
28151,1,1,1,0,0
28108,0,0,0,0,0
31035,0,0,0,0,0
42054,0,0,0,0,0
6063,0,0,0,0,0
80974,0,0,0,0,0
38996,0,0,0,0,0
33666,0,0,0,0,0
114049,0,0,0,0,0
110045,0,0,0,0,0
73690,0,0,0,0,0
110382,0,0,0,0,0
764,0,0,0,0,0
17488,0,0,0,0,0
91666,0,0,0,0,0
49101,0,0,0,0,0
3870,0,0,0,0,0
66837,0,0,0,0,0
4200,0,0,0,0,0
50470,0,0,0,0,0
7006,0,0,0,0,0
31999,0,0,0,0,0
48170,0,0,0,0,0
60260,0,0,0,0,0
55414,0,0,0,0,0
12758,0,0,0,0,0
36651,0,0,0,0,0
42402,0,0,0,0,0
35771,0,0,0,0,0
88867,0,0,0,0,0
16847,4,4,4,0,0
100444,0,0,0,0,0
3343,0,0,0,0,0
119949,0,0,0,0,0
841,0,0,0,0,0
45849,0,0,0,0,0
85206,0,0,0,0,0
47472,0,0,0,0,0
64788,0,0,0,0,0
63269,0,0,0,0,0
107861,0,0,0,0,0
13119,0,0,0,0,0
22026,0,0,0,0,0
101579,0,0,0,0,0
86864,0,0,0,0,0
57718,0,0,0,0,0
65098,0,0,0,0,0
31072,0,0,0,0,0
56240,0,0,0,0,0
50423,0,0,0,0,0
40362,0,0,0,0,0
22198,1,1,1,0,0
62690,0,0,0,0,0
12132,0,0,0,0,0
87994,0,0,0,0,0
98583,0,0,0,0,0
27590,0,0,0,0,0
52158,0,0,0,0,0
63873,0,0,0,0,0
49689,0,0,0,0,0
65685,0,0,0,0,0
41370,0,0,0,0,0
4188,0,0,0,0,0
111324,1,1,1,0,0
63859,0,0,0,0,0
63757,0,0,0,0,0
85629,0,0,0,0,0
5737,0,0,0,0,0
64099,0,0,0,0,0
58807,0,0,0,0,0
17874,0,0,0,0,0
108227,0,0,0,0,0
42382,0,0,0,0,0
65934,0,0,0,0,0
117725,0,0,0,0,0
39893,0,0,0,0,0
102277,0,0,0,0,0
22157,0,0,0,0,0
45492,0,0,0,0,0
7473,0,0,0,0,0
83390,0,0,0,0,0
38790,0,0,0,0,0
101495,0,0,0,0,0
29903,0,0,0,0,0
112078,0,0,0,0,0
90832,0,0,0,0,0
106152,0,0,0,0,0
99065,0,0,0,0,0
16685,0,0,0,0,0
16814,0,0,0,0,0
77292,0,0,0,0,0
5757,0,0,0,0,0
99548,0,0,0,0,0
31250,0,0,0,0,0
58991,0,0,0,0,0
67042,0,0,0,0,0
57116,0,0,0,0,0
94494,0,0,0,0,0
20195,0,0,0,0,0
106594,0,0,0,0,0
62478,0,0,0,0,0
96451,0,0,0,0,0
80085,0,0,0,0,0
13892,0,0,0,0,0
63841,1,1,1,0,0
44875,0,0,0,0,0
66119,0,0,0,0,0
94593,0,0,0,0,0
120183,0,0,0,0,0
85947,0,0,0,0,0
88875,0,0,0,0,0
2276,0,0,0,0,0
66282,0,0,0,0,0
30374,0,0,0,0,0
56540,0,0,0,0,0
80461,0,0,0,0,0
40912,0,0,0,0,0
58136,0,0,0,0,0
38947,0,0,0,0,0
64753,0,0,0,0,0
100572,0,0,0,0,0
9920,0,0,0,0,0
38914,0,0,0,0,0
36025,0,0,0,0,0
23725,0,0,0,0,0
116120,0,0,0,0,0
79753,0,0,0,0,0
45279,0,0,0,0,0
12790,0,0,0,0,0
118457,0,0,0,0,0
43627,0,0,0,0,0
112782,0,0,0,0,0
4394,0,0,0,0,0
37313,0,0,0,0,0
45026,1,1,1,0,0
117346,0,0,0,0,0
79446,0,0,0,0,0
6069,0,0,0,0,0
71674,0,0,0,0,0
23364,0,0,0,0,0
17052,0,0,0,0,0
20095,0,0,0,0,0
119182,0,0,0,0,0
53704,0,0,0,0,0
21145,0,0,0,0,0
15519,0,0,0,0,0
104208,0,0,0,0,0
90907,0,0,0,0,0
60877,0,0,0,0,0
60486,0,0,0,0,0
119189,0,0,0,0,0
12968,0,0,0,0,0
106896,0,0,0,0,0
10594,0,0,0,0,0
4472,0,0,0,0,0
7275,0,0,0,0,0
21630,0,0,0,0,0
16435,0,0,0,0,0
61426,0,0,0,0,0
119638,1,1,1,0,0
25457,0,0,0,0,0
99553,0,0,0,0,0
102211,0,0,0,0,0
69342,0,0,0,0,0
109393,0,0,0,0,0
106625,0,0,0,0,0
50305,0,0,0,0,0
55129,0,0,0,0,0
85062,0,0,0,0,0
59699,0,0,0,0,0
39145,0,0,0,0,0
112146,0,0,0,0,0
25155,0,0,0,0,0
42309,0,0,0,0,0
59620,0,0,0,0,0
115482,0,0,0,0,0
69539,0,0,0,0,0
59963,0,0,0,0,0
20360,0,0,0,0,0
69812,0,0,0,0,0
50260,0,0,0,0,0
46193,0,0,0,0,0
63737,0,0,0,0,0
65449,0,0,0,0,0
52423,0,0,0,0,0
56726,0,0,0,0,0
52752,0,0,0,0,0
90012,0,0,0,0,0
19165,0,0,0,0,0
21475,0,0,0,0,0
33695,0,0,0,0,0
53356,0,0,0,0,0
116562,0,0,0,0,0
97486,0,0,0,0,0
23557,0,0,0,0,0
53392,0,0,0,0,0
112838,0,0,0,0,0
71327,0,0,0,0,0
7367,0,0,0,0,0
111109,0,0,0,0,0
9610,0,0,0,0,0
3740,0,0,0,0,0
75458,0,0,0,0,0
47401,0,0,0,0,0
22832,0,0,0,0,0
29953,0,0,0,0,0
61048,0,0,0,0,0
16096,0,0,0,0,0
75459,0,0,0,0,0
86473,0,0,0,0,0
38138,0,0,0,0,0
38923,0,0,0,0,0
56119,0,0,0,0,0
12221,0,0,0,0,0
72859,0,0,0,0,0
13394,0,0,0,0,0
59782,0,0,0,0,0
114194,0,0,0,0,0
44454,0,0,0,0,0
23196,0,0,0,0,0
66316,0,0,0,0,0
58276,0,0,0,0,0
113821,0,0,0,0,0
79414,0,0,0,0,0
56596,0,0,0,0,0
109517,0,0,0,0,0
89457,0,0,0,0,0
93282,0,0,0,0,0
96187,0,0,0,0,0
115164,0,0,0,0,0
6619,0,0,0,0,0
111961,0,0,0,0,0
8289,0,0,0,0,0
53154,0,0,0,0,0
223,0,0,0,0,0
81838,0,0,0,0,0
33566,0,0,0,0,0
87742,0,0,0,0,0
108657,0,0,0,0,0
39896,0,0,0,0,0
65683,0,0,0,0,0
32103,0,0,0,0,0
101122,0,0,0,0,0
22005,0,0,0,0,0
117146,0,0,0,0,0
68297,0,0,0,0,0
110036,0,0,0,0,0
60106,0,0,0,0,0
113077,0,0,0,0,0
76043,0,0,0,0,0
80977,0,0,0,0,0
108076,0,0,0,0,0
40602,0,0,0,0,0
13752,0,0,0,0,0
36825,0,0,0,0,0
70788,0,0,0,0,0
116832,0,0,0,0,0
117108,0,0,0,0,0
119013,0,0,0,0,0
119225,0,0,0,0,0
59796,0,0,0,0,0
106477,0,0,0,0,0
46939,0,0,0,0,0
78268,0,0,0,0,0
45264,0,0,0,0,0
72581,0,0,0,0,0
65558,0,0,0,0,0
33138,0,0,0,0,0
84183,0,0,0,0,0
11169,0,0,0,0,0
97874,0,0,0,0,0
53989,0,0,0,0,0
49231,0,0,0,0,0
88547,0,0,0,0,0
54600,0,0,0,0,0
1755,0,0,0,0,0
40459,0,0,0,0,0
62821,0,0,0,0,0
77276,0,0,0,0,0
107750,0,0,0,0,0
92862,0,0,0,0,0
72981,0,0,0,0,0
100621,0,0,0,0,0
118053,0,0,0,0,0
115439,0,0,0,0,0
14192,0,0,0,0,0
42243,0,0,0,0,0
61015,0,0,0,0,0
108717,0,0,0,0,0
26933,0,0,0,0,0
76316,0,0,0,0,0
43642,0,0,0,0,0
36804,0,0,0,0,0
118273,0,0,0,0,0
35548,0,0,0,0,0
68525,0,0,0,0,0
93294,0,0,0,0,0
93461,2,2,2,0,0
46836,0,0,0,0,0
73600,0,0,0,0,0
91698,0,0,0,0,0
32519,0,0,0,0,0
47080,0,0,0,0,0
97447,0,0,0,0,0
113115,0,0,0,0,0
104999,0,0,0,0,0
70575,0,0,0,0,0
52666,0,0,0,0,0
23467,0,0,0,0,0
8948,0,0,0,0,0
45225,0,0,0,0,0
81760,0,0,0,0,0
118931,0,0,0,0,0
83222,0,0,0,0,0
91094,0,0,0,0,0
48972,0,0,0,0,0
107342,0,0,0,0,0
91424,0,0,0,0,0
83402,0,0,0,0,0
58525,0,0,0,0,0
48779,0,0,0,0,0
40476,0,0,0,0,0
104759,0,0,0,0,0
104105,0,0,0,0,0
62456,0,0,0,0,0
4642,0,0,0,0,0
1969,0,0,0,0,0
69600,0,0,0,0,0
42928,0,0,0,0,0
81782,0,0,0,0,0
83732,0,0,0,0,0
6947,0,0,0,0,0
115355,0,0,0,0,0
74111,0,0,0,0,0
66729,0,0,0,0,0
119146,0,0,0,0,0
80943,0,0,0,0,0
89522,0,0,0,0,0
113273,0,0,0,0,0
96322,0,0,0,0,0
25447,0,0,0,0,0
97085,0,0,0,0,0
56308,0,0,0,0,0
22992,0,0,0,0,0
73353,0,0,0,0,0
69039,0,0,0,0,0
112548,0,0,0,0,0
17331,0,0,0,0,0
65791,0,0,0,0,0
51564,0,0,0,0,0
82337,0,0,0,0,0
34298,0,0,0,0,0
101049,0,0,0,0,0
56376,0,0,0,0,0
102539,0,0,0,0,0
22296,0,0,0,0,0
51251,0,0,0,0,0
7172,0,0,0,0,0
46948,0,0,0,0,0
17216,0,0,0,0,0
106328,0,0,0,0,0
7895,0,0,0,0,0
91284,0,0,0,0,0
75928,0,0,0,0,0
8309,0,0,0,0,0
7723,0,0,0,0,0
45007,0,0,0,0,0
103340,0,0,0,0,0
71902,0,0,0,0,0
47279,0,0,0,0,0
25479,0,0,0,0,0
72348,0,0,0,0,0
45833,0,0,0,0,0
61448,0,0,0,0,0
74037,0,0,0,0,0
31837,0,0,0,0,0
34796,0,0,0,0,0
11441,0,0,0,0,0
37233,0,0,0,0,0
83095,0,0,0,0,0
60560,0,0,0,0,0
83377,0,0,0,0,0
84982,0,0,0,0,0
60407,0,0,0,0,0
2649,0,0,0,0,0
66523,0,0,0,0,0
51671,0,0,0,0,0
104068,0,0,0,0,0
19215,0,0,0,0,0
49311,0,0,0,0,0
25970,0,0,0,0,0
46734,0,0,0,0,0
59127,0,0,0,0,0
56272,0,0,0,0,0
31964,0,0,0,0,0
60688,0,0,0,0,0
93058,0,0,0,0,0
63102,0,0,0,0,0
39075,0,0,0,0,0
40245,0,0,0,0,0
2105,0,0,0,0,0
67748,0,0,0,0,0
54582,0,0,0,0,0
92462,0,0,0,0,0
31719,0,0,0,0,0
57026,0,0,0,0,0
15342,0,0,0,0,0
45946,0,0,0,0,0
55924,0,0,0,0,0
111942,0,0,0,0,0
33584,0,0,0,0,0
66670,0,0,0,0,0
44717,0,0,0,0,0
30654,0,0,0,0,0
78738,0,0,0,0,0
65844,0,0,0,0,0
13800,0,0,0,0,0
93895,0,0,0,0,0
33127,0,0,0,0,0
99862,0,0,0,0,0
56355,0,0,0,0,0
119294,0,0,0,0,0
117850,0,0,0,0,0
104032,0,0,0,0,0
115914,0,0,0,0,0
43074,0,0,0,0,0
89452,0,0,0,0,0
100851,0,0,0,0,0
93607,0,0,0,0,0
1124,0,0,0,0,0
16201,0,0,0,0,0
113700,0,0,0,0,0
64725,0,0,0,0,0
25297,0,0,0,0,0
40895,0,0,0,0,0
95847,0,0,0,0,0
4421,0,0,0,0,0
35121,0,0,0,0,0
58959,0,0,0,0,0
7818,0,0,0,0,0
20884,0,0,0,0,0
2628,0,0,0,0,0
94867,0,0,0,0,0
75832,0,0,0,0,0
1599,0,0,0,0,0
59575,0,0,0,0,0
63998,0,0,0,0,0
4626,0,0,0,0,0
90531,0,0,0,0,0
84189,0,0,0,0,0
40991,0,0,0,0,0
115947,0,0,0,0,0
13475,0,0,0,0,0
80486,0,0,0,0,0
692,0,0,0,0,0
74163,0,0,0,0,0
54499,0,0,0,0,0
69647,0,0,0,0,0
7020,0,0,0,0,0
101847,0,0,0,0,0
20999,0,0,0,0,0
85367,0,0,0,0,0
10440,0,0,0,0,0
107560,0,0,0,0,0
21998,0,0,0,0,0
91672,0,0,0,0,0
52209,0,0,0,0,0
92600,0,0,0,0,0
115262,0,0,0,0,0
17595,0,0,0,0,0
51620,0,0,0,0,0
11951,0,0,0,0,0
71502,0,0,0,0,0
65363,0,0,0,0,0
34940,0,0,0,0,0
113704,0,0,0,0,0
98246,0,0,0,0,0
6487,0,0,0,0,0
22545,0,0,0,0,0
54880,0,0,0,0,0
100139,0,0,0,0,0
71852,0,0,0,0,0
116621,0,0,0,0,0
69201,0,0,0,0,0
69902,0,0,0,0,0
24175,0,0,0,0,0
15945,0,0,0,0,0
116824,0,0,0,0,0
67852,0,0,0,0,0
113595,0,0,0,0,0
53433,0,0,0,0,0
14444,0,0,0,0,0
112652,0,0,0,0,0
77782,0,0,0,0,0
59275,0,0,0,0,0
105117,0,0,0,0,0
118306,0,0,0,0,0
43561,0,0,0,0,0
40212,0,0,0,0,0
55823,0,0,0,0,0
42360,0,0,0,0,0
13348,0,0,0,0,0
61897,0,0,0,0,0
44515,0,0,0,0,0
115039,0,0,0,0,0
87159,0,0,0,0,0
95386,0,0,0,0,0
82070,0,0,0,0,0
72703,0,0,0,0,0
109194,0,0,0,0,0
46118,0,0,0,0,0
68312,0,0,0,0,0
87378,0,0,0,0,0
103633,0,0,0,0,0
51712,0,0,0,0,0
1312,2,2,2,0,0
107589,0,0,0,0,0
114791,0,0,0,0,0
62921,0,0,0,0,0
4894,0,0,0,0,0
40092,0,0,0,0,0
68358,0,0,0,0,0
2176,0,0,0,0,0
59407,1,1,1,0,0
82480,0,0,0,0,0
115236,0,0,0,0,0
65519,0,0,0,0,0
25091,0,0,0,0,0
32582,0,0,0,0,0
58159,0,0,0,0,0
74977,0,0,0,0,0
112383,0,0,0,0,0
36943,0,0,0,0,0
5013,0,0,0,0,0
91172,0,0,0,0,0
109345,0,0,0,0,0
49924,0,0,0,0,0
52504,0,0,0,0,0
119454,0,0,0,0,0
50216,0,0,0,0,0
70165,0,0,0,0,0
92494,0,0,0,0,0
85193,0,0,0,0,0
49045,0,0,0,0,0
70770,0,0,0,0,0
63381,0,0,0,0,0
658,0,0,0,0,0
24079,0,0,0,0,0
62508,0,0,0,0,0
73110,0,0,0,0,0
6329,0,0,0,0,0
105655,0,0,0,0,0
59322,0,0,0,0,0
42493,0,0,0,0,0
32136,0,0,0,0,0
42423,0,0,0,0,0
103917,0,0,0,0,0
26808,0,0,0,0,0
59438,0,0,0,0,0
100322,0,0,0,0,0
15366,0,0,0,0,0
92995,0,0,0,0,0
48636,0,0,0,0,0
101950,0,0,0,0,0
9555,0,0,0,0,0
105478,0,0,0,0,0
52123,0,0,0,0,0
40404,0,0,0,0,0
93605,0,0,0,0,0
52200,0,0,0,0,0
707,0,0,0,0,0
103999,0,0,0,0,0
59157,0,0,0,0,0
111100,0,0,0,0,0
69962,0,0,0,0,0
34838,0,0,0,0,0
67454,0,0,0,0,0
15309,1,1,1,0,0
92403,0,0,0,0,0
81712,0,0,0,0,0
59925,0,0,0,0,0
104717,0,0,0,0,0
20459,0,0,0,0,0
20882,0,0,0,0,0
9807,0,0,0,0,0
8423,1,1,1,0,0
735,0,0,0,0,0
90334,0,0,0,0,0
105740,0,0,0,0,0
99015,0,0,0,0,0
11412,0,0,0,0,0
100182,0,0,0,0,0
100959,0,0,0,0,0
47550,0,0,0,0,0
15663,0,0,0,0,0
3004,0,0,0,0,0
93935,0,0,0,0,0
43645,0,0,0,0,0
6429,4,4,4,0,0
64029,0,0,0,0,0
32912,0,0,0,0,0
20921,0,0,0,0,0
76733,0,0,0,0,0
57742,0,0,0,0,0
25710,0,0,0,0,0
7460,0,0,0,0,0
80347,0,0,0,0,0
78421,0,0,0,0,0
57982,1,1,1,0,0
57404,0,0,0,0,0
101589,0,0,0,0,0
10590,0,0,0,0,0
103112,0,0,0,0,0
57887,0,0,0,0,0
74808,0,0,0,0,0
33713,0,0,0,0,0
20689,0,0,0,0,0
26758,0,0,0,0,0
118992,1,1,1,0,0
3171,0,0,0,0,0
33017,0,0,0,0,0
65073,0,0,0,0,0
51476,0,0,0,0,0
9767,0,0,0,0,0
94054,0,0,0,0,0
29789,0,0,0,0,0
27819,0,0,0,0,0
39448,0,0,0,0,0
90353,0,0,0,0,0
55716,0,0,0,0,0
112492,0,0,0,0,0
44411,0,0,0,0,0
66892,0,0,0,0,0
69987,0,0,0,0,0
44145,0,0,0,0,0
32564,0,0,0,0,0
101161,0,0,0,0,0
45152,0,0,0,0,0
74138,0,0,0,0,0
120517,0,0,0,0,0
98982,0,0,0,0,0
118795,0,0,0,0,0
14018,0,0,0,0,0
352,0,0,0,0,0
21113,0,0,0,0,0
28021,0,0,0,0,0
100749,0,0,0,0,0
55063,0,0,0,0,0
27206,0,0,0,0,0
34811,0,0,0,0,0
91657,0,0,0,0,0
52396,0,0,0,0,0
46955,0,0,0,0,0
93195,0,0,0,0,0
86400,0,0,0,0,0
78264,1,1,1,0,0
2614,1,1,1,0,0
38415,0,0,0,0,0
46616,0,0,0,0,0
44267,0,0,0,0,0
85515,2,2,2,0,0
21983,0,0,0,0,0
7189,0,0,0,0,0
51456,0,0,0,0,0
22400,0,0,0,0,0
25283,0,0,0,0,0
77152,0,0,0,0,0
99114,0,0,0,0,0
100212,0,0,0,0,0
56800,0,0,0,0,0
72587,0,0,0,0,0
42515,0,0,0,0,0
33778,0,0,0,0,0
119394,0,0,0,0,0
106760,0,0,0,0,0
116941,0,0,0,0,0
111541,0,0,0,0,0
90746,0,0,0,0,0
97622,0,0,0,0,0
30582,0,0,0,0,0
54397,0,0,0,0,0
105050,0,0,0,0,0
52992,0,0,0,0,0
83345,0,0,0,0,0
77576,0,0,0,0,0
100095,0,0,0,0,0
14003,0,0,0,0,0
89232,0,0,0,0,0
2116,0,0,0,0,0
96793,0,0,0,0,0
80643,0,0,0,0,0
72880,0,0,0,0,0
30856,0,0,0,0,0
48884,0,0,0,0,0
73633,0,0,0,0,0
41612,0,0,0,0,0
47502,0,0,0,0,0
23864,0,0,0,0,0
17281,0,0,0,0,0
98683,0,0,0,0,0
20194,0,0,0,0,0
67238,0,0,0,0,0
13301,0,0,0,0,0
19963,0,0,0,0,0
115437,0,0,0,0,0
14521,3,3,3,0,0
113376,0,0,0,0,0
115005,0,0,0,0,0
59649,0,0,0,0,0
1813,0,0,0,0,0
61928,0,0,0,0,0
27347,0,0,0,0,0
59195,0,0,0,0,0
62650,0,0,0,0,0
92456,0,0,0,0,0
102160,0,0,0,0,0
17912,0,0,0,0,0
61575,0,0,0,0,0
88707,0,0,0,0,0
31835,0,0,0,0,0
53828,0,0,0,0,0
60757,0,0,0,0,0
91370,0,0,0,0,0
93537,0,0,0,0,0
28275,0,0,0,0,0
61280,0,0,0,0,0
1192,0,0,0,0,0
10391,0,0,0,0,0
100484,0,0,0,0,0
31233,0,0,0,0,0
63015,0,0,0,0,0
35183,0,0,0,0,0
24255,0,0,0,0,0
20745,0,0,0,0,0
62048,0,0,0,0,0
20990,0,0,0,0,0
48709,0,0,0,0,0
191,0,0,0,0,0
82984,0,0,0,0,0
86767,0,0,0,0,0
101885,0,0,0,0,0
77870,0,0,0,0,0
55306,0,0,0,0,0
85243,0,0,0,0,0
21706,0,0,0,0,0
441,0,0,0,0,0
34462,6,6,6,0,0
56333,0,0,0,0,0
21685,0,0,0,0,0
788,0,0,0,0,0
96303,0,0,0,0,0
12399,0,0,0,0,0
86230,0,0,0,0,0
117358,0,0,0,0,0
36521,0,0,0,0,0
63024,0,0,0,0,0
25483,0,0,0,0,0
18999,0,0,0,0,0
2322,0,0,0,0,0
29065,0,0,0,0,0
98014,0,0,0,0,0
71595,0,0,0,0,0
97783,0,0,0,0,0
18632,0,0,0,0,0
95292,0,0,0,0,0
27602,0,0,0,0,0
17861,0,0,0,0,0
112525,0,0,0,0,0
19152,0,0,0,0,0
84086,0,0,0,0,0
23903,0,0,0,0,0
96797,0,0,0,0,0
25847,0,0,0,0,0
58842,0,0,0,0,0
91153,0,0,0,0,0
10291,0,0,0,0,0
34757,0,0,0,0,0
29355,0,0,0,0,0
82076,0,0,0,0,0
106294,0,0,0,0,0
66928,0,0,0,0,0
93399,0,0,0,0,0
102500,0,0,0,0,0
91655,0,0,0,0,0
26117,0,0,0,0,0
76271,0,0,0,0,0
69565,0,0,0,0,0
107372,0,0,0,0,0
33485,0,0,0,0,0
86281,0,0,0,0,0
73120,0,0,0,0,0
119555,0,0,0,0,0
78161,0,0,0,0,0
10176,0,0,0,0,0
86171,0,0,0,0,0
32572,0,0,0,0,0
65360,0,0,0,0,0
118961,0,0,0,0,0
85698,0,0,0,0,0
102656,0,0,0,0,0
113833,0,0,0,0,0
9441,0,0,0,0,0
106912,0,0,0,0,0
44216,0,0,0,0,0
92746,0,0,0,0,0
5442,4,4,4,0,0
20091,0,0,0,0,0
16713,0,0,0,0,0
47415,0,0,0,0,0
93620,0,0,0,0,0
112220,0,0,0,0,0
28401,0,0,0,0,0
33860,0,0,0,0,0
19932,0,0,0,0,0
71412,0,0,0,0,0
43132,0,0,0,0,0
77978,0,0,0,0,0
88641,0,0,0,0,0
54998,0,0,0,0,0
56335,0,0,0,0,0
73754,0,0,0,0,0
54053,0,0,0,0,0
103846,0,0,0,0,0
75527,0,0,0,0,0
66265,0,0,0,0,0
110844,0,0,0,0,0
91484,0,0,0,0,0
111427,0,0,0,0,0
12472,0,0,0,0,0
9084,0,0,0,0,0
62833,0,0,0,0,0
57703,0,0,0,0,0
71274,0,0,0,0,0
112512,0,0,0,0,0
35184,0,0,0,0,0
19861,0,0,0,0,0
42347,2,2,2,0,0
72254,0,0,0,0,0
103187,0,0,0,0,0
102014,0,0,0,0,0
99282,1,1,1,0,0
11029,0,0,0,0,0
57379,0,0,0,0,0
81059,0,0,0,0,0
110994,0,0,0,0,0
38497,0,0,0,0,0
59566,0,0,0,0,0
37255,0,0,0,0,0
43225,0,0,0,0,0
1340,0,0,0,0,0
100777,0,0,0,0,0
8408,0,0,0,0,0
42380,0,0,0,0,0
96381,0,0,0,0,0
66269,0,0,0,0,0
92838,0,0,0,0,0
27182,0,0,0,0,0
25800,0,0,0,0,0
62850,0,0,0,0,0
68908,0,0,0,0,0
13074,0,0,0,0,0
103707,0,0,0,0,0
113360,0,0,0,0,0
732,0,0,0,0,0
106171,0,0,0,0,0
96844,0,0,0,0,0
118402,0,0,0,0,0
101864,0,0,0,0,0
113460,0,0,0,0,0
83238,0,0,0,0,0
111491,0,0,0,0,0
72507,0,0,0,0,0
93868,0,0,0,0,0
59546,0,0,0,0,0
34473,0,0,0,0,0
26886,0,0,0,0,0
5812,0,0,0,0,0
79565,0,0,0,0,0
39177,0,0,0,0,0
46303,0,0,0,0,0
30476,0,0,0,0,0
6296,0,0,0,0,0
88889,0,0,0,0,0
47538,0,0,0,0,0
82930,0,0,0,0,0
86463,0,0,0,0,0
43970,0,0,0,0,0
22984,0,0,0,0,0
91251,0,0,0,0,0
26048,0,0,0,0,0
58002,0,0,0,0,0
24878,0,0,0,0,0
44070,0,0,0,0,0
75393,0,0,0,0,0
25116,0,0,0,0,0
95002,0,0,0,0,0
67841,0,0,0,0,0
17597,0,0,0,0,0
32502,0,0,0,0,0
50503,0,0,0,0,0
116175,0,0,0,0,0
107374,0,0,0,0,0
56643,0,0,0,0,0
120454,0,0,0,0,0
1286,0,0,0,0,0
57351,0,0,0,0,0
53210,0,0,0,0,0
93501,0,0,0,0,0
51034,0,0,0,0,0
58724,0,0,0,0,0
89611,0,0,0,0,0
34787,0,0,0,0,0
51948,0,0,0,0,0
2783,0,0,0,0,0
11097,0,0,0,0,0
3131,0,0,0,0,0
58601,0,0,0,0,0
101983,0,0,0,0,0
92830,0,0,0,0,0
32596,0,0,0,0,0
118893,0,0,0,0,0
45942,0,0,0,0,0
116932,0,0,0,0,0
103473,0,0,0,0,0
37181,0,0,0,0,0
17262,0,0,0,0,0
86566,0,0,0,0,0
31745,0,0,0,0,0
98563,0,0,0,0,0
116793,0,0,0,0,0
21351,0,0,0,0,0
2358,0,0,0,0,0
47095,0,0,0,0,0
91087,0,0,0,0,0
108258,0,0,0,0,0
35151,0,0,0,0,0
75095,0,0,0,0,0
19268,0,0,0,0,0
15635,0,0,0,0,0
87745,0,0,0,0,0
75717,0,0,0,0,0
19685,0,0,0,0,0
38484,0,0,0,0,0
42685,0,0,0,0,0
117007,0,0,0,0,0
16381,0,0,0,0,0
70519,0,0,0,0,0
81292,0,0,0,0,0
118674,0,0,0,0,0
105347,0,0,0,0,0
105180,0,0,0,0,0
37590,0,0,0,0,0
119844,0,0,0,0,0
86310,0,0,0,0,0
88715,0,0,0,0,0
66109,0,0,0,0,0
63842,0,0,0,0,0
27647,0,0,0,0,0
25169,0,0,0,0,0
34608,0,0,0,0,0
29093,0,0,0,0,0
3152,0,0,0,0,0
22300,0,0,0,0,0
83162,0,0,0,0,0
41803,0,0,0,0,0
84793,0,0,0,0,0
70643,0,0,0,0,0
43346,0,0,0,0,0
69786,0,0,0,0,0
117425,0,0,0,0,0
91396,0,0,0,0,0
69310,0,0,0,0,0
62441,0,0,0,0,0
90232,0,0,0,0,0
2283,0,0,0,0,0
108435,0,0,0,0,0
98886,0,0,0,0,0
68945,0,0,0,0,0
77548,0,0,0,0,0
87382,0,0,0,0,0
88588,0,0,0,0,0
73711,0,0,0,0,0
60002,0,0,0,0,0
71893,0,0,0,0,0
27991,0,0,0,0,0
20702,0,0,0,0,0
77192,0,0,0,0,0
94628,0,0,0,0,0
111718,0,0,0,0,0
26262,0,0,0,0,0
118532,0,0,0,0,0
91216,0,0,0,0,0
21551,0,0,0,0,0
15044,0,0,0,0,0
20538,0,0,0,0,0
17780,0,0,0,0,0
117781,0,0,0,0,0
60086,0,0,0,0,0
51827,0,0,0,0,0
74932,0,0,0,0,0
6245,0,0,0,0,0
29416,0,0,0,0,0
110935,0,0,0,0,0
56405,0,0,0,0,0
73730,0,0,0,0,0
83023,0,0,0,0,0
118398,0,0,0,0,0
85822,0,0,0,0,0
110122,0,0,0,0,0
106185,0,0,0,0,0
61011,0,0,0,0,0
89524,0,0,0,0,0
77914,0,0,0,0,0
77358,0,0,0,0,0
4468,0,0,0,0,0
64509,0,0,0,0,0
2491,0,0,0,0,0
112380,0,0,0,0,0
44825,0,0,0,0,0
38649,0,0,0,0,0
1343,0,0,0,0,0
34013,0,0,0,0,0
59352,0,0,0,0,0
27335,0,0,0,0,0
86297,0,0,0,0,0
16306,0,0,0,0,0
10630,0,0,0,0,0
54755,0,0,0,0,0
69965,0,0,0,0,0
32045,0,0,0,0,0
68861,0,0,0,0,0
49697,0,0,0,0,0
89973,0,0,0,0,0
16844,0,0,0,0,0
38500,0,0,0,0,0
98168,0,0,0,0,0
38683,0,0,0,0,0
115958,0,0,0,0,0
3242,0,0,0,0,0
50680,0,0,0,0,0
48304,0,0,0,0,0
115654,0,0,0,0,0
67821,0,0,0,0,0
49293,0,0,0,0,0
92771,0,0,0,0,0
19972,0,0,0,0,0
111729,0,0,0,0,0
107569,0,0,0,0,0
92234,0,0,0,0,0
68883,0,0,0,0,0
87303,0,0,0,0,0
93656,0,0,0,0,0
41534,0,0,0,0,0
61967,0,0,0,0,0
103500,0,0,0,0,0
39457,0,0,0,0,0
88024,3,3,3,0,0
57374,0,0,0,0,0
108325,0,0,0,0,0
51749,0,0,0,0,0
66185,0,0,0,0,0
15103,0,0,0,0,0
30373,0,0,0,0,0
25634,0,0,0,0,0
32588,0,0,0,0,0
8296,0,0,0,0,0
54110,0,0,0,0,0
60454,0,0,0,0,0
33728,0,0,0,0,0
82926,0,0,0,0,0
3157,0,0,0,0,0
90916,0,0,0,0,0
62683,0,0,0,0,0
60985,0,0,0,0,0
114882,0,0,0,0,0
60161,0,0,0,0,0
48265,0,0,0,0,0
105922,0,0,0,0,0
70583,0,0,0,0,0
109361,0,0,0,0,0
25939,0,0,0,0,0
73159,0,0,0,0,0
21209,0,0,0,0,0
87846,0,0,0,0,0
67724,0,0,0,0,0
107570,0,0,0,0,0
12984,0,0,0,0,0
86404,0,0,0,0,0
64639,0,0,0,0,0
75029,0,0,0,0,0
45158,0,0,0,0,0
37474,0,0,0,0,0
31335,0,0,0,0,0
44435,0,0,0,0,0
114572,0,0,0,0,0
87287,0,0,0,0,0
17017,0,0,0,0,0
86165,0,0,0,0,0
112442,0,0,0,0,0
68671,0,0,0,0,0
22377,0,0,0,0,0
67958,0,0,0,0,0
93016,0,0,0,0,0
19092,0,0,0,0,0
108159,0,0,0,0,0
62518,0,0,0,0,0
117890,0,0,0,0,0
53047,0,0,0,0,0
52987,0,0,0,0,0
98852,0,0,0,0,0
5646,0,0,0,0,0
46484,0,0,0,0,0
104469,0,0,0,0,0
109218,0,0,0,0,0
113126,0,0,0,0,0
38233,0,0,0,0,0
77412,0,0,0,0,0
88662,4,4,4,0,0
59924,0,0,0,0,0
45631,0,0,0,0,0
63536,0,0,0,0,0
110814,0,0,0,0,0
101092,0,0,0,0,0
72438,0,0,0,0,0
23579,0,0,0,0,0
114192,0,0,0,0,0
28316,0,0,0,0,0
1157,0,0,0,0,0
16875,0,0,0,0,0
863,0,0,0,0,0
78050,0,0,0,0,0
114367,0,0,0,0,0
78927,0,0,0,0,0
9465,0,0,0,0,0
13140,0,0,0,0,0
93706,0,0,0,0,0
17039,0,0,0,0,0
13045,0,0,0,0,0
43268,0,0,0,0,0
55162,0,0,0,0,0
72209,0,0,0,0,0
39691,0,0,0,0,0
49182,0,0,0,0,0
19905,0,0,0,0,0
86803,0,0,0,0,0
54987,0,0,0,0,0
14424,0,0,0,0,0
14572,0,0,0,0,0
113320,0,0,0,0,0
59563,0,0,0,0,0
26995,0,0,0,0,0
94346,0,0,0,0,0
1885,0,0,0,0,0
40184,0,0,0,0,0
39894,0,0,0,0,0
68988,0,0,0,0,0
14257,0,0,0,0,0
7448,0,0,0,0,0
200,1,1,1,0,0
83485,0,0,0,0,0
10568,0,0,0,0,0
110726,0,0,0,0,0
29644,0,0,0,0,0
120348,0,0,0,0,0
44494,0,0,0,0,0
25024,0,0,0,0,0
71006,0,0,0,0,0
61501,0,0,0,0,0
36620,0,0,0,0,0
1309,0,0,0,0,0
116145,0,0,0,0,0
66577,0,0,0,0,0
86572,0,0,0,0,0
100513,0,0,0,0,0
79690,0,0,0,0,0
59078,0,0,0,0,0
33045,0,0,0,0,0
17412,0,0,0,0,0
102527,0,0,0,0,0
86523,0,0,0,0,0
2281,0,0,0,0,0
8382,0,0,0,0,0
92920,0,0,0,0,0
80330,0,0,0,0,0
120311,0,0,0,0,0
82042,0,0,0,0,0
80793,0,0,0,0,0
66985,0,0,0,0,0
65251,0,0,0,0,0
43104,0,0,0,0,0
107277,0,0,0,0,0
88222,0,0,0,0,0
101019,0,0,0,0,0
13916,0,0,0,0,0
35735,0,0,0,0,0
64871,0,0,0,0,0
18662,0,0,0,0,0
39612,0,0,0,0,0
113084,0,0,0,0,0
115500,0,0,0,0,0
46908,0,0,0,0,0
44944,0,0,0,0,0
82937,0,0,0,0,0
38220,0,0,0,0,0
33147,0,0,0,0,0
13277,0,0,0,0,0
117336,0,0,0,0,0
69648,0,0,0,0,0
27349,0,0,0,0,0
15261,0,0,0,0,0
17510,0,0,0,0,0
102270,0,0,0,0,0
43120,0,0,0,0,0
58053,0,0,0,0,0
35847,0,0,0,0,0
26634,0,0,0,0,0
59777,0,0,0,0,0
99981,0,0,0,0,0
112072,0,0,0,0,0
95959,0,0,0,0,0
14429,0,0,0,0,0
102491,0,0,0,0,0
46540,0,0,0,0,0
14630,0,0,0,0,0
20845,0,0,0,0,0
112133,0,0,0,0,0
47717,0,0,0,0,0
71334,0,0,0,0,0
15610,0,0,0,0,0
78116,0,0,0,0,0
116555,0,0,0,0,0
30578,0,0,0,0,0
7256,0,0,0,0,0
97257,0,0,0,0,0
8158,0,0,0,0,0
35117,0,0,0,0,0
106177,0,0,0,0,0
107256,0,0,0,0,0
113299,0,0,0,0,0
114189,0,0,0,0,0
99367,0,0,0,0,0
39926,0,0,0,0,0
113333,0,0,0,0,0
45562,0,0,0,0,0
115370,2,2,2,0,0
82555,0,0,0,0,0
113838,0,0,0,0,0
13153,0,0,0,0,0
23099,0,0,0,0,0
2545,0,0,0,0,0
24835,0,0,0,0,0
110952,0,0,0,0,0
110821,0,0,0,0,0
18182,0,0,0,0,0
70651,0,0,0,0,0
83836,0,0,0,0,0
68616,0,0,0,0,0
67972,0,0,0,0,0
115552,0,0,0,0,0
100405,0,0,0,0,0
77153,0,0,0,0,0
58683,0,0,0,0,0
64283,0,0,0,0,0
62950,0,0,0,0,0
89951,0,0,0,0,0
98579,0,0,0,0,0
38251,0,0,0,0,0
12471,0,0,0,0,0
40970,0,0,0,0,0
15203,0,0,0,0,0
32762,0,0,0,0,0
46087,0,0,0,0,0
56082,0,0,0,0,0
66754,0,0,0,0,0
117512,0,0,0,0,0
92851,3,3,3,0,0
104060,0,0,0,0,0
98845,0,0,0,0,0
14626,0,0,0,0,0
99723,0,0,0,0,0
72764,0,0,0,0,0
44803,0,0,0,0,0
67176,0,0,0,0,0
20827,0,0,0,0,0
117210,0,0,0,0,0
1434,0,0,0,0,0
60839,0,0,0,0,0
7569,0,0,0,0,0
78648,0,0,0,0,0
55524,0,0,0,0,0
102317,0,0,0,0,0
108378,0,0,0,0,0
72757,0,0,0,0,0
61643,0,0,0,0,0
59130,0,0,0,0,0
115966,0,0,0,0,0
63492,0,0,0,0,0
47433,0,0,0,0,0
46552,0,0,0,0,0
75974,0,0,0,0,0
71111,0,0,0,0,0
45911,0,0,0,0,0
28823,0,0,0,0,0
120431,0,0,0,0,0
11473,0,0,0,0,0
71192,0,0,0,0,0
85212,0,0,0,0,0
56383,0,0,0,0,0
114274,0,0,0,0,0
8453,0,0,0,0,0
6785,0,0,0,0,0
19291,0,0,0,0,0
102331,0,0,0,0,0
87108,0,0,0,0,0
15486,0,0,0,0,0
83629,0,0,0,0,0
96851,0,0,0,0,0
112909,0,0,0,0,0
76273,0,0,0,0,0
29608,0,0,0,0,0
15873,0,0,0,0,0
92036,0,0,0,0,0
89777,0,0,0,0,0
82614,0,0,0,0,0
31970,0,0,0,0,0
83914,0,0,0,0,0
67142,0,0,0,0,0
70859,0,0,0,0,0
11333,0,0,0,0,0
99198,0,0,0,0,0
90229,0,0,0,0,0
70461,0,0,0,0,0
78072,0,0,0,0,0
65871,0,0,0,0,0
31266,0,0,0,0,0
74614,0,0,0,0,0
86016,0,0,0,0,0
79755,0,0,0,0,0
63503,0,0,0,0,0
28916,0,0,0,0,0
43465,0,0,0,0,0
66416,0,0,0,0,0
11740,0,0,0,0,0
25502,0,0,0,0,0
45575,0,0,0,0,0
79787,0,0,0,0,0
105795,0,0,0,0,0
4837,0,0,0,0,0
47462,0,0,0,0,0
1944,0,0,0,0,0
5237,0,0,0,0,0
36740,0,0,0,0,0
86962,0,0,0,0,0
655,0,0,0,0,0
54403,0,0,0,0,0
3981,0,0,0,0,0
119944,0,0,0,0,0
67425,0,0,0,0,0
1529,0,0,0,0,0
93078,0,0,0,0,0
59432,0,0,0,0,0
44787,0,0,0,0,0
87200,0,0,0,0,0
95084,0,0,0,0,0
74168,0,0,0,0,0
102960,0,0,0,0,0
69402,0,0,0,0,0
70892,0,0,0,0,0
34562,0,0,0,0,0
67342,0,0,0,0,0
32832,0,0,0,0,0
33604,0,0,0,0,0
8166,0,0,0,0,0
23082,0,0,0,0,0
82606,0,0,0,0,0
55985,0,0,0,0,0
73014,0,0,0,0,0
64298,0,0,0,0,0
89302,0,0,0,0,0
109395,0,0,0,0,0
24203,0,0,0,0,0
60871,0,0,0,0,0
76776,0,0,0,0,0
22959,0,0,0,0,0
13055,0,0,0,0,0
78239,0,0,0,0,0
7620,0,0,0,0,0
118194,0,0,0,0,0
7126,0,0,0,0,0
111536,0,0,0,0,0
73266,0,0,0,0,0
85582,0,0,0,0,0
96592,0,0,0,0,0
78796,0,0,0,0,0
5886,0,0,0,0,0
78086,0,0,0,0,0
43281,0,0,0,0,0
60361,0,0,0,0,0
42269,0,0,0,0,0
39460,0,0,0,0,0
56228,0,0,0,0,0
102773,0,0,0,0,0
32853,0,0,0,0,0
64112,0,0,0,0,0
72578,0,0,0,0,0
115094,0,0,0,0,0
11771,0,0,0,0,0
74304,0,0,0,0,0
109984,0,0,0,0,0
51137,0,0,0,0,0
21298,0,0,0,0,0
715,0,0,0,0,0
85827,0,0,0,0,0
18564,0,0,0,0,0
85434,0,0,0,0,0
85123,0,0,0,0,0
40524,0,0,0,0,0
79885,0,0,0,0,0
55319,0,0,0,0,0
107169,0,0,0,0,0
86011,0,0,0,0,0
101962,0,0,0,0,0
67660,0,0,0,0,0
87384,0,0,0,0,0
87418,0,0,0,0,0
60446,0,0,0,0,0
48387,0,0,0,0,0
107445,0,0,0,0,0
36226,0,0,0,0,0
62721,0,0,0,0,0
50096,0,0,0,0,0
37369,0,0,0,0,0
50988,0,0,0,0,0
93631,0,0,0,0,0
100916,0,0,0,0,0
45709,0,0,0,0,0
30685,0,0,0,0,0
27543,0,0,0,0,0
33859,0,0,0,0,0
80229,0,0,0,0,0
79931,0,0,0,0,0
43361,0,0,0,0,0
90830,0,0,0,0,0
87696,0,0,0,0,0
77428,0,0,0,0,0
73632,0,0,0,0,0
114015,0,0,0,0,0
50632,3,3,3,0,0
36250,0,0,0,0,0
77474,0,0,0,0,0
46176,0,0,0,0,0
52753,0,0,0,0,0
29072,0,0,0,0,0
22781,0,0,0,0,0
73277,0,0,0,0,0
92002,3,3,3,0,0
57309,0,0,0,0,0
56578,0,0,0,0,0
34311,0,0,0,0,0
40163,0,0,0,0,0
105189,0,0,0,0,0
53290,0,0,0,0,0
66560,0,0,0,0,0
97209,0,0,0,0,0
28714,0,0,0,0,0
39577,0,0,0,0,0
106475,0,0,0,0,0
68646,0,0,0,0,0
106864,0,0,0,0,0
79475,0,0,0,0,0
29885,0,0,0,0,0
68035,0,0,0,0,0
20094,0,0,0,0,0
35535,0,0,0,0,0
104484,0,0,0,0,0
26461,0,0,0,0,0
119329,0,0,0,0,0
45681,0,0,0,0,0
82762,0,0,0,0,0
36941,0,0,0,0,0
64960,0,0,0,0,0
62150,0,0,0,0,0
3877,0,0,0,0,0
61715,0,0,0,0,0
29876,0,0,0,0,0
86123,0,0,0,0,0
87099,0,0,0,0,0
56294,0,0,0,0,0
87080,0,0,0,0,0
118664,0,0,0,0,0
19285,0,0,0,0,0
115348,0,0,0,0,0
14137,0,0,0,0,0
73757,0,0,0,0,0
3401,0,0,0,0,0
49479,0,0,0,0,0
19144,0,0,0,0,0
12803,4,4,4,0,0
91246,0,0,0,0,0
46003,0,0,0,0,0
81296,0,0,0,0,0
106571,0,0,0,0,0
61437,0,0,0,0,0
120223,0,0,0,0,0
96986,0,0,0,0,0
49184,0,0,0,0,0
67063,0,0,0,0,0
3259,0,0,0,0,0
83677,0,0,0,0,0
98254,3,3,3,0,0
67910,0,0,0,0,0
66224,0,0,0,0,0
30495,0,0,0,0,0
38302,0,0,0,0,0
108169,0,0,0,0,0
45267,0,0,0,0,0
119401,0,0,0,0,0
57586,0,0,0,0,0
27954,0,0,0,0,0
29542,0,0,0,0,0
71057,0,0,0,0,0
14165,0,0,0,0,0
48355,0,0,0,0,0
98924,0,0,0,0,0
15388,0,0,0,0,0
100944,0,0,0,0,0
20086,0,0,0,0,0
45126,0,0,0,0,0
105621,0,0,0,0,0
29335,0,0,0,0,0
73646,0,0,0,0,0
65739,0,0,0,0,0
32060,0,0,0,0,0
24107,0,0,0,0,0
102893,0,0,0,0,0
8589,0,0,0,0,0
32019,0,0,0,0,0
46683,0,0,0,0,0
88227,3,3,3,0,0
14492,0,0,0,0,0
34675,0,0,0,0,0
46866,0,0,0,0,0
48480,0,0,0,0,0
24716,2,2,2,0,0
92536,0,0,0,0,0
45834,0,0,0,0,0
120519,0,0,0,0,0
113516,0,0,0,0,0
64084,0,0,0,0,0
22786,0,0,0,0,0
87474,1,1,1,0,0
59141,0,0,0,0,0
80445,0,0,0,0,0
88119,0,0,0,0,0
64314,0,0,0,0,0
15670,0,0,0,0,0
110685,0,0,0,0,0
39537,0,0,0,0,0
70874,0,0,0,0,0
19104,0,0,0,0,0
95556,0,0,0,0,0
31573,1,1,1,0,0
10252,0,0,0,0,0
118298,0,0,0,0,0
117003,0,0,0,0,0
116094,0,0,0,0,0
101890,0,0,0,0,0
14968,0,0,0,0,0
10837,0,0,0,0,0
104553,0,0,0,0,0
35111,0,0,0,0,0
72457,0,0,0,0,0
31244,0,0,0,0,0
72124,0,0,0,0,0
75023,0,0,0,0,0
14911,0,0,0,0,0
17140,0,0,0,0,0
71039,0,0,0,0,0
48785,0,0,0,0,0
37326,0,0,0,0,0
93125,0,0,0,0,0
86878,0,0,0,0,0
57560,0,0,0,0,0
51382,0,0,0,0,0
29990,0,0,0,0,0
112349,0,0,0,0,0
71823,0,0,0,0,0
112248,0,0,0,0,0
91863,0,0,0,0,0
81980,0,0,0,0,0
119088,0,0,0,0,0
120145,0,0,0,0,0
30238,0,0,0,0,0
112176,0,0,0,0,0
70142,0,0,0,0,0
38,0,0,0,0,0
24492,0,0,0,0,0
117707,0,0,0,0,0
7764,0,0,0,0,0
21996,0,0,0,0,0
106305,0,0,0,0,0
107576,0,0,0,0,0
39948,0,0,0,0,0
5988,0,0,0,0,0
92416,2,2,2,0,0
80170,0,0,0,0,0
42003,0,0,0,0,0
15551,0,0,0,0,0
13365,0,0,0,0,0
57514,0,0,0,0,0
33149,0,0,0,0,0
26075,0,0,0,0,0
28839,0,0,0,0,0
19075,0,0,0,0,0
73679,0,0,0,0,0
55402,0,0,0,0,0
97585,0,0,0,0,0
66644,0,0,0,0,0
40733,0,0,0,0,0
60457,0,0,0,0,0
63463,0,0,0,0,0
112836,0,0,0,0,0
112294,0,0,0,0,0
39280,0,0,0,0,0
23160,0,0,0,0,0
1212,0,0,0,0,0
39922,0,0,0,0,0
36600,0,0,0,0,0
102103,0,0,0,0,0
117443,0,0,0,0,0
53403,0,0,0,0,0
51900,0,0,0,0,0
53129,0,0,0,0,0
39170,0,0,0,0,0
3017,0,0,0,0,0
32278,0,0,0,0,0
50333,0,0,0,0,0
73698,0,0,0,0,0
49520,0,0,0,0,0
92944,0,0,0,0,0
99146,0,0,0,0,0
69400,0,0,0,0,0
63281,0,0,0,0,0
46753,0,0,0,0,0
46555,0,0,0,0,0
82191,0,0,0,0,0
42304,0,0,0,0,0
62173,0,0,0,0,0
55743,0,0,0,0,0
109242,0,0,0,0,0
90806,0,0,0,0,0
27116,0,0,0,0,0
77827,0,0,0,0,0
50296,0,0,0,0,0
100653,0,0,0,0,0
93269,0,0,0,0,0
7427,0,0,0,0,0
62987,0,0,0,0,0
66753,0,0,0,0,0
30410,0,0,0,0,0
17945,0,0,0,0,0
89622,0,0,0,0,0
113184,0,0,0,0,0
73949,0,0,0,0,0
36153,0,0,0,0,0
77594,0,0,0,0,0
74925,0,0,0,0,0
60231,0,0,0,0,0
2666,0,0,0,0,0
36856,0,0,0,0,0
49160,0,0,0,0,0
78830,0,0,0,0,0
112739,0,0,0,0,0
67711,0,0,0,0,0
63768,0,0,0,0,0
112851,1,1,1,0,0
39496,0,0,0,0,0
35899,0,0,0,0,0
78367,1,1,1,0,0
50342,0,0,0,0,0
18247,0,0,0,0,0
94771,0,0,0,0,0
9385,0,0,0,0,0
51686,0,0,0,0,0
89163,0,0,0,0,0
109424,0,0,0,0,0
20789,0,0,0,0,0
16991,0,0,0,0,0
76812,0,0,0,0,0
52738,0,0,0,0,0
74784,0,0,0,0,0
33663,0,0,0,0,0
65426,0,0,0,0,0
4791,0,0,0,0,0
102409,0,0,0,0,0
34132,0,0,0,0,0
92988,0,0,0,0,0
24624,0,0,0,0,0
40264,0,0,0,0,0
88629,0,0,0,0,0
33395,0,0,0,0,0
95528,0,0,0,0,0
2110,0,0,0,0,0
60381,0,0,0,0,0
60272,0,0,0,0,0
34514,0,0,0,0,0
68687,0,0,0,0,0
94848,0,0,0,0,0
59704,3,3,3,0,0
57349,0,0,0,0,0
110662,0,0,0,0,0
61079,0,0,0,0,0
68106,0,0,0,0,0
118512,0,0,0,0,0
31542,0,0,0,0,0
72175,0,0,0,0,0
94575,0,0,0,0,0
4780,0,0,0,0,0
120310,1,1,1,0,0
997,0,0,0,0,0
101638,0,0,0,0,0
96185,0,0,0,0,0
61430,0,0,0,0,0
91055,0,0,0,0,0
87545,0,0,0,0,0
72070,0,0,0,0,0
77967,0,0,0,0,0
92831,0,0,0,0,0
119565,0,0,0,0,0
16229,0,0,0,0,0
13970,0,0,0,0,0
33711,0,0,0,0,0
107313,0,0,0,0,0
33377,0,0,0,0,0
38975,0,0,0,0,0
11591,0,0,0,0,0
106225,0,0,0,0,0
100722,0,0,0,0,0
9435,0,0,0,0,0
18494,0,0,0,0,0
3509,0,0,0,0,0
46813,0,0,0,0,0
88728,0,0,0,0,0
41485,0,0,0,0,0
73918,0,0,0,0,0
81990,0,0,0,0,0
25936,0,0,0,0,0
82302,0,0,0,0,0
60526,0,0,0,0,0
61244,0,0,0,0,0
21907,0,0,0,0,0
30272,0,0,0,0,0
96739,0,0,0,0,0
113775,0,0,0,0,0
14716,0,0,0,0,0
84484,0,0,0,0,0
12124,0,0,0,0,0
102698,0,0,0,0,0
48974,0,0,0,0,0
78045,0,0,0,0,0
73766,0,0,0,0,0
78642,0,0,0,0,0
59431,0,0,0,0,0
114046,0,0,0,0,0
12598,0,0,0,0,0
118974,0,0,0,0,0
25359,0,0,0,0,0
56683,0,0,0,0,0
85655,0,0,0,0,0
59030,0,0,0,0,0
56591,0,0,0,0,0
105685,0,0,0,0,0
91266,0,0,0,0,0
91704,0,0,0,0,0
1413,0,0,0,0,0
30278,0,0,0,0,0
58039,0,0,0,0,0
91820,0,0,0,0,0
118344,0,0,0,0,0
86122,0,0,0,0,0
66648,0,0,0,0,0
118482,0,0,0,0,0
46560,0,0,0,0,0
14738,0,0,0,0,0
72083,0,0,0,0,0
35925,0,0,0,0,0
86502,0,0,0,0,0
4119,0,0,0,0,0
76789,0,0,0,0,0
11867,0,0,0,0,0
95575,0,0,0,0,0
64497,0,0,0,0,0
86124,0,0,0,0,0
7532,0,0,0,0,0
71638,0,0,0,0,0
12943,6,6,6,0,0
55333,0,0,0,0,0
25573,2,2,2,0,0
49549,0,0,0,0,0
20826,0,0,0,0,0
24405,0,0,0,0,0
86960,0,0,0,0,0
45145,0,0,0,0,0
26009,2,2,2,0,0
74676,0,0,0,0,0
38242,0,0,0,0,0
110981,0,0,0,0,0
66804,0,0,0,0,0
48466,0,0,0,0,0
39489,0,0,0,0,0
76024,0,0,0,0,0
21997,0,0,0,0,0
116831,0,0,0,0,0
54024,0,0,0,0,0
107189,0,0,0,0,0
84040,0,0,0,0,0
1670,0,0,0,0,0
94433,3,3,3,0,0
61706,0,0,0,0,0
43965,0,0,0,0,0
16329,0,0,0,0,0
115413,0,0,0,0,0
12868,0,0,0,0,0
67419,0,0,0,0,0
82163,0,0,0,0,0
9291,0,0,0,0,0
28841,0,0,0,0,0
54438,0,0,0,0,0
110728,0,0,0,0,0
65494,0,0,0,0,0
12789,0,0,0,0,0
105284,0,0,0,0,0
74351,0,0,0,0,0
60273,0,0,0,0,0
42020,0,0,0,0,0
11524,0,0,0,0,0
38573,0,0,0,0,0
33506,0,0,0,0,0
61626,0,0,0,0,0
43249,0,0,0,0,0
2153,0,0,0,0,0
63894,0,0,0,0,0
2033,0,0,0,0,0
104887,0,0,0,0,0
5668,0,0,0,0,0
96558,0,0,0,0,0
11363,0,0,0,0,0
78932,0,0,0,0,0
90325,0,0,0,0,0
10147,0,0,0,0,0
80253,0,0,0,0,0
110284,0,0,0,0,0
45029,0,0,0,0,0
20384,0,0,0,0,0
19514,0,0,0,0,0
45814,0,0,0,0,0
120503,0,0,0,0,0
37441,0,0,0,0,0
107004,0,0,0,0,0
73055,0,0,0,0,0
101657,0,0,0,0,0
92837,0,0,0,0,0
112432,0,0,0,0,0
544,0,0,0,0,0
8113,0,0,0,0,0
77663,0,0,0,0,0
29415,0,0,0,0,0
57436,0,0,0,0,0
108513,0,0,0,0,0
77251,0,0,0,0,0
55960,0,0,0,0,0
37284,0,0,0,0,0
40898,0,0,0,0,0
83964,0,0,0,0,0
27995,0,0,0,0,0
113823,0,0,0,0,0
120084,0,0,0,0,0
106604,0,0,0,0,0
34703,0,0,0,0,0
30972,0,0,0,0,0
61619,0,0,0,0,0
52344,0,0,0,0,0
58863,0,0,0,0,0
106683,0,0,0,0,0
116492,0,0,0,0,0
18924,4,4,4,0,0
42588,0,0,0,0,0
75009,0,0,0,0,0
86029,0,0,0,0,0
46230,0,0,0,0,0
82220,0,0,0,0,0
67905,0,0,0,0,0
42427,0,0,0,0,0
35465,0,0,0,0,0
100464,0,0,0,0,0
104977,0,0,0,0,0
90877,0,0,0,0,0
37715,0,0,0,0,0
77611,0,0,0,0,0
9098,0,0,0,0,0
114285,0,0,0,0,0
47224,0,0,0,0,0
21229,0,0,0,0,0
73817,0,0,0,0,0
118886,0,0,0,0,0
82893,0,0,0,0,0
112412,0,0,0,0,0
24192,0,0,0,0,0
36221,0,0,0,0,0
83728,0,0,0,0,0
28896,0,0,0,0,0
87718,0,0,0,0,0
49536,0,0,0,0,0
83538,0,0,0,0,0
102934,0,0,0,0,0
39623,0,0,0,0,0
48586,0,0,0,0,0
8357,0,0,0,0,0
20255,0,0,0,0,0
85001,0,0,0,0,0
67190,0,0,0,0,0
35092,0,0,0,0,0
102155,0,0,0,0,0
39362,0,0,0,0,0
69670,0,0,0,0,0
76325,0,0,0,0,0
916,0,0,0,0,0
24655,0,0,0,0,0
53075,0,0,0,0,0
8750,0,0,0,0,0
48264,0,0,0,0,0
81914,0,0,0,0,0
6020,0,0,0,0,0
106601,0,0,0,0,0
93929,0,0,0,0,0
61473,0,0,0,0,0
41633,0,0,0,0,0
92555,0,0,0,0,0
65930,0,0,0,0,0
76837,0,0,0,0,0
16886,0,0,0,0,0
89954,0,0,0,0,0
94772,0,0,0,0,0
14275,0,0,0,0,0
19307,0,0,0,0,0
26162,0,0,0,0,0
37972,0,0,0,0,0
117368,0,0,0,0,0
78113,0,0,0,0,0
9841,0,0,0,0,0
13575,0,0,0,0,0
116337,0,0,0,0,0
42407,0,0,0,0,0
88328,0,0,0,0,0
96535,0,0,0,0,0
45637,0,0,0,0,0
59833,0,0,0,0,0
114760,0,0,0,0,0
70664,0,0,0,0,0
73955,0,0,0,0,0
116350,0,0,0,0,0
40610,0,0,0,0,0
49925,0,0,0,0,0
110062,0,0,0,0,0
67431,0,0,0,0,0
42026,0,0,0,0,0
73802,0,0,0,0,0
103033,0,0,0,0,0
7465,0,0,0,0,0
52958,0,0,0,0,0
74731,0,0,0,0,0
101770,0,0,0,0,0
103809,0,0,0,0,0
89804,0,0,0,0,0
94845,0,0,0,0,0
100298,0,0,0,0,0
2532,0,0,0,0,0
30066,0,0,0,0,0
53550,0,0,0,0,0
64928,0,0,0,0,0
110875,0,0,0,0,0
29237,0,0,0,0,0
24964,0,0,0,0,0
67009,0,0,0,0,0
21532,0,0,0,0,0
60784,0,0,0,0,0
48020,0,0,0,0,0
16402,0,0,0,0,0
35305,0,0,0,0,0
46107,0,0,0,0,0
24550,0,0,0,0,0
10060,0,0,0,0,0
15674,0,0,0,0,0
96327,0,0,0,0,0
92317,0,0,0,0,0
4851,0,0,0,0,0
105148,0,0,0,0,0
64542,0,0,0,0,0
47688,0,0,0,0,0
22771,0,0,0,0,0
64475,0,0,0,0,0
81898,0,0,0,0,0
55713,0,0,0,0,0
89376,0,0,0,0,0
26476,0,0,0,0,0
59287,3,3,3,0,0
30137,0,0,0,0,0
36628,1,1,1,0,0
32232,0,0,0,0,0
13302,0,0,0,0,0
118351,0,0,0,0,0
27360,0,0,0,0,0
38479,0,0,0,0,0
47225,0,0,0,0,0
49813,0,0,0,0,0
1007,0,0,0,0,0
74210,0,0,0,0,0
104502,0,0,0,0,0
55471,0,0,0,0,0
109837,0,0,0,0,0
9018,0,0,0,0,0
54044,0,0,0,0,0
100128,0,0,0,0,0
68007,0,0,0,0,0
94389,0,0,0,0,0
67033,0,0,0,0,0
94788,0,0,0,0,0
19341,0,0,0,0,0
82161,0,0,0,0,0
25801,0,0,0,0,0
23812,0,0,0,0,0
32973,0,0,0,0,0
12113,0,0,0,0,0
42996,0,0,0,0,0
43003,0,0,0,0,0
114601,0,0,0,0,0
74690,0,0,0,0,0
8847,0,0,0,0,0
8713,0,0,0,0,0
10370,0,0,0,0,0
95912,0,0,0,0,0
56319,0,0,0,0,0
46091,0,0,0,0,0
82844,0,0,0,0,0
108047,0,0,0,0,0
106715,1,1,1,0,0
105661,0,0,0,0,0
14892,0,0,0,0,0
93443,0,0,0,0,0
101675,0,0,0,0,0
60854,0,0,0,0,0
31825,0,0,0,0,0
18113,0,0,0,0,0
105658,0,0,0,0,0
41418,0,0,0,0,0
48609,0,0,0,0,0
95599,0,0,0,0,0
39439,0,0,0,0,0
35156,0,0,0,0,0
29041,0,0,0,0,0
57794,0,0,0,0,0
115122,0,0,0,0,0
2770,0,0,0,0,0
83083,0,0,0,0,0
43316,0,0,0,0,0
96026,0,0,0,0,0
43971,0,0,0,0,0
83596,0,0,0,0,0
75995,0,0,0,0,0
33948,0,0,0,0,0
22762,0,0,0,0,0
71095,0,0,0,0,0
71214,0,0,0,0,0
53314,0,0,0,0,0
55990,0,0,0,0,0
93015,0,0,0,0,0
1269,0,0,0,0,0
6801,0,0,0,0,0
94131,0,0,0,0,0
46675,0,0,0,0,0
83258,0,0,0,0,0
14765,0,0,0,0,0
5575,0,0,0,0,0
49984,0,0,0,0,0
59852,0,0,0,0,0
91155,0,0,0,0,0
86415,0,0,0,0,0
111792,0,0,0,0,0
45217,0,0,0,0,0
38469,0,0,0,0,0
107032,0,0,0,0,0
23115,0,0,0,0,0
29157,0,0,0,0,0
94903,0,0,0,0,0
61616,0,0,0,0,0
32332,0,0,0,0,0
63018,0,0,0,0,0
115692,0,0,0,0,0
41175,0,0,0,0,0
83316,0,0,0,0,0
63715,0,0,0,0,0
84284,0,0,0,0,0
74895,0,0,0,0,0
3208,0,0,0,0,0
75774,0,0,0,0,0
71036,0,0,0,0,0
97328,0,0,0,0,0
115600,0,0,0,0,0
112415,0,0,0,0,0
67500,0,0,0,0,0
32485,0,0,0,0,0
8363,0,0,0,0,0
10988,0,0,0,0,0
112971,0,0,0,0,0
102576,0,0,0,0,0
65869,0,0,0,0,0
88821,0,0,0,0,0
114740,0,0,0,0,0
115097,0,0,0,0,0
31205,0,0,0,0,0
24818,0,0,0,0,0
85574,1,1,1,0,0
11511,0,0,0,0,0
53211,0,0,0,0,0
102824,0,0,0,0,0
2053,0,0,0,0,0
24744,0,0,0,0,0
26797,0,0,0,0,0
34756,0,0,0,0,0
74855,0,0,0,0,0
23465,0,0,0,0,0
119066,0,0,0,0,0
37150,0,0,0,0,0
8272,0,0,0,0,0
61518,0,0,0,0,0
59816,0,0,0,0,0
91734,0,0,0,0,0
112777,0,0,0,0,0
95132,0,0,0,0,0
81729,0,0,0,0,0
58867,0,0,0,0,0
70598,0,0,0,0,0
1112,0,0,0,0,0
53651,0,0,0,0,0
76957,0,0,0,0,0
63208,0,0,0,0,0
32009,0,0,0,0,0
98882,0,0,0,0,0
119205,0,0,0,0,0
46764,0,0,0,0,0
118077,0,0,0,0,0
79830,0,0,0,0,0
71719,0,0,0,0,0
60942,0,0,0,0,0
116339,0,0,0,0,0
87193,0,0,0,0,0
14802,0,0,0,0,0
53206,0,0,0,0,0
22942,0,0,0,0,0
40094,0,0,0,0,0
65855,0,0,0,0,0
68148,0,0,0,0,0
7133,0,0,0,0,0
95895,0,0,0,0,0
35064,0,0,0,0,0
106747,0,0,0,0,0
15495,0,0,0,0,0
29244,0,0,0,0,0
4215,0,0,0,0,0
35005,0,0,0,0,0
103014,0,0,0,0,0
10555,0,0,0,0,0
24597,0,0,0,0,0
106119,0,0,0,0,0
103129,0,0,0,0,0
12384,0,0,0,0,0
114738,0,0,0,0,0
57740,0,0,0,0,0
106194,0,0,0,0,0
95179,0,0,0,0,0
114549,0,0,0,0,0
38926,0,0,0,0,0
6302,0,0,0,0,0
120243,0,0,0,0,0
80023,0,0,0,0,0
16922,0,0,0,0,0
110705,0,0,0,0,0
110268,0,0,0,0,0
22844,0,0,0,0,0
71590,0,0,0,0,0
110328,0,0,0,0,0
55369,0,0,0,0,0
109074,0,0,0,0,0
74177,0,0,0,0,0
26432,0,0,0,0,0
33174,0,0,0,0,0
80416,0,0,0,0,0
70623,0,0,0,0,0
86425,0,0,0,0,0
97924,0,0,0,0,0
33901,0,0,0,0,0
19910,0,0,0,0,0
117620,0,0,0,0,0
19467,0,0,0,0,0
107584,0,0,0,0,0
70237,0,0,0,0,0
94158,0,0,0,0,0
54861,0,0,0,0,0
445,0,0,0,0,0
60047,0,0,0,0,0
18647,0,0,0,0,0
90072,0,0,0,0,0
93943,0,0,0,0,0
76261,0,0,0,0,0
44627,0,0,0,0,0
119280,0,0,0,0,0
87925,0,0,0,0,0
98916,0,0,0,0,0
81374,0,0,0,0,0
52302,0,0,0,0,0
84436,0,0,0,0,0
56651,0,0,0,0,0
113345,0,0,0,0,0
90586,0,0,0,0,0
30290,0,0,0,0,0
23880,0,0,0,0,0
40379,0,0,0,0,0
118557,0,0,0,0,0
7854,0,0,0,0,0
67661,0,0,0,0,0
58935,0,0,0,0,0
26309,0,0,0,0,0
38407,0,0,0,0,0
98625,0,0,0,0,0
84134,0,0,0,0,0
25814,0,0,0,0,0
41074,0,0,0,0,0
23405,0,0,0,0,0
110646,0,0,0,0,0
47355,0,0,0,0,0
75707,0,0,0,0,0
59283,0,0,0,0,0
77332,0,0,0,0,0
40826,0,0,0,0,0
96259,0,0,0,0,0
86912,0,0,0,0,0
114280,0,0,0,0,0
119793,0,0,0,0,0
119,0,0,0,0,0
103127,0,0,0,0,0
66981,0,0,0,0,0
39411,0,0,0,0,0
6518,0,0,0,0,0
113507,0,0,0,0,0
248,0,0,0,0,0
16123,0,0,0,0,0
81437,0,0,0,0,0
109964,0,0,0,0,0
79720,0,0,0,0,0
86649,0,0,0,0,0
56506,0,0,0,0,0
32487,0,0,0,0,0
99624,0,0,0,0,0
32391,0,0,0,0,0
95423,0,0,0,0,0
78691,0,0,0,0,0
118248,0,0,0,0,0
106323,0,0,0,0,0
86325,0,0,0,0,0
91542,0,0,0,0,0
4099,0,0,0,0,0
7983,0,0,0,0,0
49657,0,0,0,0,0
54745,0,0,0,0,0
59979,0,0,0,0,0
42079,0,0,0,0,0
50493,0,0,0,0,0
100204,0,0,0,0,0
10514,0,0,0,0,0
65472,0,0,0,0,0
68546,0,0,0,0,0
43135,0,0,0,0,0
42048,0,0,0,0,0
107869,0,0,0,0,0
93229,0,0,0,0,0
6427,0,0,0,0,0
39793,0,0,0,0,0
44837,0,0,0,0,0
117409,0,0,0,0,0
29246,0,0,0,0,0
111398,0,0,0,0,0
54257,0,0,0,0,0
4214,0,0,0,0,0
985,0,0,0,0,0
82690,0,0,0,0,0
39523,0,0,0,0,0
96569,0,0,0,0,0
95782,0,0,0,0,0
76351,0,0,0,0,0
64310,0,0,0,0,0
63769,0,0,0,0,0
1787,0,0,0,0,0
114926,0,0,0,0,0
24186,0,0,0,0,0
64100,0,0,0,0,0
112677,0,0,0,0,0
45229,0,0,0,0,0
56507,0,0,0,0,0
44927,0,0,0,0,0
89028,0,0,0,0,0
97835,0,0,0,0,0
15830,0,0,0,0,0
105055,0,0,0,0,0
65125,0,0,0,0,0
17461,0,0,0,0,0
90355,0,0,0,0,0
86558,0,0,0,0,0
8127,0,0,0,0,0
9381,0,0,0,0,0
1897,0,0,0,0,0
116864,0,0,0,0,0
104778,0,0,0,0,0
38992,0,0,0,0,0
89730,0,0,0,0,0
11534,0,0,0,0,0
22772,0,0,0,0,0
76252,0,0,0,0,0
101145,0,0,0,0,0
2312,0,0,0,0,0
37729,0,0,0,0,0
102701,0,0,0,0,0
38222,0,0,0,0,0
23334,0,0,0,0,0
37144,0,0,0,0,0
104160,0,0,0,0,0
69192,0,0,0,0,0
101873,0,0,0,0,0
51816,0,0,0,0,0
60229,0,0,0,0,0
54878,0,0,0,0,0
41232,0,0,0,0,0
38033,0,0,0,0,0
120139,0,0,0,0,0
29392,0,0,0,0,0
91427,0,0,0,0,0
49843,0,0,0,0,0
103180,0,0,0,0,0
34116,0,0,0,0,0
69320,0,0,0,0,0
29053,0,0,0,0,0
51485,0,0,0,0,0
26755,0,0,0,0,0
17775,0,0,0,0,0
85622,0,0,0,0,0
22056,0,0,0,0,0
62495,0,0,0,0,0
16731,0,0,0,0,0
104213,0,0,0,0,0
60006,0,0,0,0,0
115391,0,0,0,0,0
118197,0,0,0,0,0
44417,0,0,0,0,0
102452,0,0,0,0,0
40787,0,0,0,0,0
55003,0,0,0,0,0
110405,0,0,0,0,0
29962,0,0,0,0,0
105123,0,0,0,0,0
105075,0,0,0,0,0
55881,0,0,0,0,0
98128,0,0,0,0,0
17248,0,0,0,0,0
106851,0,0,0,0,0
65629,0,0,0,0,0
39491,0,0,0,0,0
14115,0,0,0,0,0
9236,0,0,0,0,0
72552,0,0,0,0,0
24602,0,0,0,0,0
86629,0,0,0,0,0
81693,0,0,0,0,0
11215,0,0,0,0,0
47375,0,0,0,0,0
87826,0,0,0,0,0
71043,0,0,0,0,0
95611,0,0,0,0,0
101663,1,1,1,0,0
11721,0,0,0,0,0
78540,0,0,0,0,0
100017,0,0,0,0,0
80246,0,0,0,0,0
86880,0,0,0,0,0
18101,0,0,0,0,0
43363,0,0,0,0,0
57696,0,0,0,0,0
57823,0,0,0,0,0
62066,0,0,0,0,0
111697,0,0,0,0,0
114357,0,0,0,0,0
1842,0,0,0,0,0
19306,0,0,0,0,0
102883,0,0,0,0,0
34066,0,0,0,0,0
50187,0,0,0,0,0
103163,0,0,0,0,0
114238,0,0,0,0,0
54319,0,0,0,0,0
118270,0,0,0,0,0
114200,0,0,0,0,0
10916,0,0,0,0,0
24241,0,0,0,0,0
111060,0,0,0,0,0
61638,0,0,0,0,0
1985,0,0,0,0,0
8856,0,0,0,0,0
61558,0,0,0,0,0
4240,0,0,0,0,0
97193,0,0,0,0,0
85700,0,0,0,0,0
46162,0,0,0,0,0
49016,0,0,0,0,0
18477,1,1,1,0,0
39513,0,0,0,0,0
33391,0,0,0,0,0
56650,0,0,0,0,0
72921,0,0,0,0,0
34841,0,0,0,0,0
93888,5,5,5,0,0
57640,0,0,0,0,0
96968,0,0,0,0,0
52989,0,0,0,0,0
109091,0,0,0,0,0
41395,0,0,0,0,0
58507,0,0,0,0,0
87029,0,0,0,0,0
25218,0,0,0,0,0
81800,0,0,0,0,0
104844,0,0,0,0,0
41747,0,0,0,0,0
12184,0,0,0,0,0
97026,2,2,2,0,0
57883,0,0,0,0,0
10181,0,0,0,0,0
48344,0,0,0,0,0
31515,0,0,0,0,0
56951,0,0,0,0,0
103101,0,0,0,0,0
3783,0,0,0,0,0
34613,0,0,0,0,0
94443,0,0,0,0,0
42817,0,0,0,0,0
63739,0,0,0,0,0
113767,0,0,0,0,0
106407,0,0,0,0,0
68154,0,0,0,0,0
98275,0,0,0,0,0
18859,0,0,0,0,0
21471,0,0,0,0,0
92371,0,0,0,0,0
72362,0,0,0,0,0
75655,0,0,0,0,0
86643,0,0,0,0,0
85474,0,0,0,0,0
90587,0,0,0,0,0
78776,0,0,0,0,0
94416,0,0,0,0,0
91821,0,0,0,0,0
33730,0,0,0,0,0
101142,0,0,0,0,0
115587,0,0,0,0,0
12397,0,0,0,0,0
105469,0,0,0,0,0
30055,0,0,0,0,0
103314,0,0,0,0,0
61818,0,0,0,0,0
42865,0,0,0,0,0
60692,0,0,0,0,0
32854,0,0,0,0,0
16026,0,0,0,0,0
94047,0,0,0,0,0
39118,0,0,0,0,0
56263,0,0,0,0,0
3423,0,0,0,0,0
37377,0,0,0,0,0
102501,0,0,0,0,0
46086,0,0,0,0,0
49922,0,0,0,0,0
36917,0,0,0,0,0
112458,0,0,0,0,0
63812,0,0,0,0,0
4043,0,0,0,0,0
50757,0,0,0,0,0
115643,0,0,0,0,0
14965,0,0,0,0,0
16929,0,0,0,0,0
2481,0,0,0,0,0
66980,0,0,0,0,0
86066,0,0,0,0,0
57345,0,0,0,0,0
3455,0,0,0,0,0
62934,0,0,0,0,0
19051,0,0,0,0,0
103901,0,0,0,0,0
41075,0,0,0,0,0
63249,0,0,0,0,0
26979,0,0,0,0,0
98658,0,0,0,0,0
101406,0,0,0,0,0
74591,0,0,0,0,0
54273,0,0,0,0,0
795,0,0,0,0,0
105160,0,0,0,0,0
37119,0,0,0,0,0
92510,0,0,0,0,0
68208,0,0,0,0,0
91775,0,0,0,0,0
47724,0,0,0,0,0
101626,0,0,0,0,0
7755,0,0,0,0,0
13572,0,0,0,0,0
14801,0,0,0,0,0
19372,0,0,0,0,0
72878,0,0,0,0,0
72257,0,0,0,0,0
8268,0,0,0,0,0
1806,0,0,0,0,0
49439,0,0,0,0,0
44984,0,0,0,0,0
35165,0,0,0,0,0
14380,0,0,0,0,0
105177,0,0,0,0,0
82519,0,0,0,0,0
26422,0,0,0,0,0
112235,0,0,0,0,0
60449,0,0,0,0,0
117029,0,0,0,0,0
33211,0,0,0,0,0
2854,1,1,1,0,0
42632,0,0,0,0,0
101038,0,0,0,0,0
32642,0,0,0,0,0
87237,0,0,0,0,0
117658,0,0,0,0,0
31988,0,0,0,0,0
86645,0,0,0,0,0
100961,0,0,0,0,0
99560,0,0,0,0,0
23858,0,0,0,0,0
49191,0,0,0,0,0
83591,0,0,0,0,0
41782,0,0,0,0,0
73079,0,0,0,0,0
83582,0,0,0,0,0
32071,0,0,0,0,0
118198,0,0,0,0,0
12766,0,0,0,0,0
117326,0,0,0,0,0
84673,0,0,0,0,0
6916,0,0,0,0,0
6314,0,0,0,0,0
115905,0,0,0,0,0
10099,0,0,0,0,0
62623,0,0,0,0,0
72564,0,0,0,0,0
82821,0,0,0,0,0
16935,0,0,0,0,0
52760,0,0,0,0,0
85161,0,0,0,0,0
20323,0,0,0,0,0
12415,0,0,0,0,0
61710,0,0,0,0,0
70177,0,0,0,0,0
80308,0,0,0,0,0
104839,0,0,0,0,0
83323,1,1,1,0,0
116981,0,0,0,0,0
68552,0,0,0,0,0
23861,0,0,0,0,0
12086,0,0,0,0,0
19545,0,0,0,0,0
96719,0,0,0,0,0
40128,0,0,0,0,0
101339,0,0,0,0,0
14841,0,0,0,0,0
85099,0,0,0,0,0
82044,0,0,0,0,0
70188,0,0,0,0,0
10708,0,0,0,0,0
116209,0,0,0,0,0
61762,0,0,0,0,0
72056,0,0,0,0,0
58889,0,0,0,0,0
90667,0,0,0,0,0
689,0,0,0,0,0
12670,0,0,0,0,0
11587,0,0,0,0,0
41950,0,0,0,0,0
36907,0,0,0,0,0
76711,0,0,0,0,0
52195,0,0,0,0,0
34070,0,0,0,0,0
11980,0,0,0,0,0
79996,0,0,0,0,0
11686,0,0,0,0,0
52783,0,0,0,0,0
57270,0,0,0,0,0
111868,0,0,0,0,0
73389,0,0,0,0,0
75399,0,0,0,0,0
5155,0,0,0,0,0
103882,0,0,0,0,0
76160,0,0,0,0,0
12096,0,0,0,0,0
89927,0,0,0,0,0
17989,0,0,0,0,0
35301,0,0,0,0,0
81054,0,0,0,0,0
56649,0,0,0,0,0
7756,0,0,0,0,0
29553,0,0,0,0,0
66149,0,0,0,0,0
114256,0,0,0,0,0
12971,0,0,0,0,0
9913,0,0,0,0,0
90818,0,0,0,0,0
77351,0,0,0,0,0
89771,0,0,0,0,0
104257,0,0,0,0,0
104132,0,0,0,0,0
106855,0,0,0,0,0
86504,0,0,0,0,0
8990,0,0,0,0,0
73981,0,0,0,0,0
95898,0,0,0,0,0
49750,0,0,0,0,0
27235,0,0,0,0,0
89588,2,2,2,0,0
51495,0,0,0,0,0
32786,0,0,0,0,0
37630,0,0,0,0,0
8317,0,0,0,0,0
66132,0,0,0,0,0
48733,0,0,0,0,0
23681,0,0,0,0,0
65893,0,0,0,0,0
28167,0,0,0,0,0
23729,0,0,0,0,0
37980,0,0,0,0,0
73181,0,0,0,0,0
100099,0,0,0,0,0
39349,0,0,0,0,0
97631,0,0,0,0,0
5925,0,0,0,0,0
116604,0,0,0,0,0
74269,0,0,0,0,0
116224,0,0,0,0,0
8174,0,0,0,0,0
50362,0,0,0,0,0
58417,0,0,0,0,0
10685,0,0,0,0,0
76506,0,0,0,0,0
70590,0,0,0,0,0
7949,0,0,0,0,0
49003,0,0,0,0,0
119529,0,0,0,0,0
53557,0,0,0,0,0
11650,0,0,0,0,0
100157,0,0,0,0,0
120532,0,0,0,0,0
96107,0,0,0,0,0
43258,0,0,0,0,0
47371,0,0,0,0,0
55900,0,0,0,0,0
32385,0,0,0,0,0
80047,4,4,4,0,0
85978,0,0,0,0,0
41468,0,0,0,0,0
93765,0,0,0,0,0
17021,0,0,0,0,0
81091,0,0,0,0,0
7108,0,0,0,0,0
32761,0,0,0,0,0
76341,0,0,0,0,0
27571,0,0,0,0,0
100865,0,0,0,0,0
69997,0,0,0,0,0
91290,0,0,0,0,0
113760,0,0,0,0,0
119326,0,0,0,0,0
40093,0,0,0,0,0
99657,0,0,0,0,0
78187,0,0,0,0,0
103550,0,0,0,0,0
107579,0,0,0,0,0
18806,0,0,0,0,0
40680,0,0,0,0,0
5614,0,0,0,0,0
3286,0,0,0,0,0
18137,0,0,0,0,0
102767,0,0,0,0,0
79393,0,0,0,0,0
101470,0,0,0,0,0
68,0,0,0,0,0
22659,0,0,0,0,0
37612,0,0,0,0,0
69171,0,0,0,0,0
113245,0,0,0,0,0
47052,0,0,0,0,0
116260,0,0,0,0,0
99079,0,0,0,0,0
24313,0,0,0,0,0
55089,0,0,0,0,0
28514,0,0,0,0,0
92202,0,0,0,0,0
74636,0,0,0,0,0
30246,0,0,0,0,0
114260,0,0,0,0,0
5099,0,0,0,0,0
77891,0,0,0,0,0
33626,0,0,0,0,0
4265,0,0,0,0,0
60,0,0,0,0,0
64350,0,0,0,0,0
92954,0,0,0,0,0
52454,0,0,0,0,0
7362,0,0,0,0,0
26676,0,0,0,0,0
103800,0,0,0,0,0
55578,0,0,0,0,0
102557,0,0,0,0,0
106034,0,0,0,0,0
2379,0,0,0,0,0
26184,0,0,0,0,0
39586,0,0,0,0,0
105150,0,0,0,0,0
107715,0,0,0,0,0
63819,0,0,0,0,0
70858,0,0,0,0,0
48526,0,0,0,0,0
24577,0,0,0,0,0
55514,0,0,0,0,0
102891,0,0,0,0,0
3129,0,0,0,0,0
10232,0,0,0,0,0
95321,0,0,0,0,0
11732,0,0,0,0,0
81756,0,0,0,0,0
40620,0,0,0,0,0
49506,0,0,0,0,0
37511,0,0,0,0,0
32604,0,0,0,0,0
109243,0,0,0,0,0
40099,0,0,0,0,0
104166,0,0,0,0,0
108679,0,0,0,0,0
92690,0,0,0,0,0
104497,0,0,0,0,0
17442,0,0,0,0,0
116681,0,0,0,0,0
53862,0,0,0,0,0
109870,0,0,0,0,0
56249,0,0,0,0,0
18922,0,0,0,0,0
84573,0,0,0,0,0
20936,0,0,0,0,0
117020,0,0,0,0,0
118314,0,0,0,0,0
35262,0,0,0,0,0
78128,0,0,0,0,0
105127,4,4,4,0,0
90579,0,0,0,0,0
51335,0,0,0,0,0
70185,0,0,0,0,0
26376,0,0,0,0,0
44460,0,0,0,0,0
22035,0,0,0,0,0
12312,0,0,0,0,0
77270,0,0,0,0,0
64391,0,0,0,0,0
99046,0,0,0,0,0
36828,0,0,0,0,0
17521,0,0,0,0,0
19138,0,0,0,0,0
54686,0,0,0,0,0
72907,0,0,0,0,0
70591,0,0,0,0,0
28662,0,0,0,0,0
31521,0,0,0,0,0
24046,0,0,0,0,0
106742,0,0,0,0,0
83626,0,0,0,0,0
108433,0,0,0,0,0
21844,0,0,0,0,0
81198,0,0,0,0,0
17047,0,0,0,0,0
94893,0,0,0,0,0
100252,0,0,0,0,0
80882,0,0,0,0,0
14917,0,0,0,0,0
55521,0,0,0,0,0
48996,0,0,0,0,0
61820,0,0,0,0,0
105806,0,0,0,0,0
31617,0,0,0,0,0
38844,0,0,0,0,0
91756,0,0,0,0,0
75001,2,2,2,0,0
2049,0,0,0,0,0
43093,0,0,0,0,0
94861,0,0,0,0,0
29224,0,0,0,0,0
20521,0,0,0,0,0
73461,0,0,0,0,0
11365,0,0,0,0,0
29472,0,0,0,0,0
63981,0,0,0,0,0
2417,0,0,0,0,0
22463,0,0,0,0,0
106286,0,0,0,0,0
80105,0,0,0,0,0
107632,0,0,0,0,0
88973,0,0,0,0,0
4199,0,0,0,0,0
79539,0,0,0,0,0
83878,0,0,0,0,0
8683,0,0,0,0,0
101505,0,0,0,0,0
39010,0,0,0,0,0
11067,0,0,0,0,0
68586,0,0,0,0,0
3200,0,0,0,0,0
103546,0,0,0,0,0
94323,0,0,0,0,0
85501,0,0,0,0,0
3637,0,0,0,0,0
42538,0,0,0,0,0
24862,0,0,0,0,0
81257,0,0,0,0,0
103238,0,0,0,0,0
13110,0,0,0,0,0
13895,0,0,0,0,0
113000,0,0,0,0,0
37862,0,0,0,0,0
104870,0,0,0,0,0
100804,0,0,0,0,0
71427,0,0,0,0,0
19573,0,0,0,0,0
58775,0,0,0,0,0
85236,0,0,0,0,0
39017,0,0,0,0,0
29614,0,0,0,0,0
12146,0,0,0,0,0
15046,0,0,0,0,0
66384,0,0,0,0,0
86698,0,0,0,0,0
43682,0,0,0,0,0
101255,0,0,0,0,0
45505,0,0,0,0,0
7750,0,0,0,0,0
87229,0,0,0,0,0
91566,0,0,0,0,0
85401,0,0,0,0,0
79078,1,1,1,0,0
114633,0,0,0,0,0
44733,0,0,0,0,0
46099,0,0,0,0,0
66193,0,0,0,0,0
21265,0,0,0,0,0
91602,0,0,0,0,0
113469,0,0,0,0,0
21721,0,0,0,0,0
64243,0,0,0,0,0
53360,0,0,0,0,0
74123,0,0,0,0,0
68265,0,0,0,0,0
84947,0,0,0,0,0
61392,0,0,0,0,0
39658,0,0,0,0,0
19493,0,0,0,0,0
102447,0,0,0,0,0
84393,0,0,0,0,0
115033,0,0,0,0,0
11080,0,0,0,0,0
95028,0,0,0,0,0
47130,0,0,0,0,0
44432,0,0,0,0,0
32482,0,0,0,0,0
115357,0,0,0,0,0
26160,0,0,0,0,0
40431,0,0,0,0,0
99391,0,0,0,0,0
73046,0,0,0,0,0
11695,0,0,0,0,0
27580,0,0,0,0,0
30986,0,0,0,0,0
37301,0,0,0,0,0
5966,0,0,0,0,0
112403,0,0,0,0,0
81184,0,0,0,0,0
41035,0,0,0,0,0
119894,2,2,2,0,0
69139,0,0,0,0,0
38259,0,0,0,0,0
117091,0,0,0,0,0
4591,0,0,0,0,0
39077,0,0,0,0,0
35743,0,0,0,0,0
35158,0,0,0,0,0
105240,0,0,0,0,0
99995,0,0,0,0,0
23351,0,0,0,0,0
107701,0,0,0,0,0
93238,0,0,0,0,0
74834,0,0,0,0,0
118471,0,0,0,0,0
35136,0,0,0,0,0
45590,0,0,0,0,0
11666,0,0,0,0,0
4549,0,0,0,0,0
95990,0,0,0,0,0
87815,0,0,0,0,0
59106,0,0,0,0,0
94762,0,0,0,0,0
58266,0,0,0,0,0
79146,0,0,0,0,0
6147,0,0,0,0,0
103345,0,0,0,0,0
9013,0,0,0,0,0
80336,0,0,0,0,0
66554,0,0,0,0,0
64077,0,0,0,0,0
118701,0,0,0,0,0
105865,0,0,0,0,0
15937,0,0,0,0,0
18623,0,0,0,0,0
106446,0,0,0,0,0
36801,0,0,0,0,0
76938,0,0,0,0,0
9633,2,2,2,0,0
22486,0,0,0,0,0
78659,0,0,0,0,0
61417,0,0,0,0,0
104625,0,0,0,0,0
83897,0,0,0,0,0
66631,0,0,0,0,0
47985,0,0,0,0,0
11311,0,0,0,0,0
110979,0,0,0,0,0
47333,0,0,0,0,0
76219,0,0,0,0,0
74564,0,0,0,0,0
76236,0,0,0,0,0
20237,0,0,0,0,0
20892,0,0,0,0,0
83252,0,0,0,0,0
109645,0,0,0,0,0
25344,0,0,0,0,0
14562,0,0,0,0,0
37757,0,0,0,0,0
31400,0,0,0,0,0
75349,0,0,0,0,0
42149,0,0,0,0,0
107214,0,0,0,0,0
64168,0,0,0,0,0
25293,0,0,0,0,0
116589,0,0,0,0,0
71486,0,0,0,0,0
64163,0,0,0,0,0
89773,0,0,0,0,0
99385,0,0,0,0,0
72889,0,0,0,0,0
51300,0,0,0,0,0
68812,0,0,0,0,0
5183,0,0,0,0,0
16472,0,0,0,0,0
13573,0,0,0,0,0
94564,0,0,0,0,0
116264,0,0,0,0,0
57425,0,0,0,0,0
40990,0,0,0,0,0
90545,0,0,0,0,0
109028,0,0,0,0,0
74697,0,0,0,0,0
97764,0,0,0,0,0
43359,0,0,0,0,0
13433,0,0,0,0,0
33881,0,0,0,0,0
111233,0,0,0,0,0
2869,0,0,0,0,0
104369,0,0,0,0,0
44037,0,0,0,0,0
35559,0,0,0,0,0
97955,0,0,0,0,0
1342,0,0,0,0,0
39585,0,0,0,0,0
119825,0,0,0,0,0
93875,2,2,2,0,0
31177,0,0,0,0,0
97047,0,0,0,0,0
19309,0,0,0,0,0
61129,0,0,0,0,0
116360,0,0,0,0,0
85186,0,0,0,0,0
69100,0,0,0,0,0
79712,0,0,0,0,0
109615,0,0,0,0,0
81679,0,0,0,0,0
460,0,0,0,0,0
43826,0,0,0,0,0
42674,0,0,0,0,0
40134,0,0,0,0,0
99044,0,0,0,0,0
3125,0,0,0,0,0
112729,0,0,0,0,0
87477,0,0,0,0,0
88963,0,0,0,0,0
33316,0,0,0,0,0
63370,0,0,0,0,0
886,0,0,0,0,0
83248,0,0,0,0,0
36594,0,0,0,0,0
80137,0,0,0,0,0
47054,0,0,0,0,0
10551,0,0,0,0,0
30256,0,0,0,0,0
102570,0,0,0,0,0
74747,0,0,0,0,0
57709,0,0,0,0,0
80327,0,0,0,0,0
58691,0,0,0,0,0
21081,0,0,0,0,0
12266,0,0,0,0,0
43766,0,0,0,0,0
53744,0,0,0,0,0
20807,0,0,0,0,0
115172,0,0,0,0,0
99986,0,0,0,0,0
11285,0,0,0,0,0
116726,0,0,0,0,0
118295,0,0,0,0,0
84023,0,0,0,0,0
45369,0,0,0,0,0
42451,0,0,0,0,0
60018,0,0,0,0,0
99228,0,0,0,0,0
71596,0,0,0,0,0
35576,0,0,0,0,0
39660,0,0,0,0,0
39497,0,0,0,0,0
25862,0,0,0,0,0
96911,0,0,0,0,0
88459,0,0,0,0,0
100967,0,0,0,0,0
62060,0,0,0,0,0
68841,0,0,0,0,0
86815,0,0,0,0,0
31601,0,0,0,0,0
11189,0,0,0,0,0
36665,0,0,0,0,0
9580,0,0,0,0,0
53088,0,0,0,0,0
80095,0,0,0,0,0
111318,0,0,0,0,0
54824,0,0,0,0,0
85472,0,0,0,0,0
11104,0,0,0,0,0
48292,0,0,0,0,0
114358,0,0,0,0,0
64361,0,0,0,0,0
63170,0,0,0,0,0
84456,0,0,0,0,0
66000,0,0,0,0,0
64862,0,0,0,0,0
120530,0,0,0,0,0
85713,0,0,0,0,0
100507,0,0,0,0,0
85307,0,0,0,0,0
19017,0,0,0,0,0
24267,0,0,0,0,0
109918,0,0,0,0,0
11156,0,0,0,0,0
8963,0,0,0,0,0
4072,0,0,0,0,0
19891,0,0,0,0,0
64518,0,0,0,0,0
106735,0,0,0,0,0
22057,0,0,0,0,0
57297,0,0,0,0,0
51597,0,0,0,0,0
14632,0,0,0,0,0
4250,0,0,0,0,0
35052,0,0,0,0,0
25647,0,0,0,0,0
51891,0,0,0,0,0
90137,0,0,0,0,0
69830,0,0,0,0,0
14318,0,0,0,0,0
105502,0,0,0,0,0
23911,0,0,0,0,0
116992,0,0,0,0,0
64419,0,0,0,0,0
15842,0,0,0,0,0
1974,0,0,0,0,0
18709,0,0,0,0,0
9869,1,1,1,0,0
106697,0,0,0,0,0
84167,0,0,0,0,0
47668,0,0,0,0,0
15128,0,0,0,0,0
58570,0,0,0,0,0
14943,0,0,0,0,0
16947,0,0,0,0,0
30221,0,0,0,0,0
85050,0,0,0,0,0
66446,0,0,0,0,0
45064,0,0,0,0,0
85230,0,0,0,0,0
51047,0,0,0,0,0
38440,0,0,0,0,0
89461,0,0,0,0,0
108851,0,0,0,0,0
40206,3,3,3,0,0
88152,0,0,0,0,0
30814,0,0,0,0,0
12229,0,0,0,0,0
77947,0,0,0,0,0
117651,0,0,0,0,0
11959,0,0,0,0,0
89515,0,0,0,0,0
77579,0,0,0,0,0
119569,0,0,0,0,0
69348,0,0,0,0,0
115128,0,0,0,0,0
54428,0,0,0,0,0
111111,0,0,0,0,0
16112,0,0,0,0,0
114441,0,0,0,0,0
21843,0,0,0,0,0
11620,0,0,0,0,0
116111,0,0,0,0,0
50336,0,0,0,0,0
7655,0,0,0,0,0
92951,0,0,0,0,0
55259,0,0,0,0,0
31676,0,0,0,0,0
84695,0,0,0,0,0
31777,0,0,0,0,0
62863,0,0,0,0,0
114301,0,0,0,0,0
42692,0,0,0,0,0
11781,0,0,0,0,0
44136,0,0,0,0,0
10190,2,2,2,0,0
96567,0,0,0,0,0
45742,0,0,0,0,0
94420,0,0,0,0,0
11452,0,0,0,0,0
71228,0,0,0,0,0
17935,0,0,0,0,0
48700,0,0,0,0,0
60204,0,0,0,0,0
67488,0,0,0,0,0
26901,0,0,0,0,0
68814,0,0,0,0,0
110228,0,0,0,0,0
5691,3,3,3,0,0
110231,0,0,0,0,0
9440,0,0,0,0,0
9252,0,0,0,0,0
64846,0,0,0,0,0
41046,0,0,0,0,0
50817,0,0,0,0,0
53372,0,0,0,0,0
40572,0,0,0,0,0
16538,0,0,0,0,0
78771,0,0,0,0,0
67965,0,0,0,0,0
96102,0,0,0,0,0
44918,0,0,0,0,0
55763,0,0,0,0,0
115275,0,0,0,0,0
115912,0,0,0,0,0
44663,0,0,0,0,0
27301,0,0,0,0,0
40098,0,0,0,0,0
95581,0,0,0,0,0
46658,0,0,0,0,0
59923,0,0,0,0,0
80403,0,0,0,0,0
42202,0,0,0,0,0
73895,0,0,0,0,0
64148,0,0,0,0,0
2548,0,0,0,0,0
102333,0,0,0,0,0
42964,0,0,0,0,0
1300,0,0,0,0,0
87942,0,0,0,0,0
25413,0,0,0,0,0
10489,0,0,0,0,0
80138,0,0,0,0,0
86966,0,0,0,0,0
101512,0,0,0,0,0
35493,0,0,0,0,0
60416,0,0,0,0,0
75241,0,0,0,0,0
87557,0,0,0,0,0
38857,0,0,0,0,0
51733,0,0,0,0,0
93425,0,0,0,0,0
59073,0,0,0,0,0
41077,0,0,0,0,0
14840,0,0,0,0,0
54827,0,0,0,0,0
82492,2,2,2,0,0
59835,0,0,0,0,0
118131,0,0,0,0,0
10385,0,0,0,0,0
40169,0,0,0,0,0
76534,0,0,0,0,0
71130,0,0,0,0,0
8321,0,0,0,0,0
28164,0,0,0,0,0
91277,0,0,0,0,0
78127,0,0,0,0,0
47572,2,2,2,0,0
16520,0,0,0,0,0
47017,0,0,0,0,0
38689,0,0,0,0,0
67265,0,0,0,0,0
85089,0,0,0,0,0
83105,0,0,0,0,0
106562,0,0,0,0,0
87879,0,0,0,0,0
39483,0,0,0,0,0
78743,0,0,0,0,0
85295,0,0,0,0,0
92267,0,0,0,0,0
6363,0,0,0,0,0
25561,0,0,0,0,0
67278,0,0,0,0,0
20701,0,0,0,0,0
5051,0,0,0,0,0
53960,0,0,0,0,0
109688,0,0,0,0,0
88494,0,0,0,0,0
31937,0,0,0,0,0
8110,0,0,0,0,0
111186,0,0,0,0,0
117766,0,0,0,0,0
47971,0,0,0,0,0
30033,0,0,0,0,0
12231,0,0,0,0,0
13021,0,0,0,0,0
74410,0,0,0,0,0
98968,0,0,0,0,0
6614,0,0,0,0,0
50459,0,0,0,0,0
106934,0,0,0,0,0
111266,0,0,0,0,0
65674,0,0,0,0,0
8637,0,0,0,0,0
70580,0,0,0,0,0
303,0,0,0,0,0
84760,0,0,0,0,0
70440,0,0,0,0,0
88172,0,0,0,0,0
118180,0,0,0,0,0
41200,0,0,0,0,0
110408,0,0,0,0,0
110500,0,0,0,0,0
100835,0,0,0,0,0
100757,0,0,0,0,0
83204,0,0,0,0,0
84586,0,0,0,0,0
80960,0,0,0,0,0
12723,0,0,0,0,0
67346,0,0,0,0,0
6091,0,0,0,0,0
77523,0,0,0,0,0
30404,0,0,0,0,0
7528,0,0,0,0,0
1287,0,0,0,0,0
10867,0,0,0,0,0
25824,0,0,0,0,0
67527,0,0,0,0,0
61542,0,0,0,0,0
119439,0,0,0,0,0
76334,0,0,0,0,0
100650,0,0,0,0,0
36976,0,0,0,0,0
81209,0,0,0,0,0
90979,0,0,0,0,0
4353,0,0,0,0,0
85174,0,0,0,0,0
59193,0,0,0,0,0
3635,0,0,0,0,0
31841,0,0,0,0,0
5230,0,0,0,0,0
105665,0,0,0,0,0
87057,1,1,1,0,0
40931,0,0,0,0,0
88373,0,0,0,0,0
92996,0,0,0,0,0
34601,0,0,0,0,0
88134,0,0,0,0,0
106378,0,0,0,0,0
41246,0,0,0,0,0
79914,0,0,0,0,0
25993,0,0,0,0,0
22551,0,0,0,0,0
115546,0,0,0,0,0
29493,0,0,0,0,0
76281,0,0,0,0,0
21753,0,0,0,0,0
63889,0,0,0,0,0
80549,0,0,0,0,0
16548,0,0,0,0,0
50129,0,0,0,0,0
102939,0,0,0,0,0
24617,0,0,0,0,0
19815,0,0,0,0,0
73608,0,0,0,0,0
10077,0,0,0,0,0
73973,0,0,0,0,0
115689,0,0,0,0,0
105849,0,0,0,0,0
35617,0,0,0,0,0
108974,0,0,0,0,0
81112,0,0,0,0,0
40123,0,0,0,0,0
3219,0,0,0,0,0
88864,0,0,0,0,0
15244,0,0,0,0,0
111852,0,0,0,0,0
69811,0,0,0,0,0
27405,0,0,0,0,0
41443,0,0,0,0,0
48439,0,0,0,0,0
61594,0,0,0,0,0
114009,0,0,0,0,0
69101,0,0,0,0,0
16883,0,0,0,0,0
119503,0,0,0,0,0
65429,1,1,1,0,0
101253,0,0,0,0,0
87519,0,0,0,0,0
11564,0,0,0,0,0
11328,0,0,0,0,0
80978,0,0,0,0,0
85570,0,0,0,0,0
32000,0,0,0,0,0
108648,0,0,0,0,0
17177,0,0,0,0,0
5472,0,0,0,0,0
36216,0,0,0,0,0
18521,0,0,0,0,0
72942,0,0,0,0,0
70212,0,0,0,0,0
97667,0,0,0,0,0
101540,0,0,0,0,0
72320,0,0,0,0,0
14014,0,0,0,0,0
95732,0,0,0,0,0
76800,0,0,0,0,0
110162,0,0,0,0,0
45992,0,0,0,0,0
39695,0,0,0,0,0
14181,0,0,0,0,0
79473,0,0,0,0,0
18332,0,0,0,0,0
116284,0,0,0,0,0
74081,0,0,0,0,0
66706,0,0,0,0,0
11087,0,0,0,0,0
78906,0,0,0,0,0
33528,0,0,0,0,0
81208,0,0,0,0,0
80548,0,0,0,0,0
70563,0,0,0,0,0
41923,0,0,0,0,0
45585,0,0,0,0,0
16668,0,0,0,0,0
110993,0,0,0,0,0
25766,0,0,0,0,0
28061,0,0,0,0,0
46168,0,0,0,0,0
75181,0,0,0,0,0
34348,0,0,0,0,0
95750,0,0,0,0,0
5107,0,0,0,0,0
66167,0,0,0,0,0
43495,0,0,0,0,0
17186,0,0,0,0,0
85660,0,0,0,0,0
70548,0,0,0,0,0
82959,0,0,0,0,0
65084,0,0,0,0,0
106955,0,0,0,0,0
80161,0,0,0,0,0
95130,0,0,0,0,0
50140,0,0,0,0,0
67636,0,0,0,0,0
68081,0,0,0,0,0
109810,0,0,0,0,0
84347,0,0,0,0,0
14873,0,0,0,0,0
56943,0,0,0,0,0
49799,0,0,0,0,0
36413,0,0,0,0,0
81849,0,0,0,0,0
4125,0,0,0,0,0
30177,0,0,0,0,0
56286,0,0,0,0,0
38921,0,0,0,0,0
51980,0,0,0,0,0
85370,0,0,0,0,0
101079,0,0,0,0,0
27886,0,0,0,0,0
21635,0,0,0,0,0
1745,0,0,0,0,0
48922,0,0,0,0,0
106422,1,1,1,0,0
37957,0,0,0,0,0
22173,0,0,0,0,0
46922,0,0,0,0,0
14890,0,0,0,0,0
55902,0,0,0,0,0
15823,0,0,0,0,0
41184,0,0,0,0,0
7901,0,0,0,0,0
116786,1,1,1,0,0
83424,0,0,0,0,0
57498,0,0,0,0,0
85770,0,0,0,0,0
108203,0,0,0,0,0
7442,0,0,0,0,0
109431,0,0,0,0,0
10893,0,0,0,0,0
12757,0,0,0,0,0
38837,0,0,0,0,0
16166,0,0,0,0,0
58851,0,0,0,0,0
119482,0,0,0,0,0
109772,0,0,0,0,0
9687,0,0,0,0,0
1053,0,0,0,0,0
35540,0,0,0,0,0
89174,0,0,0,0,0
34328,0,0,0,0,0
89818,0,0,0,0,0
29822,0,0,0,0,0
49463,0,0,0,0,0
5468,0,0,0,0,0
33994,0,0,0,0,0
30579,0,0,0,0,0
110029,0,0,0,0,0
60742,0,0,0,0,0
94349,0,0,0,0,0
36434,0,0,0,0,0
79037,0,0,0,0,0
119610,0,0,0,0,0
11393,0,0,0,0,0
27528,0,0,0,0,0
33782,0,0,0,0,0
17246,0,0,0,0,0
118179,0,0,0,0,0
91551,0,0,0,0,0
63019,0,0,0,0,0
90447,0,0,0,0,0
88458,0,0,0,0,0
12250,0,0,0,0,0
58737,0,0,0,0,0
80136,0,0,0,0,0
18256,1,1,1,0,0
32196,0,0,0,0,0
28549,0,0,0,0,0
73788,0,0,0,0,0
89394,0,0,0,0,0
30237,0,0,0,0,0
30514,0,0,0,0,0
45753,0,0,0,0,0
11698,0,0,0,0,0
12377,1,1,1,0,0
90496,0,0,0,0,0
13106,0,0,0,0,0
10666,2,2,2,0,0
15014,0,0,0,0,0
46293,0,0,0,0,0
18967,0,0,0,0,0
46890,0,0,0,0,0
5689,0,0,0,0,0
52831,0,0,0,0,0
100899,0,0,0,0,0
21416,0,0,0,0,0
32878,0,0,0,0,0
101133,0,0,0,0,0
19222,0,0,0,0,0
10357,0,0,0,0,0
60199,0,0,0,0,0
19725,0,0,0,0,0
8978,0,0,0,0,0
75475,0,0,0,0,0
106362,0,0,0,0,0
56513,0,0,0,0,0
33031,0,0,0,0,0
89782,0,0,0,0,0
95845,0,0,0,0,0
50940,0,0,0,0,0
81463,0,0,0,0,0
62527,0,0,0,0,0
15531,0,0,0,0,0
66914,0,0,0,0,0
68032,0,0,0,0,0
1406,0,0,0,0,0
66426,0,0,0,0,0
14476,0,0,0,0,0
82965,0,0,0,0,0
80955,0,0,0,0,0
20666,0,0,0,0,0
83985,0,0,0,0,0
40467,0,0,0,0,0
85019,0,0,0,0,0
44882,0,0,0,0,0
119801,0,0,0,0,0
104449,0,0,0,0,0
892,0,0,0,0,0
82666,0,0,0,0,0
119831,0,0,0,0,0
103405,0,0,0,0,0
76662,0,0,0,0,0
71917,0,0,0,0,0
84769,2,2,2,0,0
73164,0,0,0,0,0
50979,0,0,0,0,0
60782,0,0,0,0,0
110879,0,0,0,0,0
47541,0,0,0,0,0
96436,0,0,0,0,0
79685,0,0,0,0,0
15293,0,0,0,0,0
93175,0,0,0,0,0
101007,0,0,0,0,0
40075,0,0,0,0,0
98944,0,0,0,0,0
49130,0,0,0,0,0
105379,0,0,0,0,0
70422,0,0,0,0,0
61722,0,0,0,0,0
110533,0,0,0,0,0
74043,3,3,3,0,0
120362,0,0,0,0,0
94249,0,0,0,0,0
117663,0,0,0,0,0
108165,0,0,0,0,0
75177,0,0,0,0,0
77021,0,0,0,0,0
110352,0,0,0,0,0
89984,0,0,0,0,0
103322,0,0,0,0,0
60070,0,0,0,0,0
26620,0,0,0,0,0
95450,0,0,0,0,0
39750,0,0,0,0,0
78051,0,0,0,0,0
60125,0,0,0,0,0
81312,0,0,0,0,0
28743,0,0,0,0,0
113370,0,0,0,0,0
6989,0,0,0,0,0
26847,0,0,0,0,0
10008,0,0,0,0,0
5801,0,0,0,0,0
85298,0,0,0,0,0
120279,0,0,0,0,0
34663,0,0,0,0,0
46498,0,0,0,0,0
36512,0,0,0,0,0
60899,0,0,0,0,0
104453,0,0,0,0,0
46024,0,0,0,0,0
51688,0,0,0,0,0
81427,0,0,0,0,0
92914,0,0,0,0,0
59712,0,0,0,0,0
24442,0,0,0,0,0
48550,0,0,0,0,0
45099,0,0,0,0,0
49399,0,0,0,0,0
36442,0,0,0,0,0
78169,0,0,0,0,0
49446,0,0,0,0,0
13709,0,0,0,0,0
4594,0,0,0,0,0
30069,0,0,0,0,0
33708,0,0,0,0,0
30517,0,0,0,0,0
52391,0,0,0,0,0
12378,0,0,0,0,0
118669,0,0,0,0,0
10201,0,0,0,0,0
43910,0,0,0,0,0
96949,0,0,0,0,0
37610,0,0,0,0,0
52965,0,0,0,0,0
28404,0,0,0,0,0
95927,0,0,0,0,0
87342,0,0,0,0,0
30327,0,0,0,0,0
6380,0,0,0,0,0
92724,0,0,0,0,0
92408,0,0,0,0,0
93101,0,0,0,0,0
48374,0,0,0,0,0
116371,0,0,0,0,0
11144,0,0,0,0,0
91813,1,1,1,0,0
91780,0,0,0,0,0
102199,0,0,0,0,0
590,0,0,0,0,0
117951,0,0,0,0,0
40690,0,0,0,0,0
75066,0,0,0,0,0
8478,6,6,6,0,0
68042,0,0,0,0,0
111816,0,0,0,0,0
85848,0,0,0,0,0
9960,0,0,0,0,0
109360,0,0,0,0,0
119226,0,0,0,0,0
80479,0,0,0,0,0
10152,0,0,0,0,0
98061,0,0,0,0,0
58477,0,0,0,0,0
18774,0,0,0,0,0
38108,0,0,0,0,0
93539,0,0,0,0,0
57473,0,0,0,0,0
81363,0,0,0,0,0
79862,0,0,0,0,0
82470,0,0,0,0,0
8300,0,0,0,0,0
111882,0,0,0,0,0
102210,0,0,0,0,0
20535,0,0,0,0,0
45825,0,0,0,0,0
37175,0,0,0,0,0
99436,0,0,0,0,0
72262,0,0,0,0,0
107312,0,0,0,0,0
19801,0,0,0,0,0
69349,0,0,0,0,0
19226,0,0,0,0,0
116616,0,0,0,0,0
15268,0,0,0,0,0
58080,0,0,0,0,0
107596,0,0,0,0,0
91000,0,0,0,0,0
24085,0,0,0,0,0
117802,0,0,0,0,0
47287,0,0,0,0,0
64675,0,0,0,0,0
76546,0,0,0,0,0
52146,0,0,0,0,0
59645,0,0,0,0,0
72543,0,0,0,0,0
116002,0,0,0,0,0
47562,0,0,0,0,0
76859,0,0,0,0,0
29044,0,0,0,0,0
59108,0,0,0,0,0
80696,0,0,0,0,0
27964,0,0,0,0,0
7585,0,0,0,0,0
96188,0,0,0,0,0
91713,0,0,0,0,0
110100,0,0,0,0,0
37135,2,2,2,0,0
2313,0,0,0,0,0
34995,0,0,0,0,0
48442,0,0,0,0,0
118453,0,0,0,0,0
109296,0,0,0,0,0
55088,0,0,0,0,0
40427,0,0,0,0,0
2337,0,0,0,0,0
39811,0,0,0,0,0
48101,0,0,0,0,0
60130,0,0,0,0,0
47955,1,1,1,0,0
118602,0,0,0,0,0
62944,0,0,0,0,0
94460,0,0,0,0,0
67169,0,0,0,0,0
86333,0,0,0,0,0
18145,0,0,0,0,0
32944,0,0,0,0,0
37741,0,0,0,0,0
48286,0,0,0,0,0
15448,0,0,0,0,0
78244,0,0,0,0,0
44726,0,0,0,0,0
39188,0,0,0,0,0
16042,0,0,0,0,0
108331,0,0,0,0,0
36237,0,0,0,0,0
9405,0,0,0,0,0
19659,0,0,0,0,0
100908,3,3,3,0,0
7458,0,0,0,0,0
96846,0,0,0,0,0
13637,0,0,0,0,0
78714,0,0,0,0,0
36127,0,0,0,0,0
26830,0,0,0,0,0
5049,0,0,0,0,0
109860,0,0,0,0,0
115571,0,0,0,0,0
35688,0,0,0,0,0
98682,0,0,0,0,0
70553,0,0,0,0,0
71739,0,0,0,0,0
80741,0,0,0,0,0
91937,0,0,0,0,0
44080,0,0,0,0,0
32140,0,0,0,0,0
70400,0,0,0,0,0
86761,0,0,0,0,0
10224,0,0,0,0,0
41487,0,0,0,0,0
73124,0,0,0,0,0
51389,0,0,0,0,0
14290,0,0,0,0,0
81094,0,0,0,0,0
16639,0,0,0,0,0
50919,0,0,0,0,0
94879,0,0,0,0,0
84481,0,0,0,0,0
89978,0,0,0,0,0
34791,0,0,0,0,0
72307,0,0,0,0,0
4969,0,0,0,0,0
59465,0,0,0,0,0
90115,0,0,0,0,0
100530,0,0,0,0,0
49997,0,0,0,0,0
30382,0,0,0,0,0
11026,0,0,0,0,0
96199,0,0,0,0,0
109,0,0,0,0,0
104898,0,0,0,0,0
23117,0,0,0,0,0
12259,0,0,0,0,0
51799,0,0,0,0,0
31021,0,0,0,0,0
85804,0,0,0,0,0
74199,0,0,0,0,0
97118,0,0,0,0,0
19393,0,0,0,0,0
113540,0,0,0,0,0
11304,0,0,0,0,0
8537,0,0,0,0,0
78019,0,0,0,0,0
12322,0,0,0,0,0
67926,0,0,0,0,0
69203,0,0,0,0,0
39311,0,0,0,0,0
37398,0,0,0,0,0
101760,0,0,0,0,0
58481,1,1,1,0,0
16062,0,0,0,0,0
32645,0,0,0,0,0
32409,0,0,0,0,0
22667,0,0,0,0,0
8015,0,0,0,0,0
79733,0,0,0,0,0
116427,0,0,0,0,0
22586,0,0,0,0,0
109312,0,0,0,0,0
8032,0,0,0,0,0
89364,0,0,0,0,0
120269,0,0,0,0,0
94604,0,0,0,0,0
38343,0,0,0,0,0
68904,0,0,0,0,0
96078,0,0,0,0,0
56138,0,0,0,0,0
16672,0,0,0,0,0
114795,0,0,0,0,0
92785,0,0,0,0,0
8430,0,0,0,0,0
90612,0,0,0,0,0
109504,0,0,0,0,0
9345,0,0,0,0,0
112431,0,0,0,0,0
69377,0,0,0,0,0
59303,0,0,0,0,0
86733,0,0,0,0,0
13679,0,0,0,0,0
66343,0,0,0,0,0
63119,0,0,0,0,0
98797,0,0,0,0,0
30899,0,0,0,0,0
14627,0,0,0,0,0
5307,0,0,0,0,0
72484,0,0,0,0,0
29741,0,0,0,0,0
21617,0,0,0,0,0
120191,0,0,0,0,0
99533,0,0,0,0,0
36023,0,0,0,0,0
14829,0,0,0,0,0
117534,0,0,0,0,0
97857,0,0,0,0,0
4067,0,0,0,0,0
98823,0,0,0,0,0
42853,0,0,0,0,0
75619,0,0,0,0,0
113140,0,0,0,0,0
48014,0,0,0,0,0
36449,0,0,0,0,0
101956,3,3,3,0,0
100493,0,0,0,0,0
18188,0,0,0,0,0
120554,0,0,0,0,0
46506,0,0,0,0,0
46036,0,0,0,0,0
107273,0,0,0,0,0
39847,0,0,0,0,0
38435,0,0,0,0,0
117351,0,0,0,0,0
75571,0,0,0,0,0
65964,0,0,0,0,0
55547,0,0,0,0,0
76819,0,0,0,0,0
99186,0,0,0,0,0
97471,0,0,0,0,0
55322,0,0,0,0,0
80412,0,0,0,0,0
72233,0,0,0,0,0
77458,0,0,0,0,0
82399,0,0,0,0,0
52130,0,0,0,0,0
120215,0,0,0,0,0
80564,0,0,0,0,0
62664,0,0,0,0,0
105431,0,0,0,0,0
45146,0,0,0,0,0
17766,0,0,0,0,0
108794,0,0,0,0,0
93604,0,0,0,0,0
38533,0,0,0,0,0
12582,0,0,0,0,0
89395,0,0,0,0,0
41177,0,0,0,0,0
65926,0,0,0,0,0
74402,0,0,0,0,0
15213,0,0,0,0,0
15479,0,0,0,0,0
41966,0,0,0,0,0
29174,0,0,0,0,0
29668,0,0,0,0,0
103379,0,0,0,0,0
45458,0,0,0,0,0
22773,0,0,0,0,0
86153,0,0,0,0,0
58917,0,0,0,0,0
100358,0,0,0,0,0
117579,0,0,0,0,0
36534,0,0,0,0,0
100867,0,0,0,0,0
19595,0,0,0,0,0
70423,0,0,0,0,0
120580,0,0,0,0,0
52599,0,0,0,0,0
103263,0,0,0,0,0
1024,0,0,0,0,0
116283,0,0,0,0,0
9995,0,0,0,0,0
77529,0,0,0,0,0
93755,0,0,0,0,0
31044,0,0,0,0,0
118702,0,0,0,0,0
20122,0,0,0,0,0
73720,0,0,0,0,0
76561,0,0,0,0,0
72868,0,0,0,0,0
94684,0,0,0,0,0
4750,0,0,0,0,0
2612,0,0,0,0,0
39818,0,0,0,0,0
32775,0,0,0,0,0
50975,0,0,0,0,0
63591,0,0,0,0,0
29036,0,0,0,0,0
53261,0,0,0,0,0
76471,0,0,0,0,0
33562,0,0,0,0,0
16011,0,0,0,0,0
90409,0,0,0,0,0
99514,0,0,0,0,0
70326,0,0,0,0,0
101328,0,0,0,0,0
9090,0,0,0,0,0
68299,0,0,0,0,0
117097,0,0,0,0,0
51121,0,0,0,0,0
120050,0,0,0,0,0
104426,0,0,0,0,0
94595,0,0,0,0,0
22342,0,0,0,0,0
14755,0,0,0,0,0
78547,0,0,0,0,0
118645,0,0,0,0,0
71023,0,0,0,0,0
110416,0,0,0,0,0
106236,0,0,0,0,0
66565,0,0,0,0,0
58272,0,0,0,0,0
64076,3,3,3,0,0
67551,0,0,0,0,0
33579,0,0,0,0,0
66234,0,0,0,0,0
72802,0,0,0,0,0
91152,0,0,0,0,0
81165,0,0,0,0,0
65005,0,0,0,0,0
38478,0,0,0,0,0
38176,0,0,0,0,0
10726,0,0,0,0,0
37225,0,0,0,0,0
61042,0,0,0,0,0
91580,0,0,0,0,0
73675,0,0,0,0,0
106876,0,0,0,0,0
84126,0,0,0,0,0
91503,0,0,0,0,0
33471,0,0,0,0,0
64601,0,0,0,0,0
89126,0,0,0,0,0
30674,0,0,0,0,0
17349,0,0,0,0,0
86222,0,0,0,0,0
66283,0,0,0,0,0
34228,0,0,0,0,0
78588,0,0,0,0,0
84285,0,0,0,0,0
12819,0,0,0,0,0
81510,0,0,0,0,0
49244,0,0,0,0,0
32624,0,0,0,0,0
45550,0,0,0,0,0
27033,0,0,0,0,0
28117,0,0,0,0,0
88511,0,0,0,0,0
25016,0,0,0,0,0
56032,0,0,0,0,0
8011,0,0,0,0,0
62559,0,0,0,0,0
98331,0,0,0,0,0
114811,0,0,0,0,0
4732,0,0,0,0,0
81957,0,0,0,0,0
28988,0,0,0,0,0
52903,0,0,0,0,0
114043,0,0,0,0,0
97899,0,0,0,0,0
45162,0,0,0,0,0
112769,0,0,0,0,0
37763,0,0,0,0,0
5501,0,0,0,0,0
5943,0,0,0,0,0
98531,0,0,0,0,0
61772,0,0,0,0,0
57500,0,0,0,0,0
62733,0,0,0,0,0
23477,0,0,0,0,0
4765,0,0,0,0,0
104571,0,0,0,0,0
52662,0,0,0,0,0
56205,0,0,0,0,0
103509,0,0,0,0,0
64291,0,0,0,0,0
56665,0,0,0,0,0
35198,0,0,0,0,0
25193,0,0,0,0,0
105021,0,0,0,0,0
12255,0,0,0,0,0
100287,0,0,0,0,0
32521,0,0,0,0,0
38590,0,0,0,0,0
98205,0,0,0,0,0
8057,2,2,2,0,0
74482,0,0,0,0,0
34847,0,0,0,0,0
73207,0,0,0,0,0
88236,0,0,0,0,0
43488,0,0,0,0,0
120542,0,0,0,0,0
93626,0,0,0,0,0
8096,0,0,0,0,0
84779,0,0,0,0,0
75961,0,0,0,0,0
9494,0,0,0,0,0
76013,0,0,0,0,0
106724,0,0,0,0,0
119996,0,0,0,0,0
34218,0,0,0,0,0
3506,0,0,0,0,0
43527,0,0,0,0,0
82386,0,0,0,0,0
102782,0,0,0,0,0
52872,0,0,0,0,0
106430,0,0,0,0,0
48799,0,0,0,0,0
57555,0,0,0,0,0
61675,0,0,0,0,0
87191,0,0,0,0,0
108248,0,0,0,0,0
97367,3,3,3,0,0
81405,0,0,0,0,0
100556,0,0,0,0,0
23294,0,0,0,0,0
33264,0,0,0,0,0
25001,0,0,0,0,0
113213,0,0,0,0,0
30112,0,0,0,0,0
60766,0,0,0,0,0
46816,0,0,0,0,0
77178,0,0,0,0,0
37921,0,0,0,0,0
94925,0,0,0,0,0
47043,0,0,0,0,0
58145,0,0,0,0,0
28006,0,0,0,0,0
105532,0,0,0,0,0
23433,0,0,0,0,0
17900,0,0,0,0,0
83469,0,0,0,0,0
88042,0,0,0,0,0
44180,0,0,0,0,0
6053,0,0,0,0,0
24822,0,0,0,0,0
85836,0,0,0,0,0
46672,0,0,0,0,0
31636,0,0,0,0,0
106572,0,0,0,0,0
19416,0,0,0,0,0
11310,0,0,0,0,0
80569,0,0,0,0,0
8910,0,0,0,0,0
43167,0,0,0,0,0
61157,0,0,0,0,0
92924,0,0,0,0,0
26414,0,0,0,0,0
1553,0,0,0,0,0
88823,0,0,0,0,0
12482,0,0,0,0,0
82114,1,1,1,0,0
1592,0,0,0,0,0
31492,0,0,0,0,0
22192,0,0,0,0,0
69396,0,0,0,0,0
58271,0,0,0,0,0
47464,0,0,0,0,0
9474,0,0,0,0,0
38734,0,0,0,0,0
98980,0,0,0,0,0
10608,0,0,0,0,0
77003,0,0,0,0,0
84298,0,0,0,0,0
10135,0,0,0,0,0
16537,0,0,0,0,0
16795,0,0,0,0,0
49024,0,0,0,0,0
38572,0,0,0,0,0
120445,0,0,0,0,0
30453,0,0,0,0,0
66006,0,0,0,0,0
59751,0,0,0,0,0
106495,0,0,0,0,0
113463,0,0,0,0,0
64930,0,0,0,0,0
83029,0,0,0,0,0
20894,0,0,0,0,0
73246,0,0,0,0,0
61109,0,0,0,0,0
22745,0,0,0,0,0
98459,0,0,0,0,0
113929,0,0,0,0,0
9253,1,1,1,0,0
13294,0,0,0,0,0
4152,0,0,0,0,0
82371,0,0,0,0,0
51924,0,0,0,0,0
100531,0,0,0,0,0
46503,0,0,0,0,0
79528,0,0,0,0,0
10717,0,0,0,0,0
107469,0,0,0,0,0
34049,0,0,0,0,0
43009,0,0,0,0,0
5213,0,0,0,0,0
82774,0,0,0,0,0
6718,0,0,0,0,0
2503,0,0,0,0,0
67396,0,0,0,0,0
23817,0,0,0,0,0
60864,0,0,0,0,0
41296,0,0,0,0,0
113799,0,0,0,0,0
39647,0,0,0,0,0
41203,0,0,0,0,0
117726,0,0,0,0,0
45253,0,0,0,0,0
72448,0,0,0,0,0
85500,0,0,0,0,0
94855,3,3,3,0,0
30182,0,0,0,0,0
26515,0,0,0,0,0
59567,0,0,0,0,0
80931,0,0,0,0,0
83072,0,0,0,0,0
8908,0,0,0,0,0
69347,0,0,0,0,0
97800,0,0,0,0,0
30169,0,0,0,0,0
110175,0,0,0,0,0
76715,0,0,0,0,0
99027,0,0,0,0,0
16824,0,0,0,0,0
120026,0,0,0,0,0
102355,0,0,0,0,0
1575,0,0,0,0,0
95277,0,0,0,0,0
75454,0,0,0,0,0
44545,0,0,0,0,0
11259,0,0,0,0,0
32759,0,0,0,0,0
42053,0,0,0,0,0
87967,0,0,0,0,0
20723,0,0,0,0,0
36170,0,0,0,0,0
31775,0,0,0,0,0
21830,0,0,0,0,0
80052,0,0,0,0,0
97057,0,0,0,0,0
2364,0,0,0,0,0
4318,0,0,0,0,0
15827,0,0,0,0,0
28985,0,0,0,0,0
66763,0,0,0,0,0
7476,0,0,0,0,0
69976,0,0,0,0,0
75645,0,0,0,0,0
30261,0,0,0,0,0
98645,0,0,0,0,0
36111,0,0,0,0,0
86747,0,0,0,0,0
105848,0,0,0,0,0
76456,0,0,0,0,0
107134,0,0,0,0,0
73501,0,0,0,0,0
76911,0,0,0,0,0
90596,0,0,0,0,0
61167,0,0,0,0,0
99216,0,0,0,0,0
83644,0,0,0,0,0
10009,0,0,0,0,0
42864,0,0,0,0,0
33963,0,0,0,0,0
54301,0,0,0,0,0
104316,0,0,0,0,0
70780,0,0,0,0,0
6506,0,0,0,0,0
10956,0,0,0,0,0
25045,0,0,0,0,0
57760,0,0,0,0,0
110245,0,0,0,0,0
94387,0,0,0,0,0
114570,0,0,0,0,0
9636,0,0,0,0,0
108394,0,0,0,0,0
56789,0,0,0,0,0
44132,0,0,0,0,0
7963,0,0,0,0,0
70098,0,0,0,0,0
71153,3,3,3,0,0
66056,0,0,0,0,0
115047,0,0,0,0,0
43765,2,2,2,0,0
79397,0,0,0,0,0
60810,0,0,0,0,0
13835,0,0,0,0,0
88866,0,0,0,0,0
81686,0,0,0,0,0
53499,0,0,0,0,0
58121,0,0,0,0,0
38965,0,0,0,0,0
55506,0,0,0,0,0
50149,0,0,0,0,0
25753,0,0,0,0,0
3178,0,0,0,0,0
48983,0,0,0,0,0
62018,0,0,0,0,0
93132,0,0,0,0,0
29526,0,0,0,0,0
80080,0,0,0,0,0
96552,0,0,0,0,0
20127,0,0,0,0,0
42197,0,0,0,0,0
23591,0,0,0,0,0
76338,0,0,0,0,0
106895,0,0,0,0,0
47204,0,0,0,0,0
6998,0,0,0,0,0
56295,0,0,0,0,0
47768,0,0,0,0,0
659,0,0,0,0,0
27679,0,0,0,0,0
61824,0,0,0,0,0
114235,0,0,0,0,0
41188,0,0,0,0,0
76777,0,0,0,0,0
58199,0,0,0,0,0
52797,0,0,0,0,0
3387,0,0,0,0,0
5987,0,0,0,0,0
39194,0,0,0,0,0
35369,0,0,0,0,0
100050,0,0,0,0,0
7945,0,0,0,0,0
65928,0,0,0,0,0
70508,0,0,0,0,0
70359,0,0,0,0,0
35765,0,0,0,0,0
87661,0,0,0,0,0
47852,0,0,0,0,0
69052,0,0,0,0,0
55685,0,0,0,0,0
119438,0,0,0,0,0
72545,0,0,0,0,0
55239,0,0,0,0,0
119072,0,0,0,0,0
54946,0,0,0,0,0
24595,0,0,0,0,0
15425,0,0,0,0,0
6338,0,0,0,0,0
117160,0,0,0,0,0
106489,0,0,0,0,0
75815,0,0,0,0,0
83306,0,0,0,0,0
14964,0,0,0,0,0
67156,0,0,0,0,0
108835,0,0,0,0,0
68255,0,0,0,0,0
12301,0,0,0,0,0
66158,0,0,0,0,0
114199,0,0,0,0,0
4059,0,0,0,0,0
47421,0,0,0,0,0
37435,0,0,0,0,0
98078,0,0,0,0,0
97838,0,0,0,0,0
104333,0,0,0,0,0
16479,0,0,0,0,0
55656,0,0,0,0,0
22418,0,0,0,0,0
49913,0,0,0,0,0
36761,0,0,0,0,0
114936,0,0,0,0,0
37199,0,0,0,0,0
102660,0,0,0,0,0
58524,0,0,0,0,0
31324,0,0,0,0,0
52891,0,0,0,0,0
115294,0,0,0,0,0
58711,0,0,0,0,0
4617,0,0,0,0,0
101330,0,0,0,0,0
42977,0,0,0,0,0
42460,0,0,0,0,0
58726,0,0,0,0,0
56957,0,0,0,0,0
87738,0,0,0,0,0
17658,1,1,1,0,0
546,0,0,0,0,0
97511,0,0,0,0,0
34752,0,0,0,0,0
10659,0,0,0,0,0
79000,0,0,0,0,0
50050,0,0,0,0,0
22584,0,0,0,0,0
101466,0,0,0,0,0
84545,0,0,0,0,0
72767,0,0,0,0,0
73655,0,0,0,0,0
81641,0,0,0,0,0
70976,0,0,0,0,0
58305,0,0,0,0,0
85382,0,0,0,0,0
67193,0,0,0,0,0
113796,0,0,0,0,0
105040,0,0,0,0,0
60523,0,0,0,0,0
67401,0,0,0,0,0
2340,0,0,0,0,0
66812,0,0,0,0,0
109525,0,0,0,0,0
5818,0,0,0,0,0
25310,0,0,0,0,0
55730,0,0,0,0,0
118846,0,0,0,0,0
100378,0,0,0,0,0
109076,0,0,0,0,0
88087,0,0,0,0,0
37984,0,0,0,0,0
119536,0,0,0,0,0
2009,0,0,0,0,0
36909,0,0,0,0,0
27613,0,0,0,0,0
31045,0,0,0,0,0
104435,0,0,0,0,0
50858,0,0,0,0,0
31522,0,0,0,0,0
61463,0,0,0,0,0
56184,0,0,0,0,0
87569,0,0,0,0,0
64576,0,0,0,0,0
114234,0,0,0,0,0
2674,0,0,0,0,0
73703,0,0,0,0,0
104253,0,0,0,0,0
17575,0,0,0,0,0
69838,0,0,0,0,0
35400,0,0,0,0,0
22550,0,0,0,0,0
118327,0,0,0,0,0
31105,0,0,0,0,0
5711,0,0,0,0,0
71301,0,0,0,0,0
87824,0,0,0,0,0
16270,0,0,0,0,0
24353,0,0,0,0,0
34308,0,0,0,0,0
39803,0,0,0,0,0
105214,1,1,1,0,0
72005,0,0,0,0,0
434,0,0,0,0,0
100480,0,0,0,0,0
82800,0,0,0,0,0
48116,0,0,0,0,0
92535,0,0,0,0,0
70723,0,0,0,0,0
11263,0,0,0,0,0
95182,0,0,0,0,0
73018,0,0,0,0,0
87510,0,0,0,0,0
87605,0,0,0,0,0
95074,0,0,0,0,0
41905,0,0,0,0,0
45860,0,0,0,0,0
40232,0,0,0,0,0
30519,0,0,0,0,0
10270,0,0,0,0,0
81931,0,0,0,0,0
62427,0,0,0,0,0
1457,0,0,0,0,0
39963,0,0,0,0,0
3914,0,0,0,0,0
59200,0,0,0,0,0
19636,0,0,0,0,0
30983,0,0,0,0,0
81172,0,0,0,0,0
55667,0,0,0,0,0
86782,0,0,0,0,0
98453,0,0,0,0,0
36197,0,0,0,0,0
62175,0,0,0,0,0
103048,0,0,0,0,0
70194,0,0,0,0,0
31224,0,0,0,0,0
15058,0,0,0,0,0
119688,0,0,0,0,0
92258,0,0,0,0,0
69207,0,0,0,0,0
116922,0,0,0,0,0
118055,0,0,0,0,0
112425,0,0,0,0,0
93271,0,0,0,0,0
79317,0,0,0,0,0
102740,0,0,0,0,0
12976,0,0,0,0,0
33949,0,0,0,0,0
104370,0,0,0,0,0
79059,0,0,0,0,0
92758,0,0,0,0,0
489,0,0,0,0,0
81789,0,0,0,0,0
28483,0,0,0,0,0
86818,0,0,0,0,0
33636,0,0,0,0,0
10944,0,0,0,0,0
63429,3,3,3,0,0
3054,0,0,0,0,0
94484,0,0,0,0,0
62727,0,0,0,0,0
45534,0,0,0,0,0
27058,0,0,0,0,0
107157,0,0,0,0,0
17297,0,0,0,0,0
13789,0,0,0,0,0
106507,0,0,0,0,0
111600,0,0,0,0,0
115513,0,0,0,0,0
69024,0,0,0,0,0
39977,0,0,0,0,0
64938,0,0,0,0,0
53010,0,0,0,0,0
104543,0,0,0,0,0
5480,0,0,0,0,0
34560,0,0,0,0,0
101039,0,0,0,0,0
116647,0,0,0,0,0
107040,0,0,0,0,0
19860,0,0,0,0,0
10776,0,0,0,0,0
40190,0,0,0,0,0
83973,0,0,0,0,0
39192,0,0,0,0,0
120576,0,0,0,0,0
24213,0,0,0,0,0
47075,0,0,0,0,0
92692,0,0,0,0,0
18620,0,0,0,0,0
47961,0,0,0,0,0
101265,0,0,0,0,0
9964,0,0,0,0,0
87107,0,0,0,0,0
101030,0,0,0,0,0
58463,0,0,0,0,0
67321,0,0,0,0,0
48092,0,0,0,0,0
95093,0,0,0,0,0
85013,0,0,0,0,0
13396,0,0,0,0,0
61843,0,0,0,0,0
92134,0,0,0,0,0
47175,0,0,0,0,0
85716,0,0,0,0,0
30191,0,0,0,0,0
105935,0,0,0,0,0
22961,0,0,0,0,0
83284,0,0,0,0,0
108895,0,0,0,0,0
102810,0,0,0,0,0
14426,0,0,0,0,0
108107,0,0,0,0,0
105902,0,0,0,0,0
26541,0,0,0,0,0
119483,0,0,0,0,0
117634,0,0,0,0,0
86993,0,0,0,0,0
115875,0,0,0,0,0
79522,0,0,0,0,0
38881,0,0,0,0,0
110835,0,0,0,0,0
48544,0,0,0,0,0
22365,0,0,0,0,0
29639,0,0,0,0,0
95169,1,1,1,0,0
35368,12,12,12,0,0
86793,0,0,0,0,0
33891,0,0,0,0,0
47830,0,0,0,0,0
48780,0,0,0,0,0
47367,0,0,0,0,0
6146,0,0,0,0,0
102449,0,0,0,0,0
89081,0,0,0,0,0
10833,0,0,0,0,0
105220,0,0,0,0,0
14487,0,0,0,0,0
40732,0,0,0,0,0
58858,0,0,0,0,0
51049,0,0,0,0,0
94314,0,0,0,0,0
109063,0,0,0,0,0
40155,0,0,0,0,0
72411,0,0,0,0,0
11624,0,0,0,0,0
91640,0,0,0,0,0
16888,0,0,0,0,0
59297,0,0,0,0,0
40637,0,0,0,0,0
40241,0,0,0,0,0
85659,0,0,0,0,0
23510,0,0,0,0,0
26247,0,0,0,0,0
939,0,0,0,0,0
97330,0,0,0,0,0
80190,0,0,0,0,0
108607,0,0,0,0,0
15067,0,0,0,0,0
75740,0,0,0,0,0
86364,0,0,0,0,0
33752,2,2,2,0,0
115392,0,0,0,0,0
76696,0,0,0,0,0
26475,0,0,0,0,0
47786,0,0,0,0,0
88352,0,0,0,0,0
22233,0,0,0,0,0
76251,0,0,0,0,0
111371,0,0,0,0,0
15711,0,0,0,0,0
34292,0,0,0,0,0
84024,0,0,0,0,0
73025,0,0,0,0,0
68694,0,0,0,0,0
90033,3,3,3,0,0
80600,0,0,0,0,0
73260,0,0,0,0,0
99955,0,0,0,0,0
39564,0,0,0,0,0
57180,0,0,0,0,0
75782,0,0,0,0,0
74681,0,0,0,0,0
19461,0,0,0,0,0
52838,0,0,0,0,0
11619,0,0,0,0,0
78056,0,0,0,0,0
105962,0,0,0,0,0
30024,0,0,0,0,0
46693,0,0,0,0,0
19107,0,0,0,0,0
112063,0,0,0,0,0
55388,0,0,0,0,0
111079,0,0,0,0,0
113315,1,1,1,0,0
4422,0,0,0,0,0
865,0,0,0,0,0
59632,0,0,0,0,0
47741,0,0,0,0,0
29736,0,0,0,0,0
34452,0,0,0,0,0
36012,0,0,0,0,0
7613,0,0,0,0,0
69135,0,0,0,0,0
17925,0,0,0,0,0
54185,0,0,0,0,0
118983,0,0,0,0,0
44728,0,0,0,0,0
41249,0,0,0,0,0
14004,6,6,6,0,0
12094,0,0,0,0,0
77053,0,0,0,0,0
105538,1,1,1,0,0
26141,0,0,0,0,0
66788,0,0,0,0,0
115250,0,0,0,0,0
90909,0,0,0,0,0
20795,0,0,0,0,0
89430,0,0,0,0,0
85241,0,0,0,0,0
27961,0,0,0,0,0
59640,0,0,0,0,0
35032,0,0,0,0,0
80108,0,0,0,0,0
7266,0,0,0,0,0
3619,0,0,0,0,0
107401,0,0,0,0,0
116212,0,0,0,0,0
14654,1,1,1,0,0
17554,0,0,0,0,0
115204,0,0,0,0,0
119413,0,0,0,0,0
94949,0,0,0,0,0
13484,0,0,0,0,0
105324,0,0,0,0,0
42967,0,0,0,0,0
43407,0,0,0,0,0
53509,0,0,0,0,0
93360,0,0,0,0,0
1922,0,0,0,0,0
64305,0,0,0,0,0
102045,0,0,0,0,0
44306,0,0,0,0,0
110713,0,0,0,0,0
57656,0,0,0,0,0
41069,0,0,0,0,0
87686,0,0,0,0,0
86253,0,0,0,0,0
80869,0,0,0,0,0
69597,0,0,0,0,0
67939,0,0,0,0,0
50615,0,0,0,0,0
108658,0,0,0,0,0
83348,0,0,0,0,0
28930,0,0,0,0,0
107843,0,0,0,0,0
105519,0,0,0,0,0
107295,0,0,0,0,0
50385,0,0,0,0,0
57730,0,0,0,0,0
21923,0,0,0,0,0
101064,0,0,0,0,0
22468,0,0,0,0,0
75044,0,0,0,0,0
49611,0,0,0,0,0
27566,0,0,0,0,0
95680,0,0,0,0,0
118463,0,0,0,0,0
16998,0,0,0,0,0
51458,0,0,0,0,0
99400,0,0,0,0,0
18630,0,0,0,0,0
99940,0,0,0,0,0
89241,0,0,0,0,0
8036,0,0,0,0,0
25617,0,0,0,0,0
26330,0,0,0,0,0
92087,0,0,0,0,0
22514,0,0,0,0,0
107051,0,0,0,0,0
17757,0,0,0,0,0
61165,0,0,0,0,0
110172,0,0,0,0,0
85741,0,0,0,0,0
7241,0,0,0,0,0
53101,0,0,0,0,0
52144,0,0,0,0,0
34762,0,0,0,0,0
66136,0,0,0,0,0
62769,0,0,0,0,0
81883,0,0,0,0,0
33664,0,0,0,0,0
114089,0,0,0,0,0
82940,0,0,0,0,0
50685,0,0,0,0,0
30413,0,0,0,0,0
101785,1,1,1,0,0
12563,0,0,0,0,0
105498,0,0,0,0,0
99365,0,0,0,0,0
91053,0,0,0,0,0
20442,0,0,0,0,0
51887,0,0,0,0,0
86193,0,0,0,0,0
100059,0,0,0,0,0
9939,0,0,0,0,0
84566,0,0,0,0,0
63084,0,0,0,0,0
33490,0,0,0,0,0
110061,2,2,2,0,0
85935,0,0,0,0,0
109443,0,0,0,0,0
10114,0,0,0,0,0
1859,0,0,0,0,0
8392,0,0,0,0,0
60941,0,0,0,0,0
63635,0,0,0,0,0
74949,0,0,0,0,0
9,0,0,0,0,0
109893,0,0,0,0,0
94655,0,0,0,0,0
21216,0,0,0,0,0
81472,0,0,0,0,0
22952,0,0,0,0,0
98306,0,0,0,0,0
45817,0,0,0,0,0
114150,0,0,0,0,0
111211,0,0,0,0,0
38667,0,0,0,0,0
50109,0,0,0,0,0
102792,0,0,0,0,0
114120,0,0,0,0,0
19465,0,0,0,0,0
86508,0,0,0,0,0
78895,0,0,0,0,0
27165,0,0,0,0,0
13265,0,0,0,0,0
20041,0,0,0,0,0
117919,0,0,0,0,0
115154,0,0,0,0,0
81895,0,0,0,0,0
44325,0,0,0,0,0
96593,0,0,0,0,0
33870,0,0,0,0,0
100474,0,0,0,0,0
116835,0,0,0,0,0
43715,0,0,0,0,0
112624,0,0,0,0,0
28126,0,0,0,0,0
33647,0,0,0,0,0
22401,0,0,0,0,0
33043,0,0,0,0,0
25459,0,0,0,0,0
105596,0,0,0,0,0
51503,0,0,0,0,0
118790,0,0,0,0,0
87058,0,0,0,0,0
24966,0,0,0,0,0
12832,0,0,0,0,0
549,0,0,0,0,0
104812,0,0,0,0,0
54916,0,0,0,0,0
19518,0,0,0,0,0
6140,0,0,0,0,0
10982,0,0,0,0,0
17075,0,0,0,0,0
40664,0,0,0,0,0
66771,0,0,0,0,0
95100,0,0,0,0,0
99653,0,0,0,0,0
101750,0,0,0,0,0
67030,0,0,0,0,0
86407,0,0,0,0,0
44450,0,0,0,0,0
23611,0,0,0,0,0
40899,0,0,0,0,0
109771,0,0,0,0,0
32386,0,0,0,0,0
74648,0,0,0,0,0
113758,0,0,0,0,0
76622,0,0,0,0,0
57654,0,0,0,0,0
96667,1,1,1,0,0
7965,0,0,0,0,0
55465,0,0,0,0,0
88686,0,0,0,0,0
39627,0,0,0,0,0
9596,0,0,0,0,0
55835,0,0,0,0,0
46411,0,0,0,0,0
44917,0,0,0,0,0
30292,0,0,0,0,0
113766,0,0,0,0,0
76068,0,0,0,0,0
35484,0,0,0,0,0
113276,0,0,0,0,0
116425,0,0,0,0,0
114065,0,0,0,0,0
81078,0,0,0,0,0
18544,0,0,0,0,0
84813,0,0,0,0,0
70191,0,0,0,0,0
39721,0,0,0,0,0
112308,1,1,1,0,0
108580,0,0,0,0,0
38071,0,0,0,0,0
40130,0,0,0,0,0
50463,0,0,0,0,0
32711,0,0,0,0,0
69999,0,0,0,0,0
114450,0,0,0,0,0
106514,0,0,0,0,0
51703,0,0,0,0,0
53878,0,0,0,0,0
74277,0,0,0,0,0
91686,0,0,0,0,0
31651,0,0,0,0,0
95940,0,0,0,0,0
45969,0,0,0,0,0
88479,0,0,0,0,0
62501,0,0,0,0,0
78356,0,0,0,0,0
89340,0,0,0,0,0
45385,0,0,0,0,0
55174,0,0,0,0,0
3948,0,0,0,0,0
114193,0,0,0,0,0
108571,0,0,0,0,0
80618,0,0,0,0,0
113179,0,0,0,0,0
44420,0,0,0,0,0
59705,0,0,0,0,0
60068,0,0,0,0,0
119335,0,0,0,0,0
102477,0,0,0,0,0
116545,0,0,0,0,0
33486,0,0,0,0,0
71167,0,0,0,0,0
48841,0,0,0,0,0
51448,0,0,0,0,0
72072,0,0,0,0,0
101711,0,0,0,0,0
47648,0,0,0,0,0
119674,0,0,0,0,0
1390,0,0,0,0,0
88297,0,0,0,0,0
70543,0,0,0,0,0
61131,0,0,0,0,0
109681,0,0,0,0,0
105552,0,0,0,0,0
85456,1,1,1,0,0
25123,0,0,0,0,0
82708,0,0,0,0,0
116168,0,0,0,0,0
8221,0,0,0,0,0
77488,0,0,0,0,0
61406,0,0,0,0,0
84951,0,0,0,0,0
116414,0,0,0,0,0
70117,0,0,0,0,0
66431,0,0,0,0,0
46914,0,0,0,0,0
93918,0,0,0,0,0
16591,0,0,0,0,0
118589,0,0,0,0,0
52124,0,0,0,0,0
117089,0,0,0,0,0
100545,0,0,0,0,0
2353,0,0,0,0,0
68195,0,0,0,0,0
9190,0,0,0,0,0
18871,0,0,0,0,0
41721,0,0,0,0,0
9127,0,0,0,0,0
103115,0,0,0,0,0
86893,0,0,0,0,0
55529,0,0,0,0,0
2848,0,0,0,0,0
5819,0,0,0,0,0
38494,0,0,0,0,0
118195,0,0,0,0,0
62231,0,0,0,0,0
99383,0,0,0,0,0
32822,0,0,0,0,0
62036,0,0,0,0,0
88797,0,0,0,0,0
97793,0,0,0,0,0
26384,0,0,0,0,0
3160,0,0,0,0,0
79900,0,0,0,0,0
88181,0,0,0,0,0
59502,0,0,0,0,0
109260,0,0,0,0,0
88657,0,0,0,0,0
50765,0,0,0,0,0
9022,0,0,0,0,0
66280,0,0,0,0,0
94046,0,0,0,0,0
58116,0,0,0,0,0
68754,0,0,0,0,0
38812,0,0,0,0,0
113237,0,0,0,0,0
58472,0,0,0,0,0
111091,0,0,0,0,0
4869,0,0,0,0,0
64672,2,2,2,0,0
88128,0,0,0,0,0
6910,0,0,0,0,0
16309,0,0,0,0,0
43784,0,0,0,0,0
31885,0,0,0,0,0
9145,0,0,0,0,0
55408,0,0,0,0,0
16526,0,0,0,0,0
13211,0,0,0,0,0
103104,0,0,0,0,0
45405,0,0,0,0,0
118991,0,0,0,0,0
40253,0,0,0,0,0
103015,0,0,0,0,0
89024,0,0,0,0,0
31344,0,0,0,0,0
119371,0,0,0,0,0
27081,0,0,0,0,0
32702,0,0,0,0,0
45434,0,0,0,0,0
45676,0,0,0,0,0
117106,0,0,0,0,0
120125,0,0,0,0,0
17034,0,0,0,0,0
45954,0,0,0,0,0
28002,0,0,0,0,0
119453,0,0,0,0,0
86225,0,0,0,0,0
24932,0,0,0,0,0
93198,0,0,0,0,0
54793,0,0,0,0,0
59837,0,0,0,0,0
119359,0,0,0,0,0
93768,0,0,0,0,0
100026,0,0,0,0,0
21291,0,0,0,0,0
18816,0,0,0,0,0
28994,0,0,0,0,0
114432,0,0,0,0,0
92380,0,0,0,0,0
67096,0,0,0,0,0
30263,0,0,0,0,0
90582,0,0,0,0,0
23335,0,0,0,0,0
9122,0,0,0,0,0
16487,0,0,0,0,0
110446,0,0,0,0,0
3106,0,0,0,0,0
70616,0,0,0,0,0
77388,0,0,0,0,0
52035,0,0,0,0,0
16649,0,0,0,0,0
21652,0,0,0,0,0
103757,0,0,0,0,0
45967,0,0,0,0,0
114624,0,0,0,0,0
18211,0,0,0,0,0
120476,0,0,0,0,0
59038,0,0,0,0,0
68327,0,0,0,0,0
29786,0,0,0,0,0
17560,0,0,0,0,0
18819,0,0,0,0,0
86283,0,0,0,0,0
107022,0,0,0,0,0
73768,0,0,0,0,0
73151,0,0,0,0,0
77766,0,0,0,0,0
68135,0,0,0,0,0
15441,0,0,0,0,0
107105,0,0,0,0,0
34734,0,0,0,0,0
27808,0,0,0,0,0
80185,0,0,0,0,0
58796,0,0,0,0,0
95004,0,0,0,0,0
22152,0,0,0,0,0
41455,0,0,0,0,0
18476,0,0,0,0,0
52475,0,0,0,0,0
88441,0,0,0,0,0
45197,0,0,0,0,0
101714,0,0,0,0,0
61652,0,0,0,0,0
13144,0,0,0,0,0
111828,0,0,0,0,0
79307,0,0,0,0,0
12810,0,0,0,0,0
62164,0,0,0,0,0
79515,0,0,0,0,0
70501,0,0,0,0,0
11991,0,0,0,0,0
89853,0,0,0,0,0
119344,0,0,0,0,0
115639,0,0,0,0,0
109739,0,0,0,0,0
18532,0,0,0,0,0
32210,0,0,0,0,0
113259,0,0,0,0,0
90658,0,0,0,0,0
111241,0,0,0,0,0
114870,0,0,0,0,0
96855,0,0,0,0,0
19195,0,0,0,0,0
32881,0,0,0,0,0
78651,0,0,0,0,0
110564,0,0,0,0,0
43110,0,0,0,0,0
80980,0,0,0,0,0
58564,0,0,0,0,0
11076,0,0,0,0,0
83441,0,0,0,0,0
28298,0,0,0,0,0
103667,0,0,0,0,0
46343,0,0,0,0,0
78959,0,0,0,0,0
32376,0,0,0,0,0
57913,0,0,0,0,0
119253,0,0,0,0,0
110905,0,0,0,0,0
41097,0,0,0,0,0
23568,0,0,0,0,0
96043,0,0,0,0,0
56155,0,0,0,0,0
66153,0,0,0,0,0
108765,0,0,0,0,0
14874,0,0,0,0,0
15740,0,0,0,0,0
38741,0,0,0,0,0
32820,0,0,0,0,0
59416,0,0,0,0,0
70584,1,1,1,0,0
117695,0,0,0,0,0
117660,0,0,0,0,0
46366,0,0,0,0,0
52000,0,0,0,0,0
78690,0,0,0,0,0
104640,0,0,0,0,0
73609,0,0,0,0,0
34329,0,0,0,0,0
70296,0,0,0,0,0
15581,0,0,0,0,0
78716,0,0,0,0,0
102759,0,0,0,0,0
42025,0,0,0,0,0
110289,0,0,0,0,0
53857,0,0,0,0,0
57537,0,0,0,0,0
118572,0,0,0,0,0
52782,0,0,0,0,0
103696,0,0,0,0,0
56944,0,0,0,0,0
111308,0,0,0,0,0
56941,0,0,0,0,0
7038,0,0,0,0,0
105114,0,0,0,0,0
43491,0,0,0,0,0
61080,0,0,0,0,0
89469,0,0,0,0,0
79028,0,0,0,0,0
89981,0,0,0,0,0
38702,0,0,0,0,0
61446,0,0,0,0,0
77099,0,0,0,0,0
110775,0,0,0,0,0
74200,0,0,0,0,0
68569,0,0,0,0,0
31627,0,0,0,0,0
71019,0,0,0,0,0
79402,0,0,0,0,0
119017,0,0,0,0,0
96304,0,0,0,0,0
27633,0,0,0,0,0
2874,0,0,0,0,0
54256,0,0,0,0,0
86357,0,0,0,0,0
90008,0,0,0,0,0
82219,0,0,0,0,0
23520,0,0,0,0,0
89142,0,0,0,0,0
108379,0,0,0,0,0
30320,0,0,0,0,0
30880,0,0,0,0,0
23977,0,0,0,0,0
112771,0,0,0,0,0
63066,0,0,0,0,0
82473,0,0,0,0,0
38868,0,0,0,0,0
52257,0,0,0,0,0
43852,0,0,0,0,0
26639,0,0,0,0,0
88850,0,0,0,0,0
36062,0,0,0,0,0
117006,0,0,0,0,0
16478,0,0,0,0,0
33615,0,0,0,0,0
113387,0,0,0,0,0
78005,0,0,0,0,0
60066,0,0,0,0,0
98908,0,0,0,0,0
38364,0,0,0,0,0
37827,0,0,0,0,0
72125,0,0,0,0,0
5862,0,0,0,0,0
66289,0,0,0,0,0
108335,0,0,0,0,0
36401,0,0,0,0,0
52526,0,0,0,0,0
75918,0,0,0,0,0
79409,0,0,0,0,0
37116,0,0,0,0,0
38520,0,0,0,0,0
100518,0,0,0,0,0
70974,0,0,0,0,0
61956,1,1,1,0,0
108769,0,0,0,0,0
79017,0,0,0,0,0
36579,0,0,0,0,0
55750,0,0,0,0,0
49189,0,0,0,0,0
119632,0,0,0,0,0
120545,0,0,0,0,0
82363,0,0,0,0,0
19676,0,0,0,0,0
42635,0,0,0,0,0
82931,0,0,0,0,0
58579,0,0,0,0,0
50123,0,0,0,0,0
67074,0,0,0,0,0
84706,0,0,0,0,0
5619,0,0,0,0,0
30733,0,0,0,0,0
89117,0,0,0,0,0
92223,0,0,0,0,0
52676,0,0,0,0,0
36979,0,0,0,0,0
52625,0,0,0,0,0
82752,0,0,0,0,0
107335,0,0,0,0,0
39073,0,0,0,0,0
75188,0,0,0,0,0
119613,0,0,0,0,0
36423,0,0,0,0,0
88483,0,0,0,0,0
42866,0,0,0,0,0
36998,0,0,0,0,0
19388,0,0,0,0,0
106637,0,0,0,0,0
102078,0,0,0,0,0
120282,0,0,0,0,0
119508,0,0,0,0,0
47789,0,0,0,0,0
36517,0,0,0,0,0
116866,0,0,0,0,0
95608,0,0,0,0,0
54598,0,0,0,0,0
46679,0,0,0,0,0
107756,0,0,0,0,0
67436,0,0,0,0,0
58558,0,0,0,0,0
89897,0,0,0,0,0
116367,0,0,0,0,0
112970,0,0,0,0,0
83366,0,0,0,0,0
96961,0,0,0,0,0
15826,0,0,0,0,0
120330,0,0,0,0,0
31158,0,0,0,0,0
42949,0,0,0,0,0
27315,0,0,0,0,0
91607,0,0,0,0,0
17851,0,0,0,0,0
5235,0,0,0,0,0
97983,0,0,0,0,0
17252,0,0,0,0,0
92683,0,0,0,0,0
51162,0,0,0,0,0
56465,0,0,0,0,0
15656,0,0,0,0,0
118981,0,0,0,0,0
13763,0,0,0,0,0
32012,0,0,0,0,0
103622,3,3,3,0,0
28830,0,0,0,0,0
58659,0,0,0,0,0
94089,0,0,0,0,0
27101,0,0,0,0,0
106788,0,0,0,0,0
84259,0,0,0,0,0
31247,0,0,0,0,0
77847,0,0,0,0,0
68069,3,3,3,0,0
28792,0,0,0,0,0
2760,0,0,0,0,0
70397,0,0,0,0,0
62363,0,0,0,0,0
96290,0,0,0,0,0
22419,0,0,0,0,0
55616,0,0,0,0,0
27149,0,0,0,0,0
87528,0,0,0,0,0
12788,0,0,0,0,0
20532,0,0,0,0,0
81387,0,0,0,0,0
8070,0,0,0,0,0
81715,0,0,0,0,0
33008,0,0,0,0,0
30288,0,0,0,0,0
87022,0,0,0,0,0
56861,0,0,0,0,0
57242,0,0,0,0,0
105943,0,0,0,0,0
62649,0,0,0,0,0
51239,0,0,0,0,0
62636,0,0,0,0,0
71675,0,0,0,0,0
68227,0,0,0,0,0
74242,0,0,0,0,0
53775,0,0,0,0,0
113596,0,0,0,0,0
36885,0,0,0,0,0
27501,0,0,0,0,0
75843,0,0,0,0,0
15369,0,0,0,0,0
94630,0,0,0,0,0
82816,0,0,0,0,0
115341,0,0,0,0,0
36632,0,0,0,0,0
8446,0,0,0,0,0
69017,0,0,0,0,0
8783,0,0,0,0,0
38755,0,0,0,0,0
22543,0,0,0,0,0
106110,0,0,0,0,0
62302,0,0,0,0,0
90826,0,0,0,0,0
55367,0,0,0,0,0
101850,0,0,0,0,0
59329,0,0,0,0,0
47642,0,0,0,0,0
81445,0,0,0,0,0
81259,0,0,0,0,0
70931,0,0,0,0,0
108637,0,0,0,0,0
119786,0,0,0,0,0
60375,0,0,0,0,0
77609,0,0,0,0,0
61425,0,0,0,0,0
85259,0,0,0,0,0
84437,0,0,0,0,0
80437,0,0,0,0,0
8415,0,0,0,0,0
43823,0,0,0,0,0
101149,0,0,0,0,0
28858,0,0,0,0,0
11976,0,0,0,0,0
44552,0,0,0,0,0
100078,0,0,0,0,0
112776,0,0,0,0,0
68220,0,0,0,0,0
85992,0,0,0,0,0
94872,0,0,0,0,0
19074,0,0,0,0,0
40064,0,0,0,0,0
49858,0,0,0,0,0
99342,0,0,0,0,0
68164,0,0,0,0,0
102975,0,0,0,0,0
82289,0,0,0,0,0
73505,0,0,0,0,0
118906,0,0,0,0,0
83768,0,0,0,0,0
75321,0,0,0,0,0
62225,0,0,0,0,0
98225,0,0,0,0,0
76993,0,0,0,0,0
30359,0,0,0,0,0
97171,0,0,0,0,0
54531,0,0,0,0,0
117958,0,0,0,0,0
68806,0,0,0,0,0
97737,5,5,5,0,0
80334,0,0,0,0,0
117882,0,0,0,0,0
824,0,0,0,0,0
67615,0,0,0,0,0
38446,0,0,0,0,0
7386,0,0,0,0,0
12822,0,0,0,0,0
12679,0,0,0,0,0
8170,0,0,0,0,0
86591,0,0,0,0,0
104897,0,0,0,0,0
48638,0,0,0,0,0
16953,0,0,0,0,0
68809,0,0,0,0,0
80877,0,0,0,0,0
65132,0,0,0,0,0
62557,0,0,0,0,0
66637,0,0,0,0,0
36519,0,0,0,0,0
92373,0,0,0,0,0
33028,0,0,0,0,0
76339,0,0,0,0,0
37760,0,0,0,0,0
48404,0,0,0,0,0
57352,0,0,0,0,0
113331,0,0,0,0,0
49493,0,0,0,0,0
77540,0,0,0,0,0
26202,0,0,0,0,0
90152,0,0,0,0,0
14642,0,0,0,0,0
56079,0,0,0,0,0
88156,0,0,0,0,0
6095,0,0,0,0,0
34458,0,0,0,0,0
4079,0,0,0,0,0
48519,0,0,0,0,0
37584,0,0,0,0,0
42361,0,0,0,0,0
78223,0,0,0,0,0
117676,0,0,0,0,0
105320,0,0,0,0,0
50051,0,0,0,0,0
75778,0,0,0,0,0
37774,0,0,0,0,0
31444,0,0,0,0,0
94212,0,0,0,0,0
20928,0,0,0,0,0
37384,0,0,0,0,0
691,0,0,0,0,0
105761,0,0,0,0,0
20959,0,0,0,0,0
8756,0,0,0,0,0
107411,0,0,0,0,0
118235,0,0,0,0,0
115063,0,0,0,0,0
74223,0,0,0,0,0
26537,0,0,0,0,0
14381,0,0,0,0,0
109165,0,0,0,0,0
4432,0,0,0,0,0
93138,0,0,0,0,0
11800,0,0,0,0,0
13600,0,0,0,0,0
119986,0,0,0,0,0
10369,0,0,0,0,0
19692,0,0,0,0,0
105789,0,0,0,0,0
107351,0,0,0,0,0
62720,0,0,0,0,0
57926,0,0,0,0,0
76037,0,0,0,0,0
70356,0,0,0,0,0
36667,0,0,0,0,0
26576,0,0,0,0,0
1499,0,0,0,0,0
114920,0,0,0,0,0
101781,0,0,0,0,0
50208,0,0,0,0,0
97391,0,0,0,0,0
34788,0,0,0,0,0
49774,0,0,0,0,0
59353,0,0,0,0,0
77877,0,0,0,0,0
89359,3,3,3,0,0
84842,0,0,0,0,0
80522,0,0,0,0,0
86605,0,0,0,0,0
111824,0,0,0,0,0
95913,0,0,0,0,0
101383,0,0,0,0,0
104293,0,0,0,0,0
29207,0,0,0,0,0
66716,0,0,0,0,0
12254,0,0,0,0,0
117792,0,0,0,0,0
34709,0,0,0,0,0
47653,0,0,0,0,0
84899,0,0,0,0,0
48351,0,0,0,0,0
16277,0,0,0,0,0
110541,0,0,0,0,0
58577,0,0,0,0,0
24279,0,0,0,0,0
46074,0,0,0,0,0
47348,0,0,0,0,0
47896,0,0,0,0,0
68502,0,0,0,0,0
7314,0,0,0,0,0
41580,0,0,0,0,0
21407,0,0,0,0,0
68550,0,0,0,0,0
47053,0,0,0,0,0
102171,0,0,0,0,0
22564,0,0,0,0,0
41356,0,0,0,0,0
84980,0,0,0,0,0
50090,0,0,0,0,0
98147,1,1,1,0,0
1718,0,0,0,0,0
49952,0,0,0,0,0
82134,0,0,0,0,0
77565,0,0,0,0,0
116386,0,0,0,0,0
32291,0,0,0,0,0
95560,0,0,0,0,0
38393,0,0,0,0,0
27280,0,0,0,0,0
70646,0,0,0,0,0
113894,0,0,0,0,0
117438,0,0,0,0,0
17624,0,0,0,0,0
8247,0,0,0,0,0
106310,0,0,0,0,0
16942,0,0,0,0,0
40619,0,0,0,0,0
46863,0,0,0,0,0
12234,0,0,0,0,0
6594,0,0,0,0,0
48027,0,0,0,0,0
62467,0,0,0,0,0
108715,0,0,0,0,0
40777,1,1,1,0,0
58342,0,0,0,0,0
101558,0,0,0,0,0
17569,0,0,0,0,0
36987,0,0,0,0,0
93897,0,0,0,0,0
50920,0,0,0,0,0
101600,2,2,2,0,0
7318,0,0,0,0,0
52516,0,0,0,0,0
105191,0,0,0,0,0
75231,0,0,0,0,0
2183,0,0,0,0,0
35722,0,0,0,0,0
72191,0,0,0,0,0
66078,0,0,0,0,0
37915,0,0,0,0,0
87955,0,0,0,0,0
4465,0,0,0,0,0
30913,0,0,0,0,0
71563,0,0,0,0,0
48534,0,0,0,0,0
109167,0,0,0,0,0
119643,0,0,0,0,0
98110,0,0,0,0,0
68215,0,0,0,0,0
35873,0,0,0,0,0
47939,1,1,1,0,0
76643,6,6,6,0,0
33106,0,0,0,0,0
105909,0,0,0,0,0
14346,0,0,0,0,0
94013,0,0,0,0,0
46313,0,0,0,0,0
10115,0,0,0,0,0
47530,0,0,0,0,0
115863,0,0,0,0,0
50606,0,0,0,0,0
60549,0,0,0,0,0
116473,0,0,0,0,0
64065,0,0,0,0,0
38688,0,0,0,0,0
16797,0,0,0,0,0
42236,0,0,0,0,0
77272,0,0,0,0,0
89511,0,0,0,0,0
71418,0,0,0,0,0
102376,0,0,0,0,0
69663,0,0,0,0,0
98346,0,0,0,0,0
13242,0,0,0,0,0
86428,0,0,0,0,0
7777,0,0,0,0,0
12712,0,0,0,0,0
95534,0,0,0,0,0
66993,0,0,0,0,0
34340,0,0,0,0,0
94583,0,0,0,0,0
113716,0,0,0,0,0
71151,0,0,0,0,0
8843,0,0,0,0,0
51052,0,0,0,0,0
92747,2,2,2,0,0
15224,0,0,0,0,0
1728,0,0,0,0,0
83783,0,0,0,0,0
24286,0,0,0,0,0
73571,0,0,0,0,0
33177,0,0,0,0,0
49897,0,0,0,0,0
35230,0,0,0,0,0
30848,0,0,0,0,0
12483,0,0,0,0,0
35261,0,0,0,0,0
108306,0,0,0,0,0
56776,2,2,2,0,0
71729,0,0,0,0,0
85639,0,0,0,0,0
71350,0,0,0,0,0
10843,0,0,0,0,0
57512,0,0,0,0,0
46389,0,0,0,0,0
82072,0,0,0,0,0
1562,0,0,0,0,0
47437,0,0,0,0,0
62711,0,0,0,0,0
66994,0,0,0,0,0
91101,0,0,0,0,0
119328,0,0,0,0,0
61451,0,0,0,0,0
119511,0,0,0,0,0
55423,0,0,0,0,0
24219,0,0,0,0,0
3769,0,0,0,0,0
58566,0,0,0,0,0
104267,0,0,0,0,0
87049,0,0,0,0,0
71524,0,0,0,0,0
33931,0,0,0,0,0
16282,0,0,0,0,0
57992,0,0,0,0,0
119930,2,2,2,0,0
49321,0,0,0,0,0
114207,0,0,0,0,0
99117,0,0,0,0,0
88277,0,0,0,0,0
101705,0,0,0,0,0
70886,0,0,0,0,0
115754,0,0,0,0,0
61852,0,0,0,0,0
42174,0,0,0,0,0
92127,0,0,0,0,0
111420,0,0,0,0,0
101178,0,0,0,0,0
46966,0,0,0,0,0
69494,0,0,0,0,0
105041,0,0,0,0,0
95554,0,0,0,0,0
49554,0,0,0,0,0
84125,0,0,0,0,0
36283,0,0,0,0,0
39605,0,0,0,0,0
43448,0,0,0,0,0
25073,0,0,0,0,0
86727,0,0,0,0,0
93911,0,0,0,0,0
80558,0,0,0,0,0
58699,0,0,0,0,0
6726,0,0,0,0,0
99687,0,0,0,0,0
15538,0,0,0,0,0
91411,0,0,0,0,0
87025,0,0,0,0,0
26324,0,0,0,0,0
21438,0,0,0,0,0
35521,0,0,0,0,0
32978,0,0,0,0,0
60400,0,0,0,0,0
19089,0,0,0,0,0
88252,0,0,0,0,0
55415,0,0,0,0,0
15710,0,0,0,0,0
16053,0,0,0,0,0
36765,0,0,0,0,0
39895,0,0,0,0,0
41341,0,0,0,0,0
14116,0,0,0,0,0
78317,0,0,0,0,0
70384,0,0,0,0,0
8893,0,0,0,0,0
622,0,0,0,0,0
14471,0,0,0,0,0
27956,0,0,0,0,0
55121,0,0,0,0,0
495,0,0,0,0,0
26536,0,0,0,0,0
55519,0,0,0,0,0
76783,0,0,0,0,0
844,0,0,0,0,0
113450,0,0,0,0,0
119281,0,0,0,0,0
106028,0,0,0,0,0
86044,0,0,0,0,0
93989,4,4,4,0,0
103005,0,0,0,0,0
76082,0,0,0,0,0
5047,0,0,0,0,0
14740,0,0,0,0,0
5428,0,0,0,0,0
55321,0,0,0,0,0
41673,0,0,0,0,0
54591,0,0,0,0,0
34347,0,0,0,0,0
83877,1,1,1,0,0
10257,0,0,0,0,0
8629,0,0,0,0,0
70223,0,0,0,0,0
37751,0,0,0,0,0
103100,0,0,0,0,0
21683,0,0,0,0,0
74062,0,0,0,0,0
41295,0,0,0,0,0
3318,0,0,0,0,0
69322,0,0,0,0,0
107470,0,0,0,0,0
29100,0,0,0,0,0
120469,0,0,0,0,0
1844,0,0,0,0,0
106125,0,0,0,0,0
49545,0,0,0,0,0
93986,0,0,0,0,0
83312,0,0,0,0,0
91207,0,0,0,0,0
21432,0,0,0,0,0
69276,0,0,0,0,0
37815,0,0,0,0,0
73400,0,0,0,0,0
7551,0,0,0,0,0
34130,0,0,0,0,0
10889,0,0,0,0,0
97242,0,0,0,0,0
114674,0,0,0,0,0
2497,0,0,0,0,0
84300,0,0,0,0,0
9708,0,0,0,0,0
37138,0,0,0,0,0
23174,0,0,0,0,0
89171,0,0,0,0,0
80401,0,0,0,0,0
29728,0,0,0,0,0
62264,0,0,0,0,0
15589,0,0,0,0,0
43936,0,0,0,0,0
46272,0,0,0,0,0
31602,0,0,0,0,0
63088,0,0,0,0,0
25265,0,0,0,0,0
25173,0,0,0,0,0
109041,0,0,0,0,0
85736,0,0,0,0,0
56557,0,0,0,0,0
76470,0,0,0,0,0
118147,0,0,0,0,0
59487,0,0,0,0,0
57934,0,0,0,0,0
47756,0,0,0,0,0
82573,0,0,0,0,0
12992,0,0,0,0,0
33107,0,0,0,0,0
101176,0,0,0,0,0
10699,0,0,0,0,0
14071,0,0,0,0,0
69334,0,0,0,0,0
72601,0,0,0,0,0
10067,0,0,0,0,0
77078,0,0,0,0,0
72501,0,0,0,0,0
35660,0,0,0,0,0
36148,0,0,0,0,0
91051,3,3,3,0,0
64635,0,0,0,0,0
7223,0,0,0,0,0
75171,0,0,0,0,0
60614,0,0,0,0,0
100878,0,0,0,0,0
58633,3,3,3,0,0
64507,0,0,0,0,0
31840,0,0,0,0,0
9886,0,0,0,0,0
95070,0,0,0,0,0
68881,0,0,0,0,0
28644,0,0,0,0,0
47185,0,0,0,0,0
106708,0,0,0,0,0
94627,0,0,0,0,0
42083,0,0,0,0,0
85799,0,0,0,0,0
25229,0,0,0,0,0
35193,0,0,0,0,0
11655,0,0,0,0,0
52313,0,0,0,0,0
56841,0,0,0,0,0
9585,0,0,0,0,0
24423,0,0,0,0,0
31747,0,0,0,0,0
65256,0,0,0,0,0
5169,0,0,0,0,0
23835,0,0,0,0,0
81435,1,1,1,0,0
79604,0,0,0,0,0
87018,0,0,0,0,0
69961,0,0,0,0,0
65920,0,0,0,0,0
10563,0,0,0,0,0
70249,0,0,0,0,0
47267,0,0,0,0,0
76821,0,0,0,0,0
38336,0,0,0,0,0
96664,0,0,0,0,0
18327,0,0,0,0,0
59060,0,0,0,0,0
49243,0,0,0,0,0
5140,0,0,0,0,0
46248,0,0,0,0,0
13985,0,0,0,0,0
80896,0,0,0,0,0
53538,0,0,0,0,0
67157,0,0,0,0,0
46881,0,0,0,0,0
81892,0,0,0,0,0
64001,0,0,0,0,0
43905,0,0,0,0,0
111886,0,0,0,0,0
80867,0,0,0,0,0
86194,0,0,0,0,0
25524,0,0,0,0,0
60321,0,0,0,0,0
26051,0,0,0,0,0
6384,0,0,0,0,0
22664,0,0,0,0,0
94742,0,0,0,0,0
73689,0,0,0,0,0
16773,0,0,0,0,0
69375,0,0,0,0,0
55054,0,0,0,0,0
108867,0,0,0,0,0
113419,0,0,0,0,0
34531,0,0,0,0,0
82768,0,0,0,0,0
43523,0,0,0,0,0
60838,0,0,0,0,0
86872,0,0,0,0,0
113061,0,0,0,0,0
114390,0,0,0,0,0
88908,0,0,0,0,0
55182,0,0,0,0,0
66018,0,0,0,0,0
27115,0,0,0,0,0
116859,0,0,0,0,0
79849,0,0,0,0,0
117685,0,0,0,0,0
45112,0,0,0,0,0
58421,0,0,0,0,0
29146,0,0,0,0,0
63199,0,0,0,0,0
35195,0,0,0,0,0
41451,0,0,0,0,0
110956,0,0,0,0,0
109493,0,0,0,0,0
68348,0,0,0,0,0
75683,0,0,0,0,0
42138,0,0,0,0,0
92300,0,0,0,0,0
32360,0,0,0,0,0
9281,0,0,0,0,0
109625,0,0,0,0,0
78303,0,0,0,0,0
53619,0,0,0,0,0
65529,0,0,0,0,0
75348,0,0,0,0,0
62556,0,0,0,0,0
107546,0,0,0,0,0
14974,0,0,0,0,0
107765,0,0,0,0,0
34687,0,0,0,0,0
48520,0,0,0,0,0
89161,0,0,0,0,0
77278,0,0,0,0,0
6467,0,0,0,0,0
98672,0,0,0,0,0
93885,0,0,0,0,0
33958,0,0,0,0,0
117169,4,4,4,0,0
12714,0,0,0,0,0
32341,0,0,0,0,0
84599,0,0,0,0,0
112948,0,0,0,0,0
111737,0,0,0,0,0
11214,0,0,0,0,0
50990,0,0,0,0,0
93970,0,0,0,0,0
51471,0,0,0,0,0
9233,0,0,0,0,0
99180,0,0,0,0,0
11485,0,0,0,0,0
100253,0,0,0,0,0
104269,0,0,0,0,0
7110,0,0,0,0,0
10229,0,0,0,0,0
72205,0,0,0,0,0
77759,0,0,0,0,0
56475,0,0,0,0,0
46103,0,0,0,0,0
48037,0,0,0,0,0
43540,2,2,2,0,0
102330,0,0,0,0,0
57935,0,0,0,0,0
71404,0,0,0,0,0
100211,0,0,0,0,0
76062,0,0,0,0,0
63339,0,0,0,0,0
92158,0,0,0,0,0
100559,0,0,0,0,0
103693,0,0,0,0,0
37404,0,0,0,0,0
102981,0,0,0,0,0
72704,0,0,0,0,0
85586,0,0,0,0,0
12195,0,0,0,0,0
45057,0,0,0,0,0
40327,0,0,0,0,0
62565,0,0,0,0,0
31053,3,3,3,0,0
98477,0,0,0,0,0
19877,0,0,0,0,0
91750,0,0,0,0,0
96616,0,0,0,0,0
89548,0,0,0,0,0
41281,0,0,0,0,0
43137,0,0,0,0,0
44873,0,0,0,0,0
84145,0,0,0,0,0
63617,0,0,0,0,0
62913,0,0,0,0,0
62586,0,0,0,0,0
20403,0,0,0,0,0
73630,0,0,0,0,0
1798,0,0,0,0,0
23212,0,0,0,0,0
94426,0,0,0,0,0
70991,0,0,0,0,0
111418,0,0,0,0,0
2633,0,0,0,0,0
39341,0,0,0,0,0
100726,0,0,0,0,0
80837,0,0,0,0,0
85460,0,0,0,0,0
46822,0,0,0,0,0
9154,0,0,0,0,0
47179,0,0,0,0,0
63,0,0,0,0,0
42265,0,0,0,0,0
44740,0,0,0,0,0
109337,0,0,0,0,0
44236,0,0,0,0,0
62975,0,0,0,0,0
18522,0,0,0,0,0
75451,0,0,0,0,0
115610,0,0,0,0,0
62084,0,0,0,0,0
77998,0,0,0,0,0
48846,0,0,0,0,0
60406,0,0,0,0,0
71572,0,0,0,0,0
13248,0,0,0,0,0
5617,0,0,0,0,0
13493,0,0,0,0,0
21681,0,0,0,0,0
42568,0,0,0,0,0
70475,0,0,0,0,0
53576,0,0,0,0,0
5922,0,0,0,0,0
107034,0,0,0,0,0
80016,0,0,0,0,0
3536,0,0,0,0,0
30257,0,0,0,0,0
94368,0,0,0,0,0
30250,0,0,0,0,0
51415,0,0,0,0,0
100446,0,0,0,0,0
39939,0,0,0,0,0
62647,0,0,0,0,0
57385,0,0,0,0,0
54366,0,0,0,0,0
111920,0,0,0,0,0
110008,0,0,0,0,0
107951,3,3,3,0,0
401,0,0,0,0,0
36814,0,0,0,0,0
46609,0,0,0,0,0
71344,0,0,0,0,0
105470,0,0,0,0,0
10959,0,0,0,0,0
1492,0,0,0,0,0
119174,0,0,0,0,0
44127,0,0,0,0,0
31714,1,1,1,0,0
20872,0,0,0,0,0
25426,0,0,0,0,0
117687,0,0,0,0,0
109761,0,0,0,0,0
7553,0,0,0,0,0
94380,0,0,0,0,0
45362,0,0,0,0,0
7478,1,1,1,0,0
2180,0,0,0,0,0
6752,0,0,0,0,0
46631,0,0,0,0,0
104802,0,0,0,0,0
83944,0,0,0,0,0
114542,0,0,0,0,0
29079,0,0,0,0,0
39563,0,0,0,0,0
49141,0,0,0,0,0
92524,0,0,0,0,0
37894,0,0,0,0,0
32470,0,0,0,0,0
109736,0,0,0,0,0
15412,0,0,0,0,0
40246,0,0,0,0,0
41492,0,0,0,0,0
3395,0,0,0,0,0
59771,0,0,0,0,0
6537,0,0,0,0,0
48842,0,0,0,0,0
45364,0,0,0,0,0
25331,0,0,0,0,0
87907,0,0,0,0,0
57274,0,0,0,0,0
99608,0,0,0,0,0
45427,0,0,0,0,0
84516,0,0,0,0,0
43605,0,0,0,0,0
12665,0,0,0,0,0
91808,0,0,0,0,0
120394,0,0,0,0,0
104688,0,0,0,0,0
8020,0,0,0,0,0
70320,0,0,0,0,0
73530,0,0,0,0,0
1868,0,0,0,0,0
120033,0,0,0,0,0
29262,0,0,0,0,0
22160,0,0,0,0,0
20983,0,0,0,0,0
63482,0,0,0,0,0
102444,0,0,0,0,0
118475,0,0,0,0,0
102512,0,0,0,0,0
69601,0,0,0,0,0
22817,0,0,0,0,0
70810,0,0,0,0,0
71920,0,0,0,0,0
80179,0,0,0,0,0
49893,0,0,0,0,0
2685,0,0,0,0,0
23153,0,0,0,0,0
85843,0,0,0,0,0
118418,0,0,0,0,0
104703,0,0,0,0,0
49135,0,0,0,0,0
114275,0,0,0,0,0
98605,0,0,0,0,0
98753,0,0,0,0,0
99425,0,0,0,0,0
740,0,0,0,0,0
78214,0,0,0,0,0
75739,0,0,0,0,0
1845,0,0,0,0,0
48987,0,0,0,0,0
29770,0,0,0,0,0
23422,0,0,0,0,0
100375,0,0,0,0,0
10020,0,0,0,0,0
63256,0,0,0,0,0
8840,0,0,0,0,0
69660,0,0,0,0,0
3778,0,0,0,0,0
115697,0,0,0,0,0
4338,0,0,0,0,0
85201,0,0,0,0,0
90599,0,0,0,0,0
19180,0,0,0,0,0
28970,0,0,0,0,0
19100,0,0,0,0,0
9621,0,0,0,0,0
83873,0,0,0,0,0
33921,0,0,0,0,0
81465,0,0,0,0,0
45728,0,0,0,0,0
17872,0,0,0,0,0
86927,0,0,0,0,0
18232,0,0,0,0,0
113641,0,0,0,0,0
95330,0,0,0,0,0
20184,0,0,0,0,0
85361,0,0,0,0,0
75197,0,0,0,0,0
115879,0,0,0,0,0
56496,0,0,0,0,0
1556,0,0,0,0,0
62895,0,0,0,0,0
91310,0,0,0,0,0
13438,0,0,0,0,0
82460,0,0,0,0,0
16247,0,0,0,0,0
36314,0,0,0,0,0
118364,0,0,0,0,0
65037,0,0,0,0,0
114376,0,0,0,0,0
25599,0,0,0,0,0
2866,0,0,0,0,0
103299,0,0,0,0,0
106766,0,0,0,0,0
61214,0,0,0,0,0
92710,1,1,1,0,0
81286,0,0,0,0,0
41649,0,0,0,0,0
18557,0,0,0,0,0
31697,0,0,0,0,0
69080,0,0,0,0,0
91790,0,0,0,0,0
64174,0,0,0,0,0
116291,0,0,0,0,0
39819,0,0,0,0,0
108694,0,0,0,0,0
6525,0,0,0,0,0
15515,0,0,0,0,0
19535,0,0,0,0,0
20715,0,0,0,0,0
119462,0,0,0,0,0
22715,0,0,0,0,0
19422,0,0,0,0,0
58004,0,0,0,0,0
49874,0,0,0,0,0
112353,0,0,0,0,0
7280,0,0,0,0,0
31645,0,0,0,0,0
76162,0,0,0,0,0
37308,0,0,0,0,0
116543,0,0,0,0,0
72966,0,0,0,0,0
41424,0,0,0,0,0
7187,0,0,0,0,0
57052,0,0,0,0,0
102225,0,0,0,0,0
119137,0,0,0,0,0
102328,0,0,0,0,0
26387,0,0,0,0,0
60621,0,0,0,0,0
5624,0,0,0,0,0
47446,0,0,0,0,0
40164,0,0,0,0,0
37872,0,0,0,0,0
92010,0,0,0,0,0
13846,0,0,0,0,0
101517,0,0,0,0,0
47329,0,0,0,0,0
24965,0,0,0,0,0
90312,0,0,0,0,0
118759,0,0,0,0,0
39022,0,0,0,0,0
78390,0,0,0,0,0
8298,0,0,0,0,0
50014,0,0,0,0,0
108182,0,0,0,0,0
50241,0,0,0,0,0
95651,0,0,0,0,0
93447,0,0,0,0,0
43736,0,0,0,0,0
66363,0,0,0,0,0
84142,0,0,0,0,0
37115,0,0,0,0,0
34607,0,0,0,0,0
55250,0,0,0,0,0
43721,0,0,0,0,0
110315,0,0,0,0,0
110059,0,0,0,0,0
53408,0,0,0,0,0
9311,0,0,0,0,0
4074,0,0,0,0,0
503,0,0,0,0,0
81854,0,0,0,0,0
105785,0,0,0,0,0
50530,0,0,0,0,0
33923,0,0,0,0,0
15682,0,0,0,0,0
101947,0,0,0,0,0
27806,0,0,0,0,0
6008,0,0,0,0,0
69472,0,0,0,0,0
21333,0,0,0,0,0
42378,0,0,0,0,0
20038,1,1,1,0,0
96825,2,2,2,0,0
19475,0,0,0,0,0
66730,0,0,0,0,0
54,0,0,0,0,0
49456,0,0,0,0,0
20552,0,0,0,0,0
73401,0,0,0,0,0
52818,0,0,0,0,0
113364,0,0,0,0,0
113510,0,0,0,0,0
40633,0,0,0,0,0
69618,0,0,0,0,0
111157,0,0,0,0,0
8342,0,0,0,0,0
52368,0,0,0,0,0
38733,0,0,0,0,0
84238,0,0,0,0,0
22733,0,0,0,0,0
103084,0,0,0,0,0
31284,0,0,0,0,0
107640,0,0,0,0,0
45481,0,0,0,0,0
81644,0,0,0,0,0
63334,0,0,0,0,0
70101,0,0,0,0,0
36593,0,0,0,0,0
20645,0,0,0,0,0
62380,0,0,0,0,0
96735,0,0,0,0,0
72535,0,0,0,0,0
95547,0,0,0,0,0
51307,0,0,0,0,0
67285,0,0,0,0,0
113824,0,0,0,0,0
82711,0,0,0,0,0
109368,0,0,0,0,0
14687,0,0,0,0,0
51210,0,0,0,0,0
15104,0,0,0,0,0
30507,0,0,0,0,0
61228,0,0,0,0,0
101270,0,0,0,0,0
65517,0,0,0,0,0
96239,0,0,0,0,0
96413,3,3,3,0,0
31275,0,0,0,0,0
36331,0,0,0,0,0
107008,0,0,0,0,0
48686,0,0,0,0,0
23290,0,0,0,0,0
109380,0,0,0,0,0
26136,0,0,0,0,0
79561,0,0,0,0,0
74466,0,0,0,0,0
72732,0,0,0,0,0
44743,0,0,0,0,0
22412,0,0,0,0,0
75821,0,0,0,0,0
48824,0,0,0,0,0
57048,0,0,0,0,0
88551,0,0,0,0,0
51193,0,0,0,0,0
95350,0,0,0,0,0
43461,0,0,0,0,0
20956,0,0,0,0,0
85576,0,0,0,0,0
15156,0,0,0,0,0
76235,0,0,0,0,0
79843,0,0,0,0,0
79569,0,0,0,0,0
80118,0,0,0,0,0
27565,0,0,0,0,0
116275,0,0,0,0,0
94263,0,0,0,0,0
70561,0,0,0,0,0
112994,0,0,0,0,0
55755,0,0,0,0,0
104082,0,0,0,0,0
102692,0,0,0,0,0
4274,0,0,0,0,0
7309,0,0,0,0,0
14391,0,0,0,0,0
13744,0,0,0,0,0
80490,0,0,0,0,0
76796,0,0,0,0,0
44953,0,0,0,0,0
102596,0,0,0,0,0
77162,0,0,0,0,0
66905,0,0,0,0,0
67202,0,0,0,0,0
81829,0,0,0,0,0
14978,0,0,0,0,0
34987,0,0,0,0,0
62372,0,0,0,0,0
29516,0,0,0,0,0
102670,0,0,0,0,0
36953,0,0,0,0,0
39860,0,0,0,0,0
95207,0,0,0,0,0
95291,0,0,0,0,0
65365,0,0,0,0,0
114004,0,0,0,0,0
6284,0,0,0,0,0
578,0,0,0,0,0
72196,0,0,0,0,0
39429,0,0,0,0,0
9482,0,0,0,0,0
10010,0,0,0,0,0
89741,0,0,0,0,0
103207,0,0,0,0,0
103551,0,0,0,0,0
45086,0,0,0,0,0
87627,0,0,0,0,0
97466,0,0,0,0,0
91859,0,0,0,0,0
111772,0,0,0,0,0
96222,0,0,0,0,0
40383,0,0,0,0,0
5358,1,1,1,0,0
43237,0,0,0,0,0
62510,0,0,0,0,0
42885,0,0,0,0,0
55329,0,0,0,0,0
89664,0,0,0,0,0
86524,0,0,0,0,0
5036,0,0,0,0,0
54520,0,0,0,0,0
65218,0,0,0,0,0
93762,0,0,0,0,0
93623,0,0,0,0,0
86018,0,0,0,0,0
65030,0,0,0,0,0
116172,0,0,0,0,0
48532,0,0,0,0,0
59295,0,0,0,0,0
3394,0,0,0,0,0
109843,0,0,0,0,0
77730,0,0,0,0,0
46845,0,0,0,0,0
108270,0,0,0,0,0
105638,0,0,0,0,0
67867,0,0,0,0,0
92425,0,0,0,0,0
72037,0,0,0,0,0
19971,0,0,0,0,0
12258,0,0,0,0,0
107321,0,0,0,0,0
7606,0,0,0,0,0
46638,0,0,0,0,0
100406,0,0,0,0,0
65385,0,0,0,0,0
14335,0,0,0,0,0
29202,0,0,0,0,0
20221,0,0,0,0,0
90515,0,0,0,0,0
21422,0,0,0,0,0
73591,0,0,0,0,0
104184,0,0,0,0,0
101826,0,0,0,0,0
110880,0,0,0,0,0
57867,0,0,0,0,0
85763,0,0,0,0,0
100036,0,0,0,0,0
9000,0,0,0,0,0
116612,0,0,0,0,0
85612,0,0,0,0,0
37532,0,0,0,0,0
98163,0,0,0,0,0
19953,0,0,0,0,0
79516,0,0,0,0,0
108671,0,0,0,0,0
101932,0,0,0,0,0
117494,0,0,0,0,0
70985,0,0,0,0,0
31187,0,0,0,0,0
85930,0,0,0,0,0
62010,0,0,0,0,0
61215,0,0,0,0,0
77430,0,0,0,0,0
55614,0,0,0,0,0
39885,0,0,0,0,0
54653,0,0,0,0,0
38485,0,0,0,0,0
115296,0,0,0,0,0
86900,0,0,0,0,0
1650,0,0,0,0,0
114689,0,0,0,0,0
59239,0,0,0,0,0
87062,0,0,0,0,0
23463,0,0,0,0,0
32664,0,0,0,0,0
85744,0,0,0,0,0
42662,0,0,0,0,0
82046,0,0,0,0,0
52865,0,0,0,0,0
74828,0,0,0,0,0
68184,0,0,0,0,0
83920,0,0,0,0,0
20677,0,0,0,0,0
55189,0,0,0,0,0
11665,0,0,0,0,0
89633,0,0,0,0,0
13616,0,0,0,0,0
36299,0,0,0,0,0
46393,0,0,0,0,0
86210,0,0,0,0,0
69399,0,0,0,0,0
76060,0,0,0,0,0
75818,0,0,0,0,0
67491,0,0,0,0,0
16765,0,0,0,0,0
105690,0,0,0,0,0
82318,0,0,0,0,0
120144,0,0,0,0,0
68676,0,0,0,0,0
97446,0,0,0,0,0
93547,0,0,0,0,0
16428,0,0,0,0,0
117455,0,0,0,0,0
114929,0,0,0,0,0
57671,0,0,0,0,0
85808,0,0,0,0,0
16178,0,0,0,0,0
18844,0,0,0,0,0
3965,0,0,0,0,0
3145,0,0,0,0,0
72634,0,0,0,0,0
75273,0,0,0,0,0
89406,0,0,0,0,0
71635,0,0,0,0,0
116945,0,0,0,0,0
76665,0,0,0,0,0
30896,0,0,0,0,0
43529,0,0,0,0,0
65917,0,0,0,0,0
55364,0,0,0,0,0
64422,0,0,0,0,0
46821,0,0,0,0,0
117940,0,0,0,0,0
86743,0,0,0,0,0
57485,0,0,0,0,0
72630,0,0,0,0,0
38758,0,0,0,0,0
112510,0,0,0,0,0
95686,0,0,0,0,0
91157,0,0,0,0,0
59021,0,0,0,0,0
81629,0,0,0,0,0
102451,0,0,0,0,0
14776,0,0,0,0,0
32665,0,0,0,0,0
47322,0,0,0,0,0
19617,0,0,0,0,0
42042,0,0,0,0,0
54359,0,0,0,0,0
32035,0,0,0,0,0
60553,0,0,0,0,0
94359,0,0,0,0,0
78548,0,0,0,0,0
3548,0,0,0,0,0
50521,0,0,0,0,0
10296,0,0,0,0,0
96849,0,0,0,0,0
15383,0,0,0,0,0
2961,0,0,0,0,0
66208,0,0,0,0,0
51815,0,0,0,0,0
39002,0,0,0,0,0
105645,0,0,0,0,0
119140,0,0,0,0,0
76623,0,0,0,0,0
92453,0,0,0,0,0
79168,0,0,0,0,0
46153,0,0,0,0,0
104641,0,0,0,0,0
114955,0,0,0,0,0
60075,0,0,0,0,0
60291,0,0,0,0,0
74795,0,0,0,0,0
28490,0,0,0,0,0
90766,0,0,0,0,0
98341,0,0,0,0,0
94498,0,0,0,0,0
704,0,0,0,0,0
67670,0,0,0,0,0
53411,0,0,0,0,0
78736,0,0,0,0,0
40855,0,0,0,0,0
30217,0,0,0,0,0
100661,0,0,0,0,0
40579,0,0,0,0,0
49376,0,0,0,0,0
76899,0,0,0,0,0
16727,0,0,0,0,0
46093,0,0,0,0,0
32326,0,0,0,0,0
57652,0,0,0,0,0
34089,0,0,0,0,0
98360,0,0,0,0,0
83975,0,0,0,0,0
20017,0,0,0,0,0
62294,0,0,0,0,0
15911,0,0,0,0,0
89687,0,0,0,0,0
48567,0,0,0,0,0
24902,0,0,0,0,0
66346,0,0,0,0,0
26923,0,0,0,0,0
96296,0,0,0,0,0
70868,0,0,0,0,0
46656,0,0,0,0,0
97834,0,0,0,0,0
45976,0,0,0,0,0
83290,0,0,0,0,0
45830,0,0,0,0,0
41325,0,0,0,0,0
113681,0,0,0,0,0
96218,0,0,0,0,0
76370,0,0,0,0,0
3174,0,0,0,0,0
40915,0,0,0,0,0
115423,0,0,0,0,0
101082,0,0,0,0,0
56338,0,0,0,0,0
53100,0,0,0,0,0
59249,0,0,0,0,0
116177,0,0,0,0,0
80556,0,0,0,0,0
40173,0,0,0,0,0
93991,0,0,0,0,0
56879,0,0,0,0,0
84596,0,0,0,0,0
95840,0,0,0,0,0
118841,0,0,0,0,0
60531,0,0,0,0,0
111566,0,0,0,0,0
45456,0,0,0,0,0
64513,0,0,0,0,0
85140,0,0,0,0,0
14146,0,0,0,0,0
107669,0,0,0,0,0
103368,0,0,0,0,0
43043,0,0,0,0,0
62673,0,0,0,0,0
12497,0,0,0,0,0
55604,0,0,0,0,0
34011,0,0,0,0,0
98527,0,0,0,0,0
17097,0,0,0,0,0
90908,0,0,0,0,0
4840,0,0,0,0,0
53976,0,0,0,0,0
12500,0,0,0,0,0
58209,0,0,0,0,0
53245,0,0,0,0,0
107850,0,0,0,0,0
66120,0,0,0,0,0
82065,0,0,0,0,0
104517,0,0,0,0,0
95943,0,0,0,0,0
71546,0,0,0,0,0
41936,0,0,0,0,0
17178,0,0,0,0,0
49901,0,0,0,0,0
86886,0,0,0,0,0
76671,0,0,0,0,0
18373,0,0,0,0,0
24473,0,0,0,0,0
77239,0,0,0,0,0
97356,0,0,0,0,0
119436,0,0,0,0,0
52103,0,0,0,0,0
105880,0,0,0,0,0
18180,0,0,0,0,0
72739,0,0,0,0,0
1378,0,0,0,0,0
85234,0,0,0,0,0
67690,1,1,1,0,0
101636,0,0,0,0,0
26573,0,0,0,0,0
88735,0,0,0,0,0
111286,0,0,0,0,0
108294,0,0,0,0,0
116493,0,0,0,0,0
21111,0,0,0,0,0
45673,0,0,0,0,0
26905,0,0,0,0,0
76698,0,0,0,0,0
76399,0,0,0,0,0
22570,0,0,0,0,0
61739,0,0,0,0,0
68443,0,0,0,0,0
110895,0,0,0,0,0
20203,0,0,0,0,0
15887,0,0,0,0,0
47738,0,0,0,0,0
106208,0,0,0,0,0
31660,0,0,0,0,0
80937,0,0,0,0,0
88711,0,0,0,0,0
97575,0,0,0,0,0
111426,0,0,0,0,0
90211,0,0,0,0,0
80534,0,0,0,0,0
78929,0,0,0,0,0
25093,0,0,0,0,0
84331,0,0,0,0,0
82725,0,0,0,0,0
99338,0,0,0,0,0
105,1,1,1,0,0
50071,0,0,0,0,0
83074,0,0,0,0,0
80799,0,0,0,0,0
58599,0,0,0,0,0
32788,0,0,0,0,0
19238,0,0,0,0,0
114946,0,0,0,0,0
15738,0,0,0,0,0
115584,0,0,0,0,0
46241,0,0,0,0,0
6590,0,0,0,0,0
49367,0,0,0,0,0
105468,0,0,0,0,0
97715,0,0,0,0,0
83969,0,0,0,0,0
72027,0,0,0,0,0
65527,0,0,0,0,0
67316,0,0,0,0,0
68773,0,0,0,0,0
50523,0,0,0,0,0
57438,0,0,0,0,0
40048,0,0,0,0,0
15415,0,0,0,0,0
70213,0,0,0,0,0
63554,0,0,0,0,0
66356,0,0,0,0,0
16504,0,0,0,0,0
87248,0,0,0,0,0
10580,0,0,0,0,0
4779,0,0,0,0,0
104450,0,0,0,0,0
65123,0,0,0,0,0
68374,0,0,0,0,0
111871,0,0,0,0,0
42916,0,0,0,0,0
97906,0,0,0,0,0
39437,0,0,0,0,0
51271,0,0,0,0,0
77462,0,0,0,0,0
26444,0,0,0,0,0
7399,0,0,0,0,0
5386,0,0,0,0,0
7030,0,0,0,0,0
62273,0,0,0,0,0
118971,0,0,0,0,0
92315,0,0,0,0,0
76543,0,0,0,0,0
74115,0,0,0,0,0
103815,0,0,0,0,0
36743,0,0,0,0,0
7169,0,0,0,0,0
16079,0,0,0,0,0
5131,0,0,0,0,0
108963,0,0,0,0,0
74854,0,0,0,0,0
23720,0,0,0,0,0
50375,0,0,0,0,0
3972,0,0,0,0,0
57211,0,0,0,0,0
66669,0,0,0,0,0
47028,0,0,0,0,0
95479,0,0,0,0,0
81623,0,0,0,0,0
45788,0,0,0,0,0
49759,0,0,0,0,0
100496,0,0,0,0,0
67317,0,0,0,0,0
81073,0,0,0,0,0
43514,0,0,0,0,0
28724,0,0,0,0,0
55183,0,0,0,0,0
19906,0,0,0,0,0
91706,0,0,0,0,0
11661,0,0,0,0,0
39980,0,0,0,0,0
105908,0,0,0,0,0
31101,0,0,0,0,0
85796,0,0,0,0,0
77024,0,0,0,0,0
34069,0,0,0,0,0
40957,0,0,0,0,0
103120,0,0,0,0,0
16934,0,0,0,0,0
45816,0,0,0,0,0
777,0,0,0,0,0
52578,0,0,0,0,0
52057,0,0,0,0,0
64710,0,0,0,0,0
10053,0,0,0,0,0
115562,0,0,0,0,0
96878,0,0,0,0,0
88811,0,0,0,0,0
26031,0,0,0,0,0
71900,0,0,0,0,0
8507,0,0,0,0,0
85760,0,0,0,0,0
27975,0,0,0,0,0
57042,0,0,0,0,0
119292,0,0,0,0,0
88904,0,0,0,0,0
78948,0,0,0,0,0
117412,0,0,0,0,0
57009,0,0,0,0,0
35851,0,0,0,0,0
42912,0,0,0,0,0
93788,0,0,0,0,0
105087,0,0,0,0,0
93305,0,0,0,0,0
15604,0,0,0,0,0
103455,0,0,0,0,0
52040,0,0,0,0,0
58377,0,0,0,0,0
77209,0,0,0,0,0
88922,0,0,0,0,0
80274,0,0,0,0,0
71897,0,0,0,0,0
53577,0,0,0,0,0
17827,0,0,0,0,0
86892,0,0,0,0,0
59484,0,0,0,0,0
26132,0,0,0,0,0
55876,0,0,0,0,0
50081,0,0,0,0,0
3232,0,0,0,0,0
120103,2,2,2,0,0
16792,0,0,0,0,0
47058,0,0,0,0,0
116535,0,0,0,0,0
99297,0,0,0,0,0
109457,0,0,0,0,0
66398,0,0,0,0,0
26439,0,0,0,0,0
117513,1,1,1,0,0
77984,0,0,0,0,0
1388,0,0,0,0,0
77408,0,0,0,0,0
52733,0,0,0,0,0
85551,0,0,0,0,0
11626,0,0,0,0,0
94822,0,0,0,0,0
83503,0,0,0,0,0
111392,0,0,0,0,0
88751,0,0,0,0,0
115310,0,0,0,0,0
100194,0,0,0,0,0
2917,0,0,0,0,0
25876,0,0,0,0,0
95056,0,0,0,0,0
25788,0,0,0,0,0
88191,0,0,0,0,0
15474,0,0,0,0,0
115064,0,0,0,0,0
16461,0,0,0,0,0
116773,0,0,0,0,0
111993,0,0,0,0,0
42327,0,0,0,0,0
111525,0,0,0,0,0
23825,0,0,0,0,0
113575,0,0,0,0,0
54852,0,0,0,0,0
14995,0,0,0,0,0
51624,0,0,0,0,0
55720,0,0,0,0,0
117179,0,0,0,0,0
78884,0,0,0,0,0
45319,0,0,0,0,0
76930,0,0,0,0,0
7274,0,0,0,0,0
1700,0,0,0,0,0
77059,0,0,0,0,0
18422,0,0,0,0,0
33104,0,0,0,0,0
71928,0,0,0,0,0
49967,0,0,0,0,0
114365,0,0,0,0,0
54961,0,0,0,0,0
9732,0,0,0,0,0
74896,0,0,0,0,0
96655,0,0,0,0,0
11431,0,0,0,0,0
46312,0,0,0,0,0
7827,0,0,0,0,0
44227,0,0,0,0,0
7584,0,0,0,0,0
62949,0,0,0,0,0
217,0,0,0,0,0
65108,0,0,0,0,0
79941,0,0,0,0,0
38619,0,0,0,0,0
43528,0,0,0,0,0
77111,0,0,0,0,0
109650,0,0,0,0,0
51857,0,0,0,0,0
43354,0,0,0,0,0
81808,0,0,0,0,0
90651,0,0,0,0,0
38666,0,0,0,0,0
20982,0,0,0,0,0
32016,0,0,0,0,0
106497,0,0,0,0,0
21701,0,0,0,0,0
12542,0,0,0,0,0
113551,0,0,0,0,0
79616,0,0,0,0,0
116308,0,0,0,0,0
54210,0,0,0,0,0
56169,0,0,0,0,0
68185,0,0,0,0,0
19413,0,0,0,0,0
25471,0,0,0,0,0
85309,0,0,0,0,0
88772,0,0,0,0,0
102381,0,0,0,0,0
69392,0,0,0,0,0
88021,0,0,0,0,0
57890,0,0,0,0,0
35665,0,0,0,0,0
63528,0,0,0,0,0
82777,0,0,0,0,0
80976,0,0,0,0,0
93167,0,0,0,0,0
15701,0,0,0,0,0
118148,0,0,0,0,0
117561,0,0,0,0,0
48380,0,0,0,0,0
106872,0,0,0,0,0
69479,0,0,0,0,0
35338,0,0,0,0,0
115235,0,0,0,0,0
28279,0,0,0,0,0
49628,0,0,0,0,0
50953,0,0,0,0,0
108233,1,1,1,0,0
26292,0,0,0,0,0
19779,0,0,0,0,0
44800,0,0,0,0,0
49050,0,0,0,0,0
82797,0,0,0,0,0
47505,0,0,0,0,0
87060,0,0,0,0,0
120031,0,0,0,0,0
105239,0,0,0,0,0
39763,0,0,0,0,0
6580,0,0,0,0,0
1198,0,0,0,0,0
93624,0,0,0,0,0
65009,0,0,0,0,0
88276,0,0,0,0,0
40365,0,0,0,0,0
82840,0,0,0,0,0
52350,0,0,0,0,0
30465,0,0,0,0,0
94972,3,3,3,0,0
53672,0,0,0,0,0
13160,0,0,0,0,0
106678,0,0,0,0,0
94695,0,0,0,0,0
56135,0,0,0,0,0
99320,0,0,0,0,0
1552,0,0,0,0,0
47591,0,0,0,0,0
87105,0,0,0,0,0
86499,0,0,0,0,0
102179,0,0,0,0,0
82928,0,0,0,0,0
79901,0,0,0,0,0
52907,0,0,0,0,0
23733,0,0,0,0,0
22989,0,0,0,0,0
58129,0,0,0,0,0
27836,0,0,0,0,0
95805,0,0,0,0,0
112385,0,0,0,0,0
103106,0,0,0,0,0
76247,0,0,0,0,0
69437,0,0,0,0,0
77165,0,0,0,0,0
62009,0,0,0,0,0
18940,0,0,0,0,0
19935,0,0,0,0,0
90007,0,0,0,0,0
60428,0,0,0,0,0
2272,0,0,0,0,0
96784,0,0,0,0,0
40429,0,0,0,0,0
103422,0,0,0,0,0
70428,0,0,0,0,0
92835,0,0,0,0,0
8909,0,0,0,0,0
106007,0,0,0,0,0
85987,0,0,0,0,0
119067,0,0,0,0,0
94883,0,0,0,0,0
8647,0,0,0,0,0
87313,0,0,0,0,0
78865,1,1,1,0,0
112814,0,0,0,0,0
34145,0,0,0,0,0
87940,0,0,0,0,0
100471,0,0,0,0,0
54716,0,0,0,0,0
78819,0,0,0,0,0
9700,0,0,0,0,0
48234,0,0,0,0,0
82539,0,0,0,0,0
12362,0,0,0,0,0
93263,0,0,0,0,0
49622,0,0,0,0,0
25132,0,0,0,0,0
58278,0,0,0,0,0
8924,0,0,0,0,0
57110,0,0,0,0,0
40668,0,0,0,0,0
91646,0,0,0,0,0
50485,0,0,0,0,0
72622,0,0,0,0,0
17205,0,0,0,0,0
112350,0,0,0,0,0
119818,0,0,0,0,0
16474,0,0,0,0,0
94170,0,0,0,0,0
42869,0,0,0,0,0
59597,0,0,0,0,0
16202,0,0,0,0,0
81432,0,0,0,0,0
33261,0,0,0,0,0
110580,0,0,0,0,0
70688,0,0,0,0,0
90789,0,0,0,0,0
53587,0,0,0,0,0
108308,0,0,0,0,0
117755,0,0,0,0,0
64965,0,0,0,0,0
111615,0,0,0,0,0
528,0,0,0,0,0
78014,0,0,0,0,0
58364,0,0,0,0,0
21817,0,0,0,0,0
106931,0,0,0,0,0
119616,0,0,0,0,0
48462,0,0,0,0,0
27908,0,0,0,0,0
115633,0,0,0,0,0
30568,0,0,0,0,0
29328,0,0,0,0,0
29784,0,0,0,0,0
114122,0,0,0,0,0
115305,0,0,0,0,0
68205,0,0,0,0,0
85950,0,0,0,0,0
53652,0,0,0,0,0
93551,0,0,0,0,0
77573,0,0,0,0,0
60759,0,0,0,0,0
28173,0,0,0,0,0
85649,0,0,0,0,0
16377,0,0,0,0,0
89841,0,0,0,0,0
71489,0,0,0,0,0
35150,0,0,0,0,0
99635,1,1,1,0,0
94188,0,0,0,0,0
13412,0,0,0,0,0
55580,0,0,0,0,0
88329,0,0,0,0,0
2142,0,0,0,0,0
94245,0,0,0,0,0
85989,0,0,0,0,0
49910,0,0,0,0,0
86240,0,0,0,0,0
71081,0,0,0,0,0
82974,0,0,0,0,0
118156,0,0,0,0,0
35144,0,0,0,0,0
15734,0,0,0,0,0
66179,0,0,0,0,0
23587,0,0,0,0,0
9506,0,0,0,0,0
114514,0,0,0,0,0
72301,0,0,0,0,0
108674,0,0,0,0,0
70685,0,0,0,0,0
26659,0,0,0,0,0
28230,0,0,0,0,0
87671,0,0,0,0,0
14661,0,0,0,0,0
35029,0,0,0,0,0
51658,0,0,0,0,0
98518,0,0,0,0,0
6694,0,0,0,0,0
53600,0,0,0,0,0
98880,0,0,0,0,0
33844,0,0,0,0,0
27936,0,0,0,0,0
63676,0,0,0,0,0
3503,0,0,0,0,0
76499,0,0,0,0,0
32208,0,0,0,0,0
13977,0,0,0,0,0
32183,0,0,0,0,0
82683,0,0,0,0,0
8207,0,0,0,0,0
15275,0,0,0,0,0
45656,0,0,0,0,0
97256,0,0,0,0,0
70151,0,0,0,0,0
69621,0,0,0,0,0
56491,0,0,0,0,0
109442,0,0,0,0,0
37072,0,0,0,0,0
107341,0,0,0,0,0
111635,0,0,0,0,0
114907,0,0,0,0,0
19572,0,0,0,0,0
8302,0,0,0,0,0
28128,0,0,0,0,0
47104,0,0,0,0,0
46671,0,0,0,0,0
30981,0,0,0,0,0
118529,0,0,0,0,0
43616,0,0,0,0,0
71753,0,0,0,0,0
103775,0,0,0,0,0
20345,0,0,0,0,0
10255,1,1,1,0,0
98052,0,0,0,0,0
113911,0,0,0,0,0
65850,0,0,0,0,0
38346,0,0,0,0,0
107856,0,0,0,0,0
99289,0,0,0,0,0
95414,0,0,0,0,0
42932,0,0,0,0,0
6870,0,0,0,0,0
43322,0,0,0,0,0
90364,0,0,0,0,0
111809,0,0,0,0,0
88278,0,0,0,0,0
32715,0,0,0,0,0
17697,0,0,0,0,0
668,0,0,0,0,0
83214,0,0,0,0,0
15507,0,0,0,0,0
64868,0,0,0,0,0
1732,0,0,0,0,0
102943,0,0,0,0,0
91819,0,0,0,0,0
38358,0,0,0,0,0
85972,0,0,0,0,0
58880,0,0,0,0,0
48660,0,0,0,0,0
76618,0,0,0,0,0
102813,0,0,0,0,0
119605,0,0,0,0,0
112356,0,0,0,0,0
94026,0,0,0,0,0
90250,0,0,0,0,0
65238,0,0,0,0,0
258,0,0,0,0,0
91236,0,0,0,0,0
79694,0,0,0,0,0
70705,0,0,0,0,0
105977,0,0,0,0,0
117066,0,0,0,0,0
36514,0,0,0,0,0
119233,0,0,0,0,0
83391,0,0,0,0,0
56193,0,0,0,0,0
108588,0,0,0,0,0
1359,0,0,0,0,0
23581,0,0,0,0,0
117470,0,0,0,0,0
100123,0,0,0,0,0
26700,0,0,0,0,0
51661,0,0,0,0,0
44615,0,0,0,0,0
90199,0,0,0,0,0
1202,0,0,0,0,0
91141,0,0,0,0,0
57717,0,0,0,0,0
119149,0,0,0,0,0
105410,0,0,0,0,0
20948,0,0,0,0,0
99472,0,0,0,0,0
104381,0,0,0,0,0
48285,0,0,0,0,0
59067,0,0,0,0,0
8425,0,0,0,0,0
96656,0,0,0,0,0
95339,0,0,0,0,0
106128,0,0,0,0,0
31659,0,0,0,0,0
51680,0,0,0,0,0
9009,0,0,0,0,0
33878,0,0,0,0,0
101521,0,0,0,0,0
76275,0,0,0,0,0
38803,0,0,0,0,0
102436,0,0,0,0,0
23922,0,0,0,0,0
67811,0,0,0,0,0
9411,0,0,0,0,0
108611,0,0,0,0,0
16453,0,0,0,0,0
99675,0,0,0,0,0
117292,0,0,0,0,0
1793,0,0,0,0,0
92246,0,0,0,0,0
36155,0,0,0,0,0
27569,0,0,0,0,0
37345,0,0,0,0,0
58915,0,0,0,0,0
92142,0,0,0,0,0
8556,0,0,0,0,0
90968,0,0,0,0,0
114369,0,0,0,0,0
89306,0,0,0,0,0
80885,0,0,0,0,0
47745,0,0,0,0,0
46661,0,0,0,0,0
68496,0,0,0,0,0
14773,0,0,0,0,0
81828,0,0,0,0,0
108803,0,0,0,0,0
32568,0,0,0,0,0
97987,0,0,0,0,0
32789,0,0,0,0,0
84082,0,0,0,0,0
120428,0,0,0,0,0
28205,0,0,0,0,0
52816,0,0,0,0,0
15605,0,0,0,0,0
57465,0,0,0,0,0
85151,0,0,0,0,0
80509,0,0,0,0,0
113473,0,0,0,0,0
114470,0,0,0,0,0
81256,0,0,0,0,0
61931,0,0,0,0,0
43498,0,0,0,0,0
99043,0,0,0,0,0
62978,0,0,0,0,0
26574,0,0,0,0,0
11236,0,0,0,0,0
51036,0,0,0,0,0
112214,0,0,0,0,0
1326,0,0,0,0,0
113249,0,0,0,0,0
62869,0,0,0,0,0
86214,0,0,0,0,0
82213,0,0,0,0,0
116132,0,0,0,0,0
87609,0,0,0,0,0
19720,0,0,0,0,0
63231,0,0,0,0,0
40687,0,0,0,0,0
56489,0,0,0,0,0
104604,0,0,0,0,0
5039,0,0,0,0,0
47735,0,0,0,0,0
53463,2,2,2,0,0
43707,0,0,0,0,0
53893,0,0,0,0,0
36390,0,0,0,0,0
24678,0,0,0,0,0
107695,0,0,0,0,0
56834,0,0,0,0,0
69771,0,0,0,0,0
7405,0,0,0,0,0
101902,0,0,0,0,0
44768,0,0,0,0,0
40684,0,0,0,0,0
29428,0,0,0,0,0
71612,0,0,0,0,0
68264,0,0,0,0,0
13834,0,0,0,0,0
40835,0,0,0,0,0
91258,0,0,0,0,0
59198,0,0,0,0,0
18965,0,0,0,0,0
72871,0,0,0,0,0
27914,0,0,0,0,0
57186,0,0,0,0,0
20279,0,0,0,0,0
59637,0,0,0,0,0
39009,0,0,0,0,0
16069,0,0,0,0,0
5413,0,0,0,0,0
78761,0,0,0,0,0
89636,0,0,0,0,0
83670,0,0,0,0,0
87998,0,0,0,0,0
37806,0,0,0,0,0
15893,0,0,0,0,0
119995,0,0,0,0,0
58061,0,0,0,0,0
85305,0,0,0,0,0
63412,0,0,0,0,0
34908,0,0,0,0,0
68236,0,0,0,0,0
68768,0,0,0,0,0
3547,0,0,0,0,0
61419,0,0,0,0,0
114678,0,0,0,0,0
68922,0,0,0,0,0
34652,1,1,1,0,0
13818,0,0,0,0,0
62327,0,0,0,0,0
102730,0,0,0,0,0
41053,0,0,0,0,0
66505,0,0,0,0,0
42669,0,0,0,0,0
115056,0,0,0,0,0
63188,0,0,0,0,0
89428,0,0,0,0,0
110182,0,0,0,0,0
26298,0,0,0,0,0
30943,0,0,0,0,0
72516,0,0,0,0,0
6715,0,0,0,0,0
81585,0,0,0,0,0
16296,0,0,0,0,0
64242,0,0,0,0,0
43222,0,0,0,0,0
92874,0,0,0,0,0
11143,0,0,0,0,0
2452,0,0,0,0,0
112892,0,0,0,0,0
40378,0,0,0,0,0
14587,0,0,0,0,0
2552,0,0,0,0,0
19849,0,0,0,0,0
3105,0,0,0,0,0
116352,0,0,0,0,0
75452,0,0,0,0,0
58866,0,0,0,0,0
96065,0,0,0,0,0
28767,0,0,0,0,0
98635,0,0,0,0,0
47870,0,0,0,0,0
95375,0,0,0,0,0
61502,0,0,0,0,0
26134,0,0,0,0,0
34197,0,0,0,0,0
30912,0,0,0,0,0
64393,0,0,0,0,0
57681,0,0,0,0,0
48467,0,0,0,0,0
68715,0,0,0,0,0
18163,0,0,0,0,0
22595,0,0,0,0,0
24930,0,0,0,0,0
49975,0,0,0,0,0
15525,0,0,0,0,0
114025,0,0,0,0,0
60841,0,0,0,0,0
114320,0,0,0,0,0
17985,0,0,0,0,0
21976,0,0,0,0,0
73009,0,0,0,0,0
48873,0,0,0,0,0
6663,0,0,0,0,0
115366,0,0,0,0,0
39675,0,0,0,0,0
3580,0,0,0,0,0
54370,0,0,0,0,0
23109,0,0,0,0,0
4875,0,0,0,0,0
3048,0,0,0,0,0
110932,0,0,0,0,0
17722,0,0,0,0,0
97212,0,0,0,0,0
71089,0,0,0,0,0
38308,0,0,0,0,0
33488,0,0,0,0,0
103195,0,0,0,0,0
26491,0,0,0,0,0
59428,0,0,0,0,0
87375,0,0,0,0,0
56020,0,0,0,0,0
98177,0,0,0,0,0
97107,0,0,0,0,0
103769,0,0,0,0,0
89894,0,0,0,0,0
113908,0,0,0,0,0
73582,0,0,0,0,0
98297,0,0,0,0,0
31510,0,0,0,0,0
11358,0,0,0,0,0
99874,0,0,0,0,0
106179,0,0,0,0,0
42945,0,0,0,0,0
83764,0,0,0,0,0
17307,0,0,0,0,0
91203,0,0,0,0,0
27424,0,0,0,0,0
53388,0,0,0,0,0
76830,0,0,0,0,0
69761,0,0,0,0,0
19996,0,0,0,0,0
118831,0,0,0,0,0
46341,0,0,0,0,0
89147,0,0,0,0,0
10993,0,0,0,0,0
33172,0,0,0,0,0
11902,0,0,0,0,0
84247,0,0,0,0,0
33999,0,0,0,0,0
79876,0,0,0,0,0
50999,0,0,0,0,0
40538,0,0,0,0,0
113220,0,0,0,0,0
72651,0,0,0,0,0
108434,0,0,0,0,0
79330,0,0,0,0,0
79304,0,0,0,0,0
6209,0,0,0,0,0
49457,0,0,0,0,0
32965,0,0,0,0,0
36528,2,2,2,0,0
97885,0,0,0,0,0
99918,0,0,0,0,0
45557,1,1,1,0,0
7953,0,0,0,0,0
93774,0,0,0,0,0
11694,0,0,0,0,0
76047,0,0,0,0,0
29532,0,0,0,0,0
109573,1,1,1,0,0
54111,0,0,0,0,0
21741,0,0,0,0,0
95540,0,0,0,0,0
101118,0,0,0,0,0
74172,0,0,0,0,0
26927,0,0,0,0,0
63325,0,0,0,0,0
22526,0,0,0,0,0
109853,0,0,0,0,0
29503,0,0,0,0,0
55210,0,0,0,0,0
112620,0,0,0,0,0
54990,0,0,0,0,0
119744,0,0,0,0,0
58155,0,0,0,0,0
84114,0,0,0,0,0
16750,0,0,0,0,0
119327,0,0,0,0,0
57754,0,0,0,0,0
62058,0,0,0,0,0
58328,0,0,0,0,0
37898,0,0,0,0,0
14049,0,0,0,0,0
64151,0,0,0,0,0
68536,0,0,0,0,0
67863,0,0,0,0,0
83745,0,0,0,0,0
67916,0,0,0,0,0
21746,0,0,0,0,0
88038,0,0,0,0,0
19597,0,0,0,0,0
87232,0,0,0,0,0
95553,0,0,0,0,0
111841,0,0,0,0,0
39682,0,0,0,0,0
6297,0,0,0,0,0
14125,0,0,0,0,0
50974,0,0,0,0,0
119076,0,0,0,0,0
29257,0,0,0,0,0
802,0,0,0,0,0
7454,0,0,0,0,0
102731,0,0,0,0,0
81938,0,0,0,0,0
12102,0,0,0,0,0
61968,0,0,0,0,0
50202,0,0,0,0,0
88307,0,0,0,0,0
120239,0,0,0,0,0
100656,0,0,0,0,0
115740,0,0,0,0,0
321,1,1,1,0,0
38732,0,0,0,0,0
91729,0,0,0,0,0
116566,0,0,0,0,0
23708,0,0,0,0,0
54034,0,0,0,0,0
45819,0,0,0,0,0
5163,0,0,0,0,0
89961,0,0,0,0,0
64447,0,0,0,0,0
49280,0,0,0,0,0
39112,0,0,0,0,0
75440,0,0,0,0,0
7654,0,0,0,0,0
81704,0,0,0,0,0
16208,0,0,0,0,0
19387,0,0,0,0,0
49082,0,0,0,0,0
31418,0,0,0,0,0
55983,0,0,0,0,0
116127,0,0,0,0,0
1410,0,0,0,0,0
63080,0,0,0,0,0
79104,0,0,0,0,0
92079,0,0,0,0,0
68574,0,0,0,0,0
24626,0,0,0,0,0
81458,0,0,0,0,0
110234,0,0,0,0,0
25445,0,0,0,0,0
59592,0,0,0,0,0
51447,0,0,0,0,0
99732,0,0,0,0,0
39379,0,0,0,0,0
93219,0,0,0,0,0
69982,0,0,0,0,0
23063,0,0,0,0,0
56198,0,0,0,0,0
57564,0,0,0,0,0
117189,0,0,0,0,0
14676,0,0,0,0,0
79638,0,0,0,0,0
5053,0,0,0,0,0
40276,0,0,0,0,0
74394,0,0,0,0,0
96496,0,0,0,0,0
83320,0,0,0,0,0
16608,0,0,0,0,0
113736,0,0,0,0,0
52590,0,0,0,0,0
652,0,0,0,0,0
44220,0,0,0,0,0
94374,0,0,0,0,0
84148,0,0,0,0,0
83771,0,0,0,0,0
5126,0,0,0,0,0
114487,0,0,0,0,0
104973,1,1,1,0,0
7026,0,0,0,0,0
83046,0,0,0,0,0
31046,0,0,0,0,0
13362,0,0,0,0,0
93414,0,0,0,0,0
36961,0,0,0,0,0
56200,0,0,0,0,0
75506,0,0,0,0,0
104142,0,0,0,0,0
90984,0,0,0,0,0
22810,0,0,0,0,0
3154,0,0,0,0,0
75539,0,0,0,0,0
101463,0,0,0,0,0
52309,0,0,0,0,0
2365,0,0,0,0,0
70973,0,0,0,0,0
102775,0,0,0,0,0
48201,0,0,0,0,0
97327,0,0,0,0,0
45642,0,0,0,0,0
33512,0,0,0,0,0
41646,0,0,0,0,0
6540,0,0,0,0,0
66971,0,0,0,0,0
62020,0,0,0,0,0
89500,0,0,0,0,0
99852,0,0,0,0,0
103051,0,0,0,0,0
104886,0,0,0,0,0
88461,0,0,0,0,0
75831,0,0,0,0,0
94356,0,0,0,0,0
112386,0,0,0,0,0
80713,0,0,0,0,0
11727,0,0,0,0,0
84372,0,0,0,0,0
70989,0,0,0,0,0
100286,0,0,0,0,0
34234,0,0,0,0,0
52767,0,0,0,0,0
120057,0,0,0,0,0
57207,0,0,0,0,0
62015,0,0,0,0,0
46026,0,0,0,0,0
106447,0,0,0,0,0
55438,0,0,0,0,0
118845,0,0,0,0,0
59263,0,0,0,0,0
95217,0,0,0,0,0
117442,0,0,0,0,0
26122,0,0,0,0,0
86371,0,0,0,0,0
113392,0,0,0,0,0
3986,0,0,0,0,0
84374,0,0,0,0,0
110980,0,0,0,0,0
23753,0,0,0,0,0
63048,0,0,0,0,0
45555,0,0,0,0,0
12632,0,0,0,0,0
56218,0,0,0,0,0
106531,0,0,0,0,0
64297,0,0,0,0,0
43314,0,0,0,0,0
2132,0,0,0,0,0
96756,0,0,0,0,0
42446,0,0,0,0,0
60131,0,0,0,0,0
50225,0,0,0,0,0
61101,0,0,0,0,0
35906,0,0,0,0,0
70353,0,0,0,0,0
49539,0,0,0,0,0
112249,0,0,0,0,0
34834,0,0,0,0,0
93066,0,0,0,0,0
92191,0,0,0,0,0
64260,0,0,0,0,0
96815,0,0,0,0,0
97100,0,0,0,0,0
89584,0,0,0,0,0
54720,0,0,0,0,0
110420,0,0,0,0,0
84965,0,0,0,0,0
118092,0,0,0,0,0
68760,0,0,0,0,0
69274,0,0,0,0,0
2617,0,0,0,0,0
32395,0,0,0,0,0
60948,0,0,0,0,0
43112,0,0,0,0,0
118155,2,2,2,0,0
49884,0,0,0,0,0
31435,0,0,0,0,0
62845,0,0,0,0,0
105497,0,0,0,0,0
93144,0,0,0,0,0
4307,0,0,0,0,0
40770,0,0,0,0,0
68683,0,0,0,0,0
12906,0,0,0,0,0
56276,0,0,0,0,0
94091,0,0,0,0,0
9772,0,0,0,0,0
100232,0,0,0,0,0
24143,0,0,0,0,0
86477,0,0,0,0,0
8655,0,0,0,0,0
89599,0,0,0,0,0
43706,0,0,0,0,0
18839,0,0,0,0,0
67577,0,0,0,0,0
106315,0,0,0,0,0
5156,0,0,0,0,0
92891,0,0,0,0,0
21031,0,0,0,0,0
108389,0,0,0,0,0
98761,0,0,0,0,0
68557,0,0,0,0,0
12980,0,0,0,0,0
14990,0,0,0,0,0
48200,0,0,0,0,0
1279,8,8,8,0,0
92650,0,0,0,0,0
67104,0,0,0,0,0
44569,0,0,0,0,0
9431,0,0,0,0,0
73907,0,0,0,0,0
101746,0,0,0,0,0
66811,0,0,0,0,0
106849,0,0,0,0,0
119980,0,0,0,0,0
47073,0,0,0,0,0
26454,0,0,0,0,0
2697,0,0,0,0,0
115145,0,0,0,0,0
106550,0,0,0,0,0
15990,0,0,0,0,0
89335,0,0,0,0,0
100162,0,0,0,0,0
91138,0,0,0,0,0
17161,0,0,0,0,0
59374,0,0,0,0,0
4054,0,0,0,0,0
61283,0,0,0,0,0
68094,0,0,0,0,0
115270,0,0,0,0,0
13871,0,0,0,0,0
25607,0,0,0,0,0
23266,0,0,0,0,0
48072,0,0,0,0,0
8866,0,0,0,0,0
18840,0,0,0,0,0
38791,0,0,0,0,0
27207,0,0,0,0,0
20996,0,0,0,0,0
25906,0,0,0,0,0
17593,0,0,0,0,0
101797,0,0,0,0,0
51681,0,0,0,0,0
4688,0,0,0,0,0
15819,0,0,0,0,0
80506,0,0,0,0,0
107408,0,0,0,0,0
28492,0,0,0,0,0
91523,0,0,0,0,0
36873,0,0,0,0,0
114186,0,0,0,0,0
69651,0,0,0,0,0
119922,0,0,0,0,0
89909,0,0,0,0,0
27373,0,0,0,0,0
118178,0,0,0,0,0
32459,0,0,0,0,0
33430,0,0,0,0,0
114407,0,0,0,0,0
39130,0,0,0,0,0
49053,0,0,0,0,0
51021,0,0,0,0,0
12179,0,0,0,0,0
53263,0,0,0,0,0
10036,0,0,0,0,0
36008,0,0,0,0,0
107922,0,0,0,0,0
71118,0,0,0,0,0
97508,0,0,0,0,0
32109,0,0,0,0,0
54162,0,0,0,0,0
78432,0,0,0,0,0
45226,0,0,0,0,0
36003,0,0,0,0,0
2581,0,0,0,0,0
25002,0,0,0,0,0
78994,0,0,0,0,0
86924,0,0,0,0,0
27369,0,0,0,0,0
23151,0,0,0,0,0
99061,0,0,0,0,0
113996,0,0,0,0,0
37695,0,0,0,0,0
16671,0,0,0,0,0
68747,0,0,0,0,0
45766,0,0,0,0,0
74561,0,0,0,0,0
27023,0,0,0,0,0
108122,0,0,0,0,0
28160,0,0,0,0,0
54223,0,0,0,0,0
3530,0,0,0,0,0
26204,0,0,0,0,0
50878,0,0,0,0,0
81452,0,0,0,0,0
31329,0,0,0,0,0
41061,0,0,0,0,0
12595,0,0,0,0,0
93161,0,0,0,0,0
4877,0,0,0,0,0
57683,0,0,0,0,0
91136,0,0,0,0,0
61235,0,0,0,0,0
70573,0,0,0,0,0
72038,0,0,0,0,0
6547,0,0,0,0,0
81044,0,0,0,0,0
23367,0,0,0,0,0
37242,0,0,0,0,0
89608,0,0,0,0,0
37263,0,0,0,0,0
77897,0,0,0,0,0
109302,0,0,0,0,0
629,3,3,3,0,0
60901,0,0,0,0,0
46045,0,0,0,0,0
65185,0,0,0,0,0
45271,0,0,0,0,0
57158,0,0,0,0,0
61,0,0,0,0,0
8763,0,0,0,0,0
100088,0,0,0,0,0
24971,1,1,1,0,0
117970,0,0,0,0,0
111480,0,0,0,0,0
48031,0,0,0,0,0
29357,0,0,0,0,0
21873,0,0,0,0,0
35091,0,0,0,0,0
15154,0,0,0,0,0
98324,0,0,0,0,0
106158,0,0,0,0,0
1473,0,0,0,0,0
30335,0,0,0,0,0
53963,0,0,0,0,0
21602,0,0,0,0,0
79886,0,0,0,0,0
8352,0,0,0,0,0
56919,0,0,0,0,0
6295,0,0,0,0,0
29131,0,0,0,0,0
49343,0,0,0,0,0
50570,0,0,0,0,0
55310,0,0,0,0,0
39063,0,0,0,0,0
26828,0,0,0,0,0
33116,0,0,0,0,0
63600,0,0,0,0,0
65615,0,0,0,0,0
47143,0,0,0,0,0
52582,0,0,0,0,0
9757,0,0,0,0,0
3550,0,0,0,0,0
4370,0,0,0,0,0
2738,0,0,0,0,0
43570,0,0,0,0,0
65988,0,0,0,0,0
113500,4,4,4,0,0
80397,0,0,0,0,0
40486,0,0,0,0,0
38424,0,0,0,0,0
62967,0,0,0,0,0
38753,0,0,0,0,0
53466,0,0,0,0,0
63539,0,0,0,0,0
102072,0,0,0,0,0
83534,0,0,0,0,0
4990,0,0,0,0,0
78482,0,0,0,0,0
3666,0,0,0,0,0
56846,0,0,0,0,0
47715,0,0,0,0,0
79468,0,0,0,0,0
120113,0,0,0,0,0
45037,0,0,0,0,0
107176,0,0,0,0,0
57339,0,0,0,0,0
15078,1,1,1,0,0
85730,0,0,0,0,0
50887,0,0,0,0,0
115579,0,0,0,0,0
55741,0,0,0,0,0
110223,0,0,0,0,0
108158,0,0,0,0,0
66088,0,0,0,0,0
55482,0,0,0,0,0
39570,0,0,0,0,0
55349,0,0,0,0,0
97663,0,0,0,0,0
92185,0,0,0,0,0
62382,0,0,0,0,0
21164,0,0,0,0,0
54694,0,0,0,0,0
4599,0,0,0,0,0
11947,0,0,0,0,0
43951,0,0,0,0,0
9460,0,0,0,0,0
14069,0,0,0,0,0
15170,0,0,0,0,0
35416,0,0,0,0,0
41822,0,0,0,0,0
60382,0,0,0,0,0
44770,0,0,0,0,0
24989,0,0,0,0,0
6876,0,0,0,0,0
57820,0,0,0,0,0
97373,0,0,0,0,0
33993,0,0,0,0,0
97430,0,0,0,0,0
62715,0,0,0,0,0
28771,0,0,0,0,0
84716,0,0,0,0,0
90754,0,0,0,0,0
88930,0,0,0,0,0
59164,0,0,0,0,0
46934,0,0,0,0,0
23526,0,0,0,0,0
2592,0,0,0,0,0
112169,0,0,0,0,0
97877,0,0,0,0,0
82184,0,0,0,0,0
19117,0,0,0,0,0
33689,0,0,0,0,0
5884,0,0,0,0,0
76614,0,0,0,0,0
103700,0,0,0,0,0
66466,0,0,0,0,0
87156,0,0,0,0,0
7702,0,0,0,0,0
39134,0,0,0,0,0
88944,0,0,0,0,0
38208,0,0,0,0,0
62945,0,0,0,0,0
46342,0,0,0,0,0
5572,0,0,0,0,0
58064,0,0,0,0,0
102580,0,0,0,0,0
58101,0,0,0,0,0
64122,0,0,0,0,0
94345,0,0,0,0,0
115319,0,0,0,0,0
85419,0,0,0,0,0
33223,0,0,0,0,0
72938,0,0,0,0,0
103525,0,0,0,0,0
60201,0,0,0,0,0
117464,0,0,0,0,0
94283,0,0,0,0,0
51994,1,1,1,0,0
5068,0,0,0,0,0
40518,0,0,0,0,0
20641,0,0,0,0,0
78260,0,0,0,0,0
115676,0,0,0,0,0
2084,0,0,0,0,0
104314,0,0,0,0,0
64875,0,0,0,0,0
59928,0,0,0,0,0
2471,0,0,0,0,0
54983,0,0,0,0,0
72376,0,0,0,0,0
105555,0,0,0,0,0
108295,0,0,0,0,0
56437,0,0,0,0,0
29389,0,0,0,0,0
3022,0,0,0,0,0
23852,0,0,0,0,0
117128,0,0,0,0,0
91495,0,0,0,0,0
6809,0,0,0,0,0
32805,0,0,0,0,0
119619,0,0,0,0,0
76557,0,0,0,0,0
9432,0,0,0,0,0
84317,0,0,0,0,0
1328,0,0,0,0,0
65763,0,0,0,0,0
118956,0,0,0,0,0
7839,0,0,0,0,0
53488,0,0,0,0,0
57788,0,0,0,0,0
20896,0,0,0,0,0
70463,0,0,0,0,0
50526,0,0,0,0,0
87975,0,0,0,0,0
45332,0,0,0,0,0
102478,0,0,0,0,0
13899,0,0,0,0,0
108546,0,0,0,0,0
51289,0,0,0,0,0
71127,0,0,0,0,0
29292,0,0,0,0,0
15606,0,0,0,0,0
92906,0,0,0,0,0
41854,0,0,0,0,0
56641,0,0,0,0,0
6777,0,0,0,0,0
14499,0,0,0,0,0
21512,0,0,0,0,0
67612,0,0,0,0,0
29090,0,0,0,0,0
47280,0,0,0,0,0
60414,0,0,0,0,0
113769,0,0,0,0,0
91248,0,0,0,0,0
22111,0,0,0,0,0
109768,0,0,0,0,0
21896,0,0,0,0,0
73861,0,0,0,0,0
55478,0,0,0,0,0
86708,0,0,0,0,0
115625,1,1,1,0,0
104490,0,0,0,0,0
104579,0,0,0,0,0
58017,0,0,0,0,0
57603,0,0,0,0,0
82486,0,0,0,0,0
81593,0,0,0,0,0
93999,0,0,0,0,0
97122,0,0,0,0,0
66973,0,0,0,0,0
39409,0,0,0,0,0
64708,0,0,0,0,0
48806,0,0,0,0,0
90315,0,0,0,0,0
106621,0,0,0,0,0
111962,0,0,0,0,0
93823,0,0,0,0,0
64056,0,0,0,0,0
77739,0,0,0,0,0
71495,0,0,0,0,0
115572,0,0,0,0,0
95635,0,0,0,0,0
43999,0,0,0,0,0
66187,0,0,0,0,0
111119,0,0,0,0,0
108881,0,0,0,0,0
76598,0,0,0,0,0
69994,0,0,0,0,0
102741,0,0,0,0,0
117650,0,0,0,0,0
6735,0,0,0,0,0
52729,0,0,0,0,0
18829,0,0,0,0,0
62540,0,0,0,0,0
52301,0,0,0,0,0
85074,0,0,0,0,0
118582,0,0,0,0,0
22919,0,0,0,0,0
23139,0,0,0,0,0
51225,0,0,0,0,0
31097,0,0,0,0,0
29587,0,0,0,0,0
107482,0,0,0,0,0
43342,0,0,0,0,0
61020,0,0,0,0,0
16417,0,0,0,0,0
9716,0,0,0,0,0
57669,0,0,0,0,0
82306,0,0,0,0,0
13522,0,0,0,0,0
63232,0,0,0,0,0
104464,0,0,0,0,0
61008,0,0,0,0,0
40227,3,3,3,0,0
44423,0,0,0,0,0
87698,0,0,0,0,0
109232,0,0,0,0,0
63403,0,0,0,0,0
89415,0,0,0,0,0
105128,0,0,0,0,0
55839,0,0,0,0,0
20567,0,0,0,0,0
3707,0,0,0,0,0
28088,0,0,0,0,0
63039,0,0,0,0,0
107694,0,0,0,0,0
21125,0,0,0,0,0
93593,0,0,0,0,0
84444,0,0,0,0,0
35129,0,0,0,0,0
33403,0,0,0,0,0
59943,0,0,0,0,0
26834,0,0,0,0,0
12656,0,0,0,0,0
117768,0,0,0,0,0
67814,0,0,0,0,0
108279,0,0,0,0,0
116550,0,0,0,0,0
62731,0,0,0,0,0
89417,0,0,0,0,0
88056,0,0,0,0,0
75693,0,0,0,0,0
112609,0,0,0,0,0
103515,0,0,0,0,0
87261,0,0,0,0,0
88126,0,0,0,0,0
106590,0,0,0,0,0
17837,0,0,0,0,0
46022,0,0,0,0,0
56716,0,0,0,0,0
88086,0,0,0,0,0
9746,0,0,0,0,0
64770,0,0,0,0,0
118013,0,0,0,0,0
115457,0,0,0,0,0
65253,0,0,0,0,0
47561,0,0,0,0,0
54289,0,0,0,0,0
103694,0,0,0,0,0
33384,0,0,0,0,0
23162,0,0,0,0,0
40865,0,0,0,0,0
31756,0,0,0,0,0
51575,0,0,0,0,0
97774,0,0,0,0,0
26859,0,0,0,0,0
71476,0,0,0,0,0
16956,0,0,0,0,0
104963,0,0,0,0,0
48607,0,0,0,0,0
45245,0,0,0,0,0
36013,0,0,0,0,0
21731,0,0,0,0,0
65688,0,0,0,0,0
96531,0,0,0,0,0
39737,0,0,0,0,0
12762,0,0,0,0,0
107913,0,0,0,0,0
10316,0,0,0,0,0
9977,0,0,0,0,0
100490,0,0,0,0,0
52361,0,0,0,0,0
31320,0,0,0,0,0
29443,0,0,0,0,0
50013,0,0,0,0,0
114845,0,0,0,0,0
18143,0,0,0,0,0
59371,0,0,0,0,0
80107,0,0,0,0,0
70658,0,0,0,0,0
118103,0,0,0,0,0
76676,0,0,0,0,0
64820,0,0,0,0,0
68709,0,0,0,0,0
52896,0,0,0,0,0
110439,0,0,0,0,0
93012,0,0,0,0,0
75829,0,0,0,0,0
54992,0,0,0,0,0
9959,0,0,0,0,0
12610,0,0,0,0,0
57503,0,0,0,0,0
98543,0,0,0,0,0
66049,0,0,0,0,0
18029,0,0,0,0,0
38434,0,0,0,0,0
58178,1,1,1,0,0
61914,0,0,0,0,0
12518,0,0,0,0,0
5973,0,0,0,0,0
41438,0,0,0,0,0
86624,0,0,0,0,0
61835,0,0,0,0,0
53156,0,0,0,0,0
57919,0,0,0,0,0
107854,0,0,0,0,0
19202,0,0,0,0,0
58008,0,0,0,0,0
36324,0,0,0,0,0
78274,0,0,0,0,0
58971,0,0,0,0,0
2766,0,0,0,0,0
54583,0,0,0,0,0
54155,0,0,0,0,0
110307,0,0,0,0,0
115218,0,0,0,0,0
117916,0,0,0,0,0
62122,0,0,0,0,0
26900,0,0,0,0,0
108151,0,0,0,0,0
39617,0,0,0,0,0
11777,0,0,0,0,0
96537,0,0,0,0,0
6624,0,0,0,0,0
6914,0,0,0,0,0
101081,0,0,0,0,0
89069,0,0,0,0,0
60096,0,0,0,0,0
50524,0,0,0,0,0
104659,0,0,0,0,0
17550,0,0,0,0,0
3868,0,0,0,0,0
110748,0,0,0,0,0
3445,0,0,0,0,0
68466,0,0,0,0,0
49755,0,0,0,0,0
42318,0,0,0,0,0
7132,0,0,0,0,0
83386,0,0,0,0,0
5996,0,0,0,0,0
53249,0,0,0,0,0
68843,0,0,0,0,0
7358,0,0,0,0,0
23341,0,0,0,0,0
35916,0,0,0,0,0
62469,0,0,0,0,0
67370,0,0,0,0,0
97016,0,0,0,0,0
34533,0,0,0,0,0
33808,0,0,0,0,0
117522,0,0,0,0,0
86755,0,0,0,0,0
19179,0,0,0,0,0
26635,0,0,0,0,0
5437,0,0,0,0,0
97543,0,0,0,0,0
46785,0,0,0,0,0
87538,0,0,0,0,0
17762,0,0,0,0,0
70336,0,0,0,0,0
76267,0,0,0,0,0
36050,0,0,0,0,0
68126,0,0,0,0,0
3345,0,0,0,0,0
88219,0,0,0,0,0
58650,0,0,0,0,0
88725,3,3,3,0,0
47574,0,0,0,0,0
26984,0,0,0,0,0
110366,0,0,0,0,0
82261,0,0,0,0,0
87370,0,0,0,0,0
28715,0,0,0,0,0
119675,0,0,0,0,0
74301,0,0,0,0,0
109423,0,0,0,0,0
82013,0,0,0,0,0
10554,0,0,0,0,0
43741,0,0,0,0,0
43502,0,0,0,0,0
106646,0,0,0,0,0
82946,0,0,0,0,0
19874,0,0,0,0,0
68702,0,0,0,0,0
120402,0,0,0,0,0
97251,0,0,0,0,0
62319,0,0,0,0,0
80435,0,0,0,0,0
77016,0,0,0,0,0
86905,0,0,0,0,0
115762,0,0,0,0,0
73807,0,0,0,0,0
109579,0,0,0,0,0
48915,0,0,0,0,0
41342,0,0,0,0,0
52790,0,0,0,0,0
55963,0,0,0,0,0
26902,0,0,0,0,0
35988,0,0,0,0,0
88363,0,0,0,0,0
37880,0,0,0,0,0
94465,1,1,1,0,0
53312,0,0,0,0,0
86026,0,0,0,0,0
116459,0,0,0,0,0
96811,0,0,0,0,0
109698,0,0,0,0,0
61337,0,0,0,0,0
116004,0,0,0,0,0
80096,0,0,0,0,0
49034,0,0,0,0,0
73416,0,0,0,0,0
77362,0,0,0,0,0
19604,0,0,0,0,0
65456,0,0,0,0,0
101335,0,0,0,0,0
104295,0,0,0,0,0
93403,0,0,0,0,0
79271,0,0,0,0,0
16655,0,0,0,0,0
40750,0,0,0,0,0
11413,0,0,0,0,0
120516,0,0,0,0,0
19733,0,0,0,0,0
17489,0,0,0,0,0
63266,0,0,0,0,0
82756,0,0,0,0,0
89035,0,0,0,0,0
8236,0,0,0,0,0
44735,0,0,0,0,0
89552,0,0,0,0,0
88164,0,0,0,0,0
85955,0,0,0,0,0
24080,0,0,0,0,0
22028,0,0,0,0,0
48492,0,0,0,0,0
100615,0,0,0,0,0
90461,0,0,0,0,0
44358,0,0,0,0,0
100463,0,0,0,0,0
29722,0,0,0,0,0
18766,0,0,0,0,0
19838,0,0,0,0,0
64854,0,0,0,0,0
51083,0,0,0,0,0
77243,0,0,0,0,0
33268,0,0,0,0,0
6007,5,5,5,0,0
25234,0,0,0,0,0
16718,0,0,0,0,0
57401,0,0,0,0,0
25894,0,0,0,0,0
1065,0,0,0,0,0
38017,0,0,0,0,0
87598,0,0,0,0,0
16366,0,0,0,0,0
94530,0,0,0,0,0
104972,0,0,0,0,0
102784,0,0,0,0,0
118705,0,0,0,0,0
8264,0,0,0,0,0
95021,0,0,0,0,0
16240,0,0,0,0,0
5953,0,0,0,0,0
119684,0,0,0,0,0
59459,0,0,0,0,0
42035,0,0,0,0,0
14369,0,0,0,0,0
13080,0,0,0,0,0
46831,0,0,0,0,0
40005,0,0,0,0,0
983,0,0,0,0,0
119033,0,0,0,0,0
45381,0,0,0,0,0
94319,0,0,0,0,0
105219,0,0,0,0,0
22915,0,0,0,0,0
98398,0,0,0,0,0
96365,0,0,0,0,0
29021,0,0,0,0,0
30035,0,0,0,0,0
1717,0,0,0,0,0
52216,0,0,0,0,0
18395,0,0,0,0,0
80742,0,0,0,0,0
41596,0,0,0,0,0
84957,0,0,0,0,0
4297,3,3,3,0,0
70729,0,0,0,0,0
76652,0,0,0,0,0
106840,0,0,0,0,0
6320,0,0,0,0,0
31927,0,0,0,0,0
16326,0,0,0,0,0
22308,0,0,0,0,0
10253,0,0,0,0,0
29396,0,0,0,0,0
49505,0,0,0,0,0
18337,0,0,0,0,0
29239,0,0,0,0,0
74513,0,0,0,0,0
36289,0,0,0,0,0
45438,0,0,0,0,0
91910,0,0,0,0,0
30059,0,0,0,0,0
21228,0,0,0,0,0
70876,0,0,0,0,0
71258,0,0,0,0,0
33109,0,0,0,0,0
13083,0,0,0,0,0
67246,0,0,0,0,0
25363,0,0,0,0,0
34422,0,0,0,0,0
50662,0,0,0,0,0
43072,0,0,0,0,0
18572,0,0,0,0,0
99156,0,0,0,0,0
64108,0,0,0,0,0
118445,0,0,0,0,0
98146,0,0,0,0,0
82958,0,0,0,0,0
68433,0,0,0,0,0
39346,0,0,0,0,0
48725,0,0,0,0,0
116790,0,0,0,0,0
95065,0,0,0,0,0
12325,0,0,0,0,0
54937,0,0,0,0,0
65570,0,0,0,0,0
54625,0,0,0,0,0
101971,0,0,0,0,0
113812,0,0,0,0,0
95253,0,0,0,0,0
105454,0,0,0,0,0
7145,0,0,0,0,0
41280,0,0,0,0,0
44872,0,0,0,0,0
85885,0,0,0,0,0
78034,0,0,0,0,0
68161,0,0,0,0,0
101047,0,0,0,0,0
26180,0,0,0,0,0
111985,0,0,0,0,0
362,0,0,0,0,0
18569,0,0,0,0,0
60904,0,0,0,0,0
27380,7,7,7,0,0
33464,0,0,0,0,0
88994,0,0,0,0,0
20271,0,0,0,0,0
109274,0,0,0,0,0
111051,0,0,0,0,0
45050,0,0,0,0,0
8275,0,0,0,0,0
82632,0,0,0,0,0
97699,0,0,0,0,0
95122,0,0,0,0,0
25629,0,0,0,0,0
99898,0,0,0,0,0
1423,0,0,0,0,0
35971,0,0,0,0,0
52694,0,0,0,0,0
116654,0,0,0,0,0
40450,0,0,0,0,0
87373,0,0,0,0,0
111355,0,0,0,0,0
86675,0,0,0,0,0
18524,0,0,0,0,0
73498,0,0,0,0,0
88865,0,0,0,0,0
72837,0,0,0,0,0
43207,0,0,0,0,0
35175,0,0,0,0,0
107770,0,0,0,0,0
110475,0,0,0,0,0
5242,0,0,0,0,0
5654,0,0,0,0,0
7327,0,0,0,0,0
88788,0,0,0,0,0
57415,0,0,0,0,0
93040,0,0,0,0,0
57492,0,0,0,0,0
71891,0,0,0,0,0
8530,0,0,0,0,0
33468,0,0,0,0,0
107286,0,0,0,0,0
51091,0,0,0,0,0
34508,0,0,0,0,0
28493,8,8,8,0,0
988,0,0,0,0,0
47299,0,0,0,0,0
14211,0,0,0,0,0
16665,0,0,0,0,0
10977,0,0,0,0,0
22444,0,0,0,0,0
3384,0,0,0,0,0
111908,0,0,0,0,0
104594,0,0,0,0,0
72940,0,0,0,0,0
111995,0,0,0,0,0
107355,0,0,0,0,0
85797,0,0,0,0,0
12937,0,0,0,0,0
46710,0,0,0,0,0
64,0,0,0,0,0
91178,0,0,0,0,0
36407,0,0,0,0,0
27864,0,0,0,0,0
58208,0,0,0,0,0
30340,0,0,0,0,0
45200,0,0,0,0,0
24007,0,0,0,0,0
45876,0,0,0,0,0
5780,0,0,0,0,0
86308,0,0,0,0,0
54877,0,0,0,0,0
32091,0,0,0,0,0
117718,0,0,0,0,0
43118,0,0,0,0,0
17166,0,0,0,0,0
40930,0,0,0,0,0
34510,0,0,0,0,0
81795,0,0,0,0,0
31504,0,0,0,0,0
15358,0,0,0,0,0
101115,0,0,0,0,0
8755,0,0,0,0,0
119753,0,0,0,0,0
116512,0,0,0,0,0
11989,0,0,0,0,0
56881,0,0,0,0,0
81210,0,0,0,0,0
40166,0,0,0,0,0
29960,0,0,0,0,0
50921,0,0,0,0,0
27855,0,0,0,0,0
4271,0,0,0,0,0
9205,0,0,0,0,0
107197,0,0,0,0,0
49410,0,0,0,0,0
33358,0,0,0,0,0
99154,0,0,0,0,0
10937,0,0,0,0,0
40821,0,0,0,0,0
50345,0,0,0,0,0
64171,0,0,0,0,0
89470,0,0,0,0,0
43948,0,0,0,0,0
82380,0,0,0,0,0
23229,0,0,0,0,0
49748,0,0,0,0,0
102022,0,0,0,0,0
29867,0,0,0,0,0
66667,0,0,0,0,0
54376,0,0,0,0,0
59896,0,0,0,0,0
63246,0,0,0,0,0
52917,0,0,0,0,0
100830,0,0,0,0,0
80625,0,0,0,0,0
59811,0,0,0,0,0
56612,0,0,0,0,0
104277,0,0,0,0,0
103787,2,2,2,0,0
66582,0,0,0,0,0
7088,0,0,0,0,0
54671,0,0,0,0,0
51952,0,0,0,0,0
78247,0,0,0,0,0
32410,0,0,0,0,0
119700,0,0,0,0,0
52612,0,0,0,0,0
85294,0,0,0,0,0
3374,0,0,0,0,0
86876,0,0,0,0,0
94933,0,0,0,0,0
58086,0,0,0,0,0
30472,0,0,0,0,0
78934,0,0,0,0,0
21059,0,0,0,0,0
54048,0,0,0,0,0
72332,0,0,0,0,0
19016,0,0,0,0,0
67509,0,0,0,0,0
117120,0,0,0,0,0
78520,0,0,0,0,0
18414,0,0,0,0,0
43906,0,0,0,0,0
67566,0,0,0,0,0
87717,0,0,0,0,0
48578,0,0,0,0,0
71391,0,0,0,0,0
114475,0,0,0,0,0
33770,0,0,0,0,0
110714,0,0,0,0,0
23343,0,0,0,0,0
22361,0,0,0,0,0
56850,1,1,1,0,0
113701,0,0,0,0,0
97678,0,0,0,0,0
100932,1,1,1,0,0
10168,0,0,0,0,0
30123,0,0,0,0,0
110095,0,0,0,0,0
6174,0,0,0,0,0
21410,0,0,0,0,0
81579,0,0,0,0,0
12807,0,0,0,0,0
4110,0,0,0,0,0
82735,0,0,0,0,0
56926,0,0,0,0,0
28332,0,0,0,0,0
40255,0,0,0,0,0
66066,0,0,0,0,0
44244,0,0,0,0,0
90752,0,0,0,0,0
16631,0,0,0,0,0
87355,0,0,0,0,0
55430,0,0,0,0,0
36065,0,0,0,0,0
79748,0,0,0,0,0
64115,0,0,0,0,0
72853,0,0,0,0,0
30398,0,0,0,0,0
24209,0,0,0,0,0
37550,0,0,0,0,0
114453,0,0,0,0,0
23456,0,0,0,0,0
68722,0,0,0,0,0
79750,0,0,0,0,0
81716,0,0,0,0,0
155,0,0,0,0,0
29050,0,0,0,0,0
62770,0,0,0,0,0
82750,0,0,0,0,0
46878,0,0,0,0,0
13622,0,0,0,0,0
91850,0,0,0,0,0
86186,0,0,0,0,0
80964,0,0,0,0,0
25638,0,0,0,0,0
7811,0,0,0,0,0
11635,0,0,0,0,0
69883,0,0,0,0,0
24774,0,0,0,0,0
23319,0,0,0,0,0
93860,0,0,0,0,0
6439,0,0,0,0,0
113096,0,0,0,0,0
49500,0,0,0,0,0
40303,0,0,0,0,0
112002,0,0,0,0,0
15094,0,0,0,0,0
97162,0,0,0,0,0
76378,0,0,0,0,0
59358,0,0,0,0,0
110700,0,0,0,0,0
98377,0,0,0,0,0
115624,0,0,0,0,0
89932,0,0,0,0,0
15648,0,0,0,0,0
27248,0,0,0,0,0
45875,0,0,0,0,0
88746,0,0,0,0,0
67929,0,0,0,0,0
77584,0,0,0,0,0
23788,0,0,0,0,0
65431,0,0,0,0,0
77103,0,0,0,0,0
94115,0,0,0,0,0
89311,0,0,0,0,0
29351,0,0,0,0,0
98879,0,0,0,0,0
21855,0,0,0,0,0
54572,0,0,0,0,0
2040,0,0,0,0,0
96320,0,0,0,0,0
12817,0,0,0,0,0
26144,0,0,0,0,0
4700,0,0,0,0,0
41992,0,0,0,0,0
113041,0,0,0,0,0
24236,0,0,0,0,0
89594,0,0,0,0,0
6779,0,0,0,0,0
77240,0,0,0,0,0
8169,0,0,0,0,0
281,0,0,0,0,0
67782,0,0,0,0,0
48937,0,0,0,0,0
92473,0,0,0,0,0
96004,0,0,0,0,0
14085,0,0,0,0,0
43033,0,0,0,0,0
61555,0,0,0,0,0
101725,0,0,0,0,0
44285,0,0,0,0,0
77980,0,0,0,0,0
102940,0,0,0,0,0
36580,0,0,0,0,0
64805,0,0,0,0,0
13057,0,0,0,0,0
95604,0,0,0,0,0
24128,0,0,0,0,0
107064,0,0,0,0,0
105421,0,0,0,0,0
24428,0,0,0,0,0
72251,0,0,0,0,0
44969,0,0,0,0,0
115256,0,0,0,0,0
111690,0,0,0,0,0
120206,0,0,0,0,0
9153,0,0,0,0,0
71981,0,0,0,0,0
2826,0,0,0,0,0
75781,0,0,0,0,0
111783,0,0,0,0,0
95626,0,0,0,0,0
19643,0,0,0,0,0
84710,0,0,0,0,0
14225,0,0,0,0,0
107371,0,0,0,0,0
95702,0,0,0,0,0
107685,0,0,0,0,0
39788,0,0,0,0,0
33819,0,0,0,0,0
79974,0,0,0,0,0
21126,0,0,0,0,0
52631,0,0,0,0,0
39945,0,0,0,0,0
29879,0,0,0,0,0
51161,0,0,0,0,0
13491,0,0,0,0,0
73517,0,0,0,0,0
51004,0,0,0,0,0
76888,0,0,0,0,0
39836,0,0,0,0,0
91537,0,0,0,0,0
12840,0,0,0,0,0
111616,0,0,0,0,0
42899,0,0,0,0,0
33186,0,0,0,0,0
42076,0,0,0,0,0
49728,0,0,0,0,0
70546,0,0,0,0,0
99210,0,0,0,0,0
120178,0,0,0,0,0
47586,0,0,0,0,0
33352,0,0,0,0,0
39684,0,0,0,0,0
47950,0,0,0,0,0
66511,0,0,0,0,0
86562,0,0,0,0,0
112681,0,0,0,0,0
12215,0,0,0,0,0
73989,0,0,0,0,0
78315,0,0,0,0,0
93920,0,0,0,0,0
4726,0,0,0,0,0
120108,0,0,0,0,0
54031,0,0,0,0,0
57050,0,0,0,0,0
27712,0,0,0,0,0
26207,0,0,0,0,0
99707,0,0,0,0,0
75261,0,0,0,0,0
22049,0,0,0,0,0
78983,0,0,0,0,0
108341,0,0,0,0,0
64374,0,0,0,0,0
5392,0,0,0,0,0
89070,0,0,0,0,0
12219,0,0,0,0,0
87198,0,0,0,0,0
119958,0,0,0,0,0
82864,0,0,0,0,0
366,0,0,0,0,0
60307,0,0,0,0,0
59868,0,0,0,0,0
35448,0,0,0,0,0
63695,0,0,0,0,0
35739,0,0,0,0,0
28044,0,0,0,0,0
119808,0,0,0,0,0
32886,0,0,0,0,0
31880,0,0,0,0,0
50089,1,1,1,0,0
100683,0,0,0,0,0
114339,0,0,0,0,0
35788,0,0,0,0,0
112048,0,0,0,0,0
37956,0,0,0,0,0
96453,0,0,0,0,0
71834,0,0,0,0,0
99049,0,0,0,0,0
13736,0,0,0,0,0
67327,0,0,0,0,0
120233,0,0,0,0,0
43433,0,0,0,0,0
74733,1,1,1,0,0
53352,0,0,0,0,0
36369,0,0,0,0,0
61863,0,0,0,0,0
64577,0,0,0,0,0
55754,2,2,2,0,0
42195,0,0,0,0,0
6805,0,0,0,0,0
90299,0,0,0,0,0
100700,0,0,0,0,0
97514,0,0,0,0,0
99689,0,0,0,0,0
75430,0,0,0,0,0
21560,0,0,0,0,0
60530,0,0,0,0,0
112198,0,0,0,0,0
55033,0,0,0,0,0
95480,0,0,0,0,0
106038,0,0,0,0,0
52588,0,0,0,0,0
106104,0,0,0,0,0
9664,0,0,0,0,0
8240,0,0,0,0,0
102954,0,0,0,0,0
84147,0,0,0,0,0
73621,0,0,0,0,0
74587,0,0,0,0,0
46502,0,0,0,0,0
62606,0,0,0,0,0
95177,0,0,0,0,0
118817,0,0,0,0,0
58839,0,0,0,0,0
96946,0,0,0,0,0
80927,0,0,0,0,0
118505,0,0,0,0,0
13158,0,0,0,0,0
42051,0,0,0,0,0
22710,0,0,0,0,0
90756,0,0,0,0,0
10864,0,0,0,0,0
37588,2,2,2,0,0
33413,0,0,0,0,0
51450,0,0,0,0,0
42161,0,0,0,0,0
99244,0,0,0,0,0
101679,0,0,0,0,0
7914,0,0,0,0,0
26137,0,0,0,0,0
86249,0,0,0,0,0
12846,0,0,0,0,0
15120,0,0,0,0,0
106873,0,0,0,0,0
103121,0,0,0,0,0
54001,0,0,0,0,0
109516,0,0,0,0,0
8524,0,0,0,0,0
64209,0,0,0,0,0
99659,0,0,0,0,0
108283,0,0,0,0,0
33286,0,0,0,0,0
76401,0,0,0,0,0
71761,0,0,0,0,0
65788,0,0,0,0,0
101096,0,0,0,0,0
89742,0,0,0,0,0
11994,0,0,0,0,0
110159,0,0,0,0,0
66795,0,0,0,0,0
69760,0,0,0,0,0
62642,0,0,0,0,0
5865,0,0,0,0,0
7542,0,0,0,0,0
29633,0,0,0,0,0
74595,0,0,0,0,0
105367,0,0,0,0,0
17309,0,0,0,0,0
47314,0,0,0,0,0
110033,0,0,0,0,0
439,0,0,0,0,0
108991,4,4,4,0,0
7455,0,0,0,0,0
3737,0,0,0,0,0
42229,0,0,0,0,0
48551,0,0,0,0,0
57723,0,0,0,0,0
34203,0,0,0,0,0
22124,0,0,0,0,0
109273,0,0,0,0,0
57617,0,0,0,0,0
99579,0,0,0,0,0
28360,0,0,0,0,0
33380,0,0,0,0,0
41502,0,0,0,0,0
64050,0,0,0,0,0
115418,0,0,0,0,0
90657,0,0,0,0,0
11606,0,0,0,0,0
56185,0,0,0,0,0
117888,0,0,0,0,0
61480,0,0,0,0,0
34893,0,0,0,0,0
49668,0,0,0,0,0
68228,0,0,0,0,0
112941,0,0,0,0,0
116411,0,0,0,0,0
31570,0,0,0,0,0
34493,0,0,0,0,0
35201,0,0,0,0,0
8062,0,0,0,0,0
62211,0,0,0,0,0
65671,0,0,0,0,0
18604,0,0,0,0,0
36874,0,0,0,0,0
70827,0,0,0,0,0
97816,0,0,0,0,0
27678,0,0,0,0,0
89253,0,0,0,0,0
70697,0,0,0,0,0
49384,0,0,0,0,0
61828,0,0,0,0,0
104104,0,0,0,0,0
1225,0,0,0,0,0
50959,0,0,0,0,0
22200,0,0,0,0,0
274,0,0,0,0,0
72184,0,0,0,0,0
108738,0,0,0,0,0
52655,0,0,0,0,0
48334,0,0,0,0,0
60532,0,0,0,0,0
42015,0,0,0,0,0
4668,0,0,0,0,0
22937,0,0,0,0,0
37772,0,0,0,0,0
19258,0,0,0,0,0
51255,0,0,0,0,0
13249,0,0,0,0,0
95717,0,0,0,0,0
87218,0,0,0,0,0
19836,0,0,0,0,0
47281,0,0,0,0,0
87760,0,0,0,0,0
30684,0,0,0,0,0
83642,0,0,0,0,0
89303,0,0,0,0,0
75525,0,0,0,0,0
50846,0,0,0,0,0
80790,0,0,0,0,0
107862,0,0,0,0,0
31439,0,0,0,0,0
116984,0,0,0,0,0
7844,0,0,0,0,0
4798,0,0,0,0,0
20835,0,0,0,0,0
82488,0,0,0,0,0
113935,0,0,0,0,0
118840,0,0,0,0,0
99164,0,0,0,0,0
72077,0,0,0,0,0
55859,0,0,0,0,0
71942,0,0,0,0,0
93582,0,0,0,0,0
70291,0,0,0,0,0
54713,0,0,0,0,0
55898,0,0,0,0,0
104350,0,0,0,0,0
87175,0,0,0,0,0
72116,0,0,0,0,0
87405,0,0,0,0,0
51090,0,0,0,0,0
33596,0,0,0,0,0
11879,0,0,0,0,0
69385,0,0,0,0,0
67390,0,0,0,0,0
118366,0,0,0,0,0
48753,0,0,0,0,0
13081,0,0,0,0,0
26678,0,0,0,0,0
57125,0,0,0,0,0
88607,0,0,0,0,0
100669,0,0,0,0,0
58896,0,0,0,0,0
272,1,1,1,0,0
53674,0,0,0,0,0
36275,0,0,0,0,0
107432,0,0,0,0,0
76223,0,0,0,0,0
107822,0,0,0,0,0
99248,0,0,0,0,0
102368,0,0,0,0,0
112914,0,0,0,0,0
30074,0,0,0,0,0
49724,0,0,0,0,0
115907,0,0,0,0,0
58298,0,0,0,0,0
40083,0,0,0,0,0
80572,0,0,0,0,0
26802,0,0,0,0,0
41043,0,0,0,0,0
93313,0,0,0,0,0
22498,0,0,0,0,0
114418,0,0,0,0,0
32905,0,0,0,0,0
15136,0,0,0,0,0
117416,0,0,0,0,0
97905,0,0,0,0,0
87326,0,0,0,0,0
19383,0,0,0,0,0
113777,0,0,0,0,0
87613,0,0,0,0,0
82360,0,0,0,0,0
102492,0,0,0,0,0
78686,0,0,0,0,0
18261,0,0,0,0,0
11242,0,0,0,0,0
69952,0,0,0,0,0
45649,0,0,0,0,0
86946,0,0,0,0,0
19116,0,0,0,0,0
63457,0,0,0,0,0
119258,0,0,0,0,0
28129,0,0,0,0,0
93324,0,0,0,0,0
99506,0,0,0,0,0
72517,0,0,0,0,0
79896,0,0,0,0,0
68459,0,0,0,0,0
100034,0,0,0,0,0
45640,0,0,0,0,0
73363,0,0,0,0,0
108212,0,0,0,0,0
7116,0,0,0,0,0
99179,0,0,0,0,0
103703,0,0,0,0,0
87540,0,0,0,0,0
63411,0,0,0,0,0
51554,0,0,0,0,0
33945,0,0,0,0,0
116237,0,0,0,0,0
41322,0,0,0,0,0
7117,0,0,0,0,0
16145,0,0,0,0,0
112361,0,0,0,0,0
49168,0,0,0,0,0
42626,0,0,0,0,0
86241,0,0,0,0,0
83848,0,0,0,0,0
11421,0,0,0,0,0
9184,0,0,0,0,0
80250,0,0,0,0,0
32523,0,0,0,0,0
70661,0,0,0,0,0
29199,0,0,0,0,0
61231,0,0,0,0,0
65386,0,0,0,0,0
117626,0,0,0,0,0
113872,0,0,0,0,0
71498,0,0,0,0,0
50442,0,0,0,0,0
102832,0,0,0,0,0
22866,0,0,0,0,0
79934,0,0,0,0,0
23943,0,0,0,0,0
107983,0,0,0,0,0
87321,4,4,4,0,0
76680,0,0,0,0,0
24413,0,0,0,0,0
33974,0,0,0,0,0
7285,0,0,0,0,0
9643,0,0,0,0,0
72828,0,0,0,0,0
101891,0,0,0,0,0
79564,0,0,0,0,0
37176,0,0,0,0,0
82469,0,0,0,0,0
48857,0,0,0,0,0
119056,0,0,0,0,0
103363,0,0,0,0,0
82718,0,0,0,0,0
9423,0,0,0,0,0
54442,0,0,0,0,0
108647,0,0,0,0,0
87015,0,0,0,0,0
41366,0,0,0,0,0
86781,0,0,0,0,0
83865,0,0,0,0,0
75633,0,0,0,0,0
85881,0,0,0,0,0
1000,0,0,0,0,0
5690,0,0,0,0,0
98238,2,2,2,0,0
80065,0,0,0,0,0
105790,0,0,0,0,0
98443,0,0,0,0,0
38642,0,0,0,0,0
19274,0,0,0,0,0
92963,0,0,0,0,0
76311,0,0,0,0,0
25373,0,0,0,0,0
16448,0,0,0,0,0
46534,0,0,0,0,0
111269,0,0,0,0,0
96830,0,0,0,0,0
109129,0,0,0,0,0
82748,0,0,0,0,0
92109,0,0,0,0,0
48522,0,0,0,0,0
65191,0,0,0,0,0
90046,0,0,0,0,0
112250,0,0,0,0,0
37934,0,0,0,0,0
59434,0,0,0,0,0
12983,0,0,0,0,0
66677,0,0,0,0,0
1369,0,0,0,0,0
36839,0,0,0,0,0
106380,0,0,0,0,0
40175,0,0,0,0,0
26660,0,0,0,0,0
81225,0,0,0,0,0
57386,0,0,0,0,0
102872,0,0,0,0,0
114105,0,0,0,0,0
109071,0,0,0,0,0
97907,0,0,0,0,0
3282,0,0,0,0,0
79637,0,0,0,0,0
109200,0,0,0,0,0
37840,0,0,0,0,0
67177,0,0,0,0,0
7514,0,0,0,0,0
14757,0,0,0,0,0
62161,0,0,0,0,0
82837,0,0,0,0,0
44300,0,0,0,0,0
102584,0,0,0,0,0
22334,0,0,0,0,0
106406,0,0,0,0,0
90797,0,0,0,0,0
59152,0,0,0,0,0
48444,0,0,0,0,0
111410,0,0,0,0,0
39703,0,0,0,0,0
22812,0,0,0,0,0
115379,0,0,0,0,0
79988,0,0,0,0,0
1416,0,0,0,0,0
450,0,0,0,0,0
106303,0,0,0,0,0
91320,0,0,0,0,0
47271,0,0,0,0,0
22072,0,0,0,0,0
75562,0,0,0,0,0
77365,0,0,0,0,0
105871,0,0,0,0,0
27091,0,0,0,0,0
521,0,0,0,0,0
28284,0,0,0,0,0
39613,0,0,0,0,0
30530,0,0,0,0,0
58286,0,0,0,0,0
101799,0,0,0,0,0
54145,0,0,0,0,0
22423,0,0,0,0,0
50531,0,0,0,0,0
77629,0,0,0,0,0
21571,0,0,0,0,0
105587,0,0,0,0,0
73193,0,0,0,0,0
7349,0,0,0,0,0
78833,0,0,0,0,0
53859,0,0,0,0,0
9273,0,0,0,0,0
25041,0,0,0,0,0
22842,0,0,0,0,0
114827,0,0,0,0,0
42957,0,0,0,0,0
37256,0,0,0,0,0
63177,0,0,0,0,0
101773,0,0,0,0,0
86615,0,0,0,0,0
72470,0,0,0,0,0
85720,0,0,0,0,0
45000,0,0,0,0,0
17674,0,0,0,0,0
17065,0,0,0,0,0
97961,0,0,0,0,0
99380,0,0,0,0,0
68363,0,0,0,0,0
72030,0,0,0,0,0
13934,0,0,0,0,0
72051,0,0,0,0,0
24786,0,0,0,0,0
115414,0,0,0,0,0
59926,0,0,0,0,0
14680,0,0,0,0,0
54112,0,0,0,0,0
105199,0,0,0,0,0
72519,0,0,0,0,0
59070,0,0,0,0,0
119524,0,0,0,0,0
28158,0,0,0,0,0
83519,0,0,0,0,0
92791,0,0,0,0,0
10974,0,0,0,0,0
51545,0,0,0,0,0
61905,0,0,0,0,0
66415,0,0,0,0,0
46090,0,0,0,0,0
48280,0,0,0,0,0
41699,0,0,0,0,0
97309,0,0,0,0,0
116152,0,0,0,0,0
110210,0,0,0,0,0
101803,0,0,0,0,0
112815,0,0,0,0,0
98122,1,1,1,0,0
67291,0,0,0,0,0
63636,0,0,0,0,0
100923,0,0,0,0,0
67539,0,0,0,0,0
89810,0,0,0,0,0
48053,0,0,0,0,0
109000,0,0,0,0,0
20698,0,0,0,0,0
100697,0,0,0,0,0
78920,0,0,0,0,0
15363,0,0,0,0,0
910,0,0,0,0,0
9530,0,0,0,0,0
68516,0,0,0,0,0
109651,0,0,0,0,0
39508,0,0,0,0,0
43907,0,0,0,0,0
38467,0,0,0,0,0
116689,0,0,0,0,0
109683,0,0,0,0,0
2731,0,0,0,0,0
101378,0,0,0,0,0
70410,0,0,0,0,0
109679,0,0,0,0,0
107094,0,0,0,0,0
19109,0,0,0,0,0
64337,0,0,0,0,0
44925,0,0,0,0,0
39260,0,0,0,0,0
115184,0,0,0,0,0
70761,0,0,0,0,0
40373,0,0,0,0,0
42786,0,0,0,0,0
19030,0,0,0,0,0
30489,0,0,0,0,0
96774,0,0,0,0,0
102371,0,0,0,0,0
66235,0,0,0,0,0
4783,0,0,0,0,0
86689,0,0,0,0,0
16203,0,0,0,0,0
109917,0,0,0,0,0
77561,0,0,0,0,0
7875,0,0,0,0,0
26717,0,0,0,0,0
45926,0,0,0,0,0
7859,0,0,0,0,0
61018,0,0,0,0,0
42052,0,0,0,0,0
26911,0,0,0,0,0
25940,0,0,0,0,0
108919,0,0,0,0,0
31674,0,0,0,0,0
34269,0,0,0,0,0
54335,0,0,0,0,0
4123,0,0,0,0,0
73066,0,0,0,0,0
78701,0,0,0,0,0
91338,0,0,0,0,0
104653,0,0,0,0,0
64052,0,0,0,0,0
86611,1,1,1,0,0
15109,0,0,0,0,0
98546,0,0,0,0,0
47081,0,0,0,0,0
70109,0,0,0,0,0
89547,0,0,0,0,0
41930,0,0,0,0,0
62369,0,0,0,0,0
9337,0,0,0,0,0
80243,0,0,0,0,0
112191,0,0,0,0,0
119991,0,0,0,0,0
93274,0,0,0,0,0
32831,0,0,0,0,0
99062,0,0,0,0,0
102718,0,0,0,0,0
87136,0,0,0,0,0
78853,0,0,0,0,0
107931,0,0,0,0,0
99720,0,0,0,0,0
6992,0,0,0,0,0
18046,0,0,0,0,0
44055,0,0,0,0,0
39790,0,0,0,0,0
28957,3,3,3,0,0
100970,0,0,0,0,0
39714,0,0,0,0,0
84610,0,0,0,0,0
44679,0,0,0,0,0
27143,0,0,0,0,0
35914,0,0,0,0,0
91901,0,0,0,0,0
36702,0,0,0,0,0
115293,1,1,1,0,0
50206,0,0,0,0,0
1782,0,0,0,0,0
24330,0,0,0,0,0
107742,0,0,0,0,0
108975,0,0,0,0,0
98549,0,0,0,0,0
81002,0,0,0,0,0
89801,0,0,0,0,0
107220,0,0,0,0,0
20721,0,0,0,0,0
117614,0,0,0,0,0
91702,0,0,0,0,0
64251,0,0,0,0,0
99594,0,0,0,0,0
49793,0,0,0,0,0
53578,0,0,0,0,0
70302,1,1,1,0,0
77959,0,0,0,0,0
84384,0,0,0,0,0
9804,0,0,0,0,0
23872,0,0,0,0,0
47748,0,0,0,0,0
106954,0,0,0,0,0
568,0,0,0,0,0
82468,0,0,0,0,0
82141,0,0,0,0,0
64588,0,0,0,0,0
25857,0,0,0,0,0
86832,0,0,0,0,0
71295,0,0,0,0,0
51651,0,0,0,0,0
6261,0,0,0,0,0
110930,0,0,0,0,0
118082,0,0,0,0,0
75382,0,0,0,0,0
2048,0,0,0,0,0
35453,0,0,0,0,0
93463,0,0,0,0,0
111220,0,0,0,0,0
116970,0,0,0,0,0
96389,0,0,0,0,0
48432,0,0,0,0,0
94179,0,0,0,0,0
116498,0,0,0,0,0
15421,0,0,0,0,0
76345,0,0,0,0,0
43496,0,0,0,0,0
71784,0,0,0,0,0
23930,0,0,0,0,0
27609,0,0,0,0,0
85480,0,0,0,0,0
102448,0,0,0,0,0
88344,0,0,0,0,0
83132,0,0,0,0,0
17541,0,0,0,0,0
64328,0,0,0,0,0
105825,0,0,0,0,0
62040,0,0,0,0,0
109005,0,0,0,0,0
71338,0,0,0,0,0
6087,0,0,0,0,0
116415,0,0,0,0,0
12558,0,0,0,0,0
11582,0,0,0,0,0
65638,0,0,0,0,0
120456,0,0,0,0,0
42424,0,0,0,0,0
15124,0,0,0,0,0
44210,0,0,0,0,0
37591,0,0,0,0,0
91022,0,0,0,0,0
65338,0,0,0,0,0
117194,0,0,0,0,0
91163,0,0,0,0,0
4610,0,0,0,0,0
109808,0,0,0,0,0
61982,0,0,0,0,0
107964,0,0,0,0,0
93962,0,0,0,0,0
105465,0,0,0,0,0
77593,0,0,0,0,0
12574,0,0,0,0,0
29252,0,0,0,0,0
28943,0,0,0,0,0
113080,0,0,0,0,0
23878,0,0,0,0,0
112689,0,0,0,0,0
47016,0,0,0,0,0
73491,0,0,0,0,0
4651,0,0,0,0,0
89865,0,0,0,0,0
97917,0,0,0,0,0
13375,0,0,0,0,0
51331,0,0,0,0,0
45182,0,0,0,0,0
102062,0,0,0,0,0
85942,0,0,0,0,0
60887,0,0,0,0,0
16951,0,0,0,0,0
110402,0,0,0,0,0
104734,0,0,0,0,0
27782,0,0,0,0,0
18428,0,0,0,0,0
80511,0,0,0,0,0
10795,0,0,0,0,0
35586,0,0,0,0,0
105215,0,0,0,0,0
28291,0,0,0,0,0
56542,0,0,0,0,0
49317,0,0,0,0,0
14797,0,0,0,0,0
61600,0,0,0,0,0
30321,0,0,0,0,0
6833,0,0,0,0,0
77731,0,0,0,0,0
11961,0,0,0,0,0
11772,0,0,0,0,0
33243,0,0,0,0,0
90388,0,0,0,0,0
56842,0,0,0,0,0
120502,0,0,0,0,0
4374,0,0,0,0,0
77075,0,0,0,0,0
99275,0,0,0,0,0
115120,0,0,0,0,0
18944,0,0,0,0,0
42924,0,0,0,0,0
96682,0,0,0,0,0
44696,0,0,0,0,0
26504,0,0,0,0,0
6162,0,0,0,0,0
30131,0,0,0,0,0
82080,0,0,0,0,0
90101,0,0,0,0,0
12043,0,0,0,0,0
66538,0,0,0,0,0
84486,0,0,0,0,0
108846,0,0,0,0,0
10518,0,0,0,0,0
111037,0,0,0,0,0
94153,0,0,0,0,0
52428,0,0,0,0,0
4336,0,0,0,0,0
59826,0,0,0,0,0
84242,0,0,0,0,0
19135,0,0,0,0,0
22112,0,0,0,0,0
72950,0,0,0,0,0
63585,0,0,0,0,0
61442,0,0,0,0,0
66226,0,0,0,0,0
9758,0,0,0,0,0
9604,2,2,2,0,0
92444,0,0,0,0,0
17546,0,0,0,0,0
58534,0,0,0,0,0
31249,0,0,0,0,0
119682,0,0,0,0,0
6181,0,0,0,0,0
17151,0,0,0,0,0
66531,0,0,0,0,0
58220,0,0,0,0,0
28476,0,0,0,0,0
47553,0,0,0,0,0
104503,0,0,0,0,0
28842,0,0,0,0,0
60140,0,0,0,0,0
101146,0,0,0,0,0
7185,0,0,0,0,0
16319,0,0,0,0,0
77392,0,0,0,0,0
31056,0,0,0,0,0
70450,0,0,0,0,0
68917,0,0,0,0,0
16647,0,0,0,0,0
1846,0,0,0,0,0
70708,0,0,0,0,0
49414,0,0,0,0,0
19342,0,0,0,0,0
47736,0,0,0,0,0
57631,0,0,0,0,0
117699,0,0,0,0,0
3822,0,0,0,0,0
99369,0,0,0,0,0
82168,0,0,0,0,0
337,0,0,0,0,0
64003,0,0,0,0,0
18989,0,0,0,0,0
108947,0,0,0,0,0
34465,0,0,0,0,0
86032,0,0,0,0,0
34840,0,0,0,0,0
965,0,0,0,0,0
9765,0,0,0,0,0
53341,0,0,0,0,0
105982,0,0,0,0,0
41135,0,0,0,0,0
54437,0,0,0,0,0
71859,0,0,0,0,0
70346,0,0,0,0,0
103605,0,0,0,0,0
104516,0,0,0,0,0
46451,0,0,0,0,0
63276,0,0,0,0,0
73875,0,0,0,0,0
71335,0,0,0,0,0
47943,0,0,0,0,0
9201,0,0,0,0,0
6956,0,0,0,0,0
80515,0,0,0,0,0
89613,0,0,0,0,0
110267,0,0,0,0,0
72135,0,0,0,0,0
112972,0,0,0,0,0
29675,0,0,0,0,0
108316,3,3,3,0,0
33602,0,0,0,0,0
118862,0,0,0,0,0
63095,0,0,0,0,0
20292,0,0,0,0,0
94243,0,0,0,0,0
33195,0,0,0,0,0
82835,0,0,0,0,0
98414,0,0,0,0,0
115021,0,0,0,0,0
103857,0,0,0,0,0
20738,0,0,0,0,0
19987,0,0,0,0,0
102623,1,1,1,0,0
20159,0,0,0,0,0
82609,0,0,0,0,0
56808,0,0,0,0,0
65294,0,0,0,0,0
56373,0,0,0,0,0
61002,0,0,0,0,0
116700,0,0,0,0,0
51416,0,0,0,0,0
97153,0,0,0,0,0
44165,0,0,0,0,0
13843,0,0,0,0,0
43323,0,0,0,0,0
15209,0,0,0,0,0
59051,0,0,0,0,0
114621,0,0,0,0,0
66721,0,0,0,0,0
42923,0,0,0,0,0
45746,0,0,0,0,0
28959,0,0,0,0,0
104487,0,0,0,0,0
86973,0,0,0,0,0
10200,0,0,0,0,0
86656,0,0,0,0,0
8198,0,0,0,0,0
41362,0,0,0,0,0
42953,0,0,0,0,0
97224,0,0,0,0,0
16543,0,0,0,0,0
93152,0,0,0,0,0
16446,0,0,0,0,0
35466,0,0,0,0,0
16496,0,0,0,0,0
46760,0,0,0,0,0
50515,0,0,0,0,0
25078,0,0,0,0,0
32866,4,4,4,0,0
6264,0,0,0,0,0
86334,0,0,0,0,0
77250,0,0,0,0,0
104565,0,0,0,0,0
14506,0,0,0,0,0
51457,0,0,0,0,0
5377,3,3,3,0,0
16148,0,0,0,0,0
94331,0,0,0,0,0
34695,0,0,0,0,0
99883,0,0,0,0,0
37829,0,0,0,0,0
15132,0,0,0,0,0
22517,0,0,0,0,0
31877,0,0,0,0,0
71582,0,0,0,0,0
79798,0,0,0,0,0
33061,0,0,0,0,0
85559,0,0,0,0,0
32640,1,1,1,0,0
36808,0,0,0,0,0
62365,0,0,0,0,0
39786,0,0,0,0,0
74902,0,0,0,0,0
89084,0,0,0,0,0
86287,0,0,0,0,0
2504,0,0,0,0,0
29285,0,0,0,0,0
89545,0,0,0,0,0
58046,0,0,0,0,0
8546,0,0,0,0,0
15938,0,0,0,0,0
21511,0,0,0,0,0
14516,0,0,0,0,0
59446,0,0,0,0,0
47535,0,0,0,0,0
110931,0,0,0,0,0
69185,0,0,0,0,0
71244,0,0,0,0,0
116969,0,0,0,0,0
85035,0,0,0,0,0
36181,0,0,0,0,0
83777,0,0,0,0,0
16490,0,0,0,0,0
76108,0,0,0,0,0
102366,0,0,0,0,0
4057,0,0,0,0,0
8930,0,0,0,0,0
65914,0,0,0,0,0
53603,0,0,0,0,0
105945,0,0,0,0,0
98230,0,0,0,0,0
10086,0,0,0,0,0
14319,0,0,0,0,0
67128,0,0,0,0,0
70196,0,0,0,0,0
22222,0,0,0,0,0
17498,0,0,0,0,0
48506,0,0,0,0,0
93373,0,0,0,0,0
118210,0,0,0,0,0
29115,0,0,0,0,0
29694,0,0,0,0,0
66230,0,0,0,0,0
3025,0,0,0,0,0
79871,0,0,0,0,0
5488,0,0,0,0,0
100063,0,0,0,0,0
14936,0,0,0,0,0
27709,0,0,0,0,0
89682,0,0,0,0,0
79223,0,0,0,0,0
13517,0,0,0,0,0
71289,0,0,0,0,0
38323,0,0,0,0,0
35786,0,0,0,0,0
79214,0,0,0,0,0
90962,0,0,0,0,0
23052,0,0,0,0,0
119273,0,0,0,0,0
80582,0,0,0,0,0
977,0,0,0,0,0
22481,0,0,0,0,0
35237,0,0,0,0,0
112778,0,0,0,0,0
79674,0,0,0,0,0
113590,0,0,0,0,0
74562,0,0,0,0,0
26448,0,0,0,0,0
119420,0,0,0,0,0
48832,0,0,0,0,0
114887,0,0,0,0,0
74631,0,0,0,0,0
109008,0,0,0,0,0
80119,0,0,0,0,0
93902,0,0,0,0,0
27353,0,0,0,0,0
116195,0,0,0,0,0
24703,0,0,0,0,0
2347,0,0,0,0,0
61840,0,0,0,0,0
63126,0,0,0,0,0
3652,0,0,0,0,0
109721,0,0,0,0,0
70377,0,0,0,0,0
80398,0,0,0,0,0
90464,0,0,0,0,0
54383,0,0,0,0,0
74517,0,0,0,0,0
23197,0,0,0,0,0
28746,0,0,0,0,0
93449,0,0,0,0,0
87731,0,0,0,0,0
10821,0,0,0,0,0
79610,0,0,0,0,0
23907,0,0,0,0,0
112598,0,0,0,0,0
36526,0,0,0,0,0
50070,0,0,0,0,0
43175,0,0,0,0,0
77141,2,2,2,0,0
98119,0,0,0,0,0
45880,0,0,0,0,0
78560,0,0,0,0,0
86436,0,0,0,0,0
51491,0,0,0,0,0
74817,0,0,0,0,0
113802,0,0,0,0,0
108057,0,0,0,0,0
87768,0,0,0,0,0
101389,0,0,0,0,0
45016,0,0,0,0,0
54486,0,0,0,0,0
114640,0,0,0,0,0
98751,0,0,0,0,0
40754,0,0,0,0,0
65744,0,0,0,0,0
114205,0,0,0,0,0
79530,0,0,0,0,0
103630,0,0,0,0,0
68286,0,0,0,0,0
67472,0,0,0,0,0
94910,0,0,0,0,0
27160,0,0,0,0,0
71056,0,0,0,0,0
107837,0,0,0,0,0
84804,0,0,0,0,0
96653,0,0,0,0,0
2123,0,0,0,0,0
14982,0,0,0,0,0
3898,0,0,0,0,0
31363,0,0,0,0,0
66173,0,0,0,0,0
54492,0,0,0,0,0
29978,0,0,0,0,0
88175,0,0,0,0,0
89950,0,0,0,0,0
16820,0,0,0,0,0
22339,0,0,0,0,0
7695,0,0,0,0,0
56401,0,0,0,0,0
114709,0,0,0,0,0
31737,0,0,0,0,0
111074,0,0,0,0,0
61309,0,0,0,0,0
52233,0,0,0,0,0
63741,0,0,0,0,0
69640,0,0,0,0,0
67239,0,0,0,0,0
6792,0,0,0,0,0
85579,1,1,1,0,0
12505,0,0,0,0,0
65347,0,0,0,0,0
118008,0,0,0,0,0
9328,0,0,0,0,0
42208,0,0,0,0,0
84615,0,0,0,0,0
15263,0,0,0,0,0
2819,0,0,0,0,0
31896,0,0,0,0,0
91130,1,1,1,0,0
45323,0,0,0,0,0
85561,0,0,0,0,0
18837,0,0,0,0,0
74767,0,0,0,0,0
29908,0,0,0,0,0
32620,0,0,0,0,0
74645,0,0,0,0,0
17296,0,0,0,0,0
54956,0,0,0,0,0
22737,0,0,0,0,0
78255,0,0,0,0,0
106711,1,1,1,0,0
66710,0,0,0,0,0
27005,0,0,0,0,0
78639,0,0,0,0,0
32428,0,0,0,0,0
87438,0,0,0,0,0
63099,0,0,0,0,0
33727,0,0,0,0,0
38582,0,0,0,0,0
24189,0,0,0,0,0
17883,0,0,0,0,0
65537,0,0,0,0,0
83837,0,0,0,0,0
23989,0,0,0,0,0
46915,0,0,0,0,0
118824,0,0,0,0,0
27762,0,0,0,0,0
20692,0,0,0,0,0
27495,0,0,0,0,0
66015,0,0,0,0,0
70062,0,0,0,0,0
55379,0,0,0,0,0
6944,0,0,0,0,0
19516,0,0,0,0,0
18613,0,0,0,0,0
79603,0,0,0,0,0
54891,0,0,0,0,0
60723,0,0,0,0,0
2375,0,0,0,0,0
51422,0,0,0,0,0
103549,0,0,0,0,0
47838,0,0,0,0,0
56279,0,0,0,0,0
58870,0,0,0,0,0
76803,0,0,0,0,0
57114,0,0,0,0,0
36601,0,0,0,0,0
101514,0,0,0,0,0
11438,0,0,0,0,0
36029,0,0,0,0,0
4452,0,0,0,0,0
40691,0,0,0,0,0
75324,0,0,0,0,0
53077,0,0,0,0,0
40151,0,0,0,0,0
9659,0,0,0,0,0
57649,0,0,0,0,0
48113,0,0,0,0,0
26458,0,0,0,0,0
8522,0,0,0,0,0
22489,0,0,0,0,0
51962,0,0,0,0,0
48774,0,0,0,0,0
48902,0,0,0,0,0
80546,0,0,0,0,0
11946,0,0,0,0,0
59787,0,0,0,0,0
54703,0,0,0,0,0
52688,0,0,0,0,0
17659,0,0,0,0,0
17978,0,0,0,0,0
23549,0,0,0,0,0
36886,0,0,0,0,0
29806,0,0,0,0,0
52755,0,0,0,0,0
78423,0,0,0,0,0
53487,0,0,0,0,0
79417,0,0,0,0,0
59186,0,0,0,0,0
16855,0,0,0,0,0
118219,0,0,0,0,0
32727,0,0,0,0,0
71543,0,0,0,0,0
57229,0,0,0,0,0
27876,0,0,0,0,0
20205,0,0,0,0,0
57855,0,0,0,0,0
101999,0,0,0,0,0
95687,0,0,0,0,0
17835,0,0,0,0,0
16626,0,0,0,0,0
68001,0,0,0,0,0
66189,0,0,0,0,0
47119,0,0,0,0,0
78235,0,0,0,0,0
115170,0,0,0,0,0
45712,0,0,0,0,0
41050,0,0,0,0,0
118707,0,0,0,0,0
72951,0,0,0,0,0
44843,0,0,0,0,0
87093,0,0,0,0,0
68375,0,0,0,0,0
44782,0,0,0,0,0
72247,0,0,0,0,0
27404,0,0,0,0,0
77833,0,0,0,0,0
926,0,0,0,0,0
91788,0,0,0,0,0
83017,0,0,0,0,0
66055,0,0,0,0,0
6345,0,0,0,0,0
59642,0,0,0,0,0
113912,0,0,0,0,0
7705,0,0,0,0,0
71535,0,0,0,0,0
98903,0,0,0,0,0
89617,0,0,0,0,0
74906,0,0,0,0,0
47854,0,0,0,0,0
85061,0,0,0,0,0
52184,0,0,0,0,0
6228,0,0,0,0,0
56378,0,0,0,0,0
30458,0,0,0,0,0
17910,0,0,0,0,0
26691,0,0,0,0,0
119471,0,0,0,0,0
75933,0,0,0,0,0
62186,0,0,0,0,0
54660,0,0,0,0,0
106316,0,0,0,0,0
83079,0,0,0,0,0
61441,0,0,0,0,0
67572,0,0,0,0,0
112584,0,0,0,0,0
14581,0,0,0,0,0
80442,0,0,0,0,0
61452,0,0,0,0,0
104720,0,0,0,0,0
30893,0,0,0,0,0
19407,0,0,0,0,0
114050,0,0,0,0,0
99113,0,0,0,0,0
113401,0,0,0,0,0
112763,0,0,0,0,0
49957,0,0,0,0,0
110425,0,0,0,0,0
3911,0,0,0,0,0
77005,0,0,0,0,0
86144,0,0,0,0,0
64338,0,0,0,0,0
16969,0,0,0,0,0
112543,0,0,0,0,0
82481,0,0,0,0,0
110518,0,0,0,0,0
74222,0,0,0,0,0
118118,0,0,0,0,0
37268,0,0,0,0,0
22675,0,0,0,0,0
51652,0,0,0,0,0
28749,0,0,0,0,0
16945,0,0,0,0,0
40157,0,0,0,0,0
66107,0,0,0,0,0
83176,0,0,0,0,0
113571,0,0,0,0,0
106914,0,0,0,0,0
45280,0,0,0,0,0
13786,0,0,0,0,0
25888,0,0,0,0,0
72402,0,0,0,0,0
64647,0,0,0,0,0
72002,0,0,0,0,0
89246,0,0,0,0,0
32738,0,0,0,0,0
71792,0,0,0,0,0
68874,0,0,0,0,0
96120,0,0,0,0,0
50766,0,0,0,0,0
96207,0,0,0,0,0
69071,0,0,0,0,0
110280,0,0,0,0,0
60714,0,0,0,0,0
74632,0,0,0,0,0
18911,0,0,0,0,0
38571,0,0,0,0,0
41394,0,0,0,0,0
71539,0,0,0,0,0
11558,0,0,0,0,0
84522,0,0,0,0,0
76516,0,0,0,0,0
108977,0,0,0,0,0
43331,0,0,0,0,0
20860,0,0,0,0,0
79386,0,0,0,0,0
23363,0,0,0,0,0
64247,0,0,0,0,0
6475,0,0,0,0,0
5858,0,0,0,0,0
87507,0,0,0,0,0
108226,0,0,0,0,0
65647,0,0,0,0,0
3256,0,0,0,0,0
116439,0,0,0,0,0
115481,0,0,0,0,0
21464,0,0,0,0,0
11739,0,0,0,0,0
44004,0,0,0,0,0
94541,0,0,0,0,0
20136,0,0,0,0,0
76736,3,3,3,0,0
108630,0,0,0,0,0
49018,0,0,0,0,0
25490,0,0,0,0,0
103189,0,0,0,0,0
116092,0,0,0,0,0
56395,0,0,0,0,0
77051,0,0,0,0,0
46511,0,0,0,0,0
82489,0,0,0,0,0
4484,0,0,0,0,0
74201,0,0,0,0,0
64696,0,0,0,0,0
90026,0,0,0,0,0
117984,0,0,0,0,0
64442,0,0,0,0,0
4289,0,0,0,0,0
44074,0,0,0,0,0
108949,0,0,0,0,0
91916,0,0,0,0,0
106611,0,0,0,0,0
13918,0,0,0,0,0
102169,0,0,0,0,0
32296,0,0,0,0,0
33960,0,0,0,0,0
21134,0,0,0,0,0
84894,0,0,0,0,0
3803,0,0,0,0,0
62908,0,0,0,0,0
99431,0,0,0,0,0
106916,0,0,0,0,0
88942,0,0,0,0,0
1180,0,0,0,0,0
69439,0,0,0,0,0
107446,0,0,0,0,0
114731,0,0,0,0,0
65213,0,0,0,0,0
97637,0,0,0,0,0
93345,0,0,0,0,0
97963,0,0,0,0,0
80581,0,0,0,0,0
93183,0,0,0,0,0
667,0,0,0,0,0
78978,0,0,0,0,0
43703,0,0,0,0,0
38410,0,0,0,0,0
53727,0,0,0,0,0
95448,0,0,0,0,0
12034,0,0,0,0,0
25336,0,0,0,0,0
55404,0,0,0,0,0
25697,0,0,0,0,0
31533,0,0,0,0,0
25560,0,0,0,0,0
71624,0,0,0,0,0
53861,0,0,0,0,0
50078,0,0,0,0,0
28487,0,0,0,0,0
34502,0,0,0,0,0
40286,0,0,0,0,0
49179,0,0,0,0,0
61457,0,0,0,0,0
25143,0,0,0,0,0
50388,7,7,7,0,0
77044,0,0,0,0,0
98550,0,0,0,0,0
18932,0,0,0,0,0
45900,0,0,0,0,0
95438,0,0,0,0,0
78907,0,0,0,0,0
20001,0,0,0,0,0
116862,0,0,0,0,0
52632,0,0,0,0,0
6623,0,0,0,0,0
71249,0,0,0,0,0
10121,0,0,0,0,0
20076,0,0,0,0,0
13687,0,0,0,0,0
3110,0,0,0,0,0
91111,0,0,0,0,0
23484,0,0,0,0,0
41105,0,0,0,0,0
79572,0,0,0,0,0
59176,0,0,0,0,0
14199,0,0,0,0,0
22011,0,0,0,0,0
82547,0,0,0,0,0
84743,0,0,0,0,0
84802,0,0,0,0,0
81133,0,0,0,0,0
103009,0,0,0,0,0
108466,0,0,0,0,0
85280,0,0,0,0,0
4281,0,0,0,0,0
57749,0,0,0,0,0
81523,0,0,0,0,0
94565,0,0,0,0,0
29661,0,0,0,0,0
83713,0,0,0,0,0
7031,0,0,0,0,0
88107,0,0,0,0,0
29562,0,0,0,0,0
100905,0,0,0,0,0
77220,0,0,0,0,0
82952,0,0,0,0,0
59639,0,0,0,0,0
62924,0,0,0,0,0
39474,0,0,0,0,0
8603,0,0,0,0,0
70549,0,0,0,0,0
79911,0,0,0,0,0
55078,0,0,0,0,0
87358,0,0,0,0,0
118699,0,0,0,0,0
114214,0,0,0,0,0
71456,0,0,0,0,0
111855,0,0,0,0,0
51498,0,0,0,0,0
56318,0,0,0,0,0
22292,0,0,0,0,0
51344,0,0,0,0,0
75058,0,0,0,0,0
55576,0,0,0,0,0
116413,0,0,0,0,0
60187,0,0,0,0,0
104121,0,0,0,0,0
50301,0,0,0,0,0
106287,0,0,0,0,0
105834,0,0,0,0,0
39475,0,0,0,0,0
101238,0,0,0,0,0
35036,0,0,0,0,0
119542,0,0,0,0,0
23279,0,0,0,0,0
1215,0,0,0,0,0
68166,1,1,1,0,0
118485,0,0,0,0,0
91375,4,4,4,0,0
94282,0,0,0,0,0
12167,1,1,1,0,0
95676,0,0,0,0,0
52854,0,0,0,0,0
57365,0,0,0,0,0
103856,0,0,0,0,0
276,0,0,0,0,0
101980,0,0,0,0,0
25014,0,0,0,0,0
43608,0,0,0,0,0
38820,0,0,0,0,0
22359,0,0,0,0,0
103535,0,0,0,0,0
99561,0,0,0,0,0
57914,0,0,0,0,0
102367,0,0,0,0,0
40302,0,0,0,0,0
90081,0,0,0,0,0
95402,4,4,4,0,0
45596,0,0,0,0,0
53966,0,0,0,0,0
17487,0,0,0,0,0
12439,0,0,0,0,0
65998,0,0,0,0,0
95516,0,0,0,0,0
65350,0,0,0,0,0
88512,0,0,0,0,0
34407,0,0,0,0,0
91617,0,0,0,0,0
57166,0,0,0,0,0
44558,0,0,0,0,0
111653,0,0,0,0,0
44877,0,0,0,0,0
16621,0,0,0,0,0
33067,0,0,0,0,0
68448,0,0,0,0,0
62260,0,0,0,0,0
87479,0,0,0,0,0
103528,0,0,0,0,0
99759,0,0,0,0,0
112524,0,0,0,0,0
79212,0,0,0,0,0
83549,0,0,0,0,0
109705,0,0,0,0,0
63367,0,0,0,0,0
43320,0,0,0,0,0
71553,0,0,0,0,0
89651,0,0,0,0,0
47829,0,0,0,0,0
38893,0,0,0,0,0
87086,0,0,0,0,0
23779,0,0,0,0,0
35793,0,0,0,0,0
17232,0,0,0,0,0
77693,0,0,0,0,0
45847,0,0,0,0,0
68054,0,0,0,0,0
36696,0,0,0,0,0
80130,0,0,0,0,0
6687,2,2,2,0,0
32389,0,0,0,0,0
117913,0,0,0,0,0
64508,0,0,0,0,0
84681,0,0,0,0,0
108133,0,0,0,0,0
82052,0,0,0,0,0
12044,0,0,0,0,0
66535,0,0,0,0,0
84991,0,0,0,0,0
109524,0,0,0,0,0
45588,0,0,0,0,0
54003,0,0,0,0,0
76205,0,0,0,0,0
91781,0,0,0,0,0
44326,0,0,0,0,0
98180,0,0,0,0,0
77600,0,0,0,0,0
82941,0,0,0,0,0
37213,0,0,0,0,0
73857,0,0,0,0,0
32024,0,0,0,0,0
25404,0,0,0,0,0
42250,0,0,0,0,0
96024,0,0,0,0,0
20787,5,5,5,0,0
50034,0,0,0,0,0
68850,0,0,0,0,0
33072,0,0,0,0,0
74770,0,0,0,0,0
108610,0,0,0,0,0
838,0,0,0,0,0
81440,0,0,0,0,0
119472,1,1,1,0,0
97271,0,0,0,0,0
63579,0,0,0,0,0
68029,0,0,0,0,0
30371,0,0,0,0,0
51533,0,0,0,0,0
49147,0,0,0,0,0
17536,0,0,0,0,0
39500,0,0,0,0,0
56289,0,0,0,0,0
20479,0,0,0,0,0
26775,0,0,0,0,0
84812,0,0,0,0,0
26619,0,0,0,0,0
73834,0,0,0,0,0
74842,0,0,0,0,0
13047,0,0,0,0,0
82017,0,0,0,0,0
7926,0,0,0,0,0
79752,0,0,0,0,0
57612,0,0,0,0,0
41653,0,0,0,0,0
94113,0,0,0,0,0
47881,0,0,0,0,0
113046,0,0,0,0,0
105737,0,0,0,0,0
80247,0,0,0,0,0
73403,0,0,0,0,0
83583,0,0,0,0,0
98731,0,0,0,0,0
112821,0,0,0,0,0
103872,0,0,0,0,0
76118,0,0,0,0,0
87351,0,0,0,0,0
78564,0,0,0,0,0
71910,2,2,2,0,0
44579,0,0,0,0,0
72873,0,0,0,0,0
42539,0,0,0,0,0
119150,0,0,0,0,0
61152,0,0,0,0,0
86140,0,0,0,0,0
10981,0,0,0,0,0
113636,0,0,0,0,0
65126,0,0,0,0,0
96644,0,0,0,0,0
19223,0,0,0,0,0
109471,0,0,0,0,0
71245,0,0,0,0,0
40710,0,0,0,0,0
8555,0,0,0,0,0
28225,0,0,0,0,0
59148,0,0,0,0,0
76152,0,0,0,0,0
44688,0,0,0,0,0
8023,0,0,0,0,0
52193,0,0,0,0,0
46421,0,0,0,0,0
80808,0,0,0,0,0
50610,0,0,0,0,0
84990,0,0,0,0,0
12429,0,0,0,0,0
79358,0,0,0,0,0
23947,0,0,0,0,0
106829,0,0,0,0,0
46371,0,0,0,0,0
21478,0,0,0,0,0
40236,0,0,0,0,0
98200,0,0,0,0,0
102665,0,0,0,0,0
57622,0,0,0,0,0
12025,0,0,0,0,0
44954,0,0,0,0,0
56780,0,0,0,0,0
69095,0,0,0,0,0
57981,0,0,0,0,0
50837,0,0,0,0,0
77945,0,0,0,0,0
152,0,0,0,0,0
94371,0,0,0,0,0
103767,0,0,0,0,0
105420,0,0,0,0,0
115185,0,0,0,0,0
21275,0,0,0,0,0
100422,0,0,0,0,0
98266,0,0,0,0,0
84808,0,0,0,0,0
75908,0,0,0,0,0
54305,0,0,0,0,0
116500,0,0,0,0,0
108860,0,0,0,0,0
96791,0,0,0,0,0
119839,0,0,0,0,0
105972,0,0,0,0,0
85487,0,0,0,0,0
32068,0,0,0,0,0
11680,0,0,0,0,0
82479,0,0,0,0,0
9945,0,0,0,0,0
15100,0,0,0,0,0
37070,0,0,0,0,0
118990,0,0,0,0,0
13865,0,0,0,0,0
25761,0,0,0,0,0
39441,0,0,0,0,0
38971,0,0,0,0,0
25213,0,0,0,0,0
94247,0,0,0,0,0
10849,0,0,0,0,0
112785,0,0,0,0,0
42089,0,0,0,0,0
114425,0,0,0,0,0
75106,0,0,0,0,0
103205,0,0,0,0,0
117609,0,0,0,0,0
102951,0,0,0,0,0
98048,0,0,0,0,0
59398,0,0,0,0,0
46711,0,0,0,0,0
54392,0,0,0,0,0
82331,0,0,0,0,0
109795,2,2,2,0,0
71827,0,0,0,0,0
101487,0,0,0,0,0
47311,0,0,0,0,0
38938,0,0,0,0,0
6422,0,0,0,0,0
8572,0,0,0,0,0
87524,0,0,0,0,0
32446,0,0,0,0,0
5505,0,0,0,0,0
47484,1,1,1,0,0
48378,0,0,0,0,0
52067,0,0,0,0,0
80599,0,0,0,0,0
13133,0,0,0,0,0
87842,0,0,0,0,0
54781,0,0,0,0,0
69931,0,0,0,0,0
110688,0,0,0,0,0
25855,0,0,0,0,0
66046,0,0,0,0,0
55861,0,0,0,0,0
79486,0,0,0,0,0
15022,0,0,0,0,0
41627,0,0,0,0,0
79243,0,0,0,0,0
93956,0,0,0,0,0
100197,1,1,1,0,0
58498,0,0,0,0,0
96856,0,0,0,0,0
70649,0,0,0,0,0
48830,0,0,0,0,0
78462,0,0,0,0,0
53244,0,0,0,0,0
59948,0,0,0,0,0
46903,0,0,0,0,0
33520,0,0,0,0,0
99906,0,0,0,0,0
33096,0,0,0,0,0
118894,0,0,0,0,0
88050,0,0,0,0,0
51542,0,0,0,0,0
33834,0,0,0,0,0
86533,0,0,0,0,0
99068,0,0,0,0,0
102157,0,0,0,0,0
75020,0,0,0,0,0
22993,0,0,0,0,0
46373,0,0,0,0,0
104855,0,0,0,0,0
7937,0,0,0,0,0
103656,0,0,0,0,0
3176,0,0,0,0,0
40573,0,0,0,0,0
72570,0,0,0,0,0
46592,0,0,0,0,0
78800,0,0,0,0,0
73332,0,0,0,0,0
78179,0,0,0,0,0
119788,0,0,0,0,0
51367,0,0,0,0,0
91528,0,0,0,0,0
39580,0,0,0,0,0
88309,0,0,0,0,0
25281,0,0,0,0,0
37347,0,0,0,0,0
6440,0,0,0,0,0
103358,0,0,0,0,0
6065,0,0,0,0,0
9806,0,0,0,0,0
66545,0,0,0,0,0
10312,0,0,0,0,0
4805,0,0,0,0,0
107763,0,0,0,0,0
78111,0,0,0,0,0
30571,0,0,0,0,0
117182,0,0,0,0,0
51317,0,0,0,0,0
73043,0,0,0,0,0
7423,0,0,0,0,0
29731,0,0,0,0,0
102323,0,0,0,0,0
118132,0,0,0,0,0
98972,0,0,0,0,0
52120,0,0,0,0,0
14550,0,0,0,0,0
9919,0,0,0,0,0
36659,0,0,0,0,0
101455,0,0,0,0,0
64802,0,0,0,0,0
36653,0,0,0,0,0
105385,0,0,0,0,0
19563,0,0,0,0,0
114517,0,0,0,0,0
18142,0,0,0,0,0
60222,0,0,0,0,0
16709,0,0,0,0,0
74230,0,0,0,0,0
43071,1,1,1,0,0
18596,0,0,0,0,0
103103,0,0,0,0,0
115772,0,0,0,0,0
77060,0,0,0,0,0
55064,0,0,0,0,0
78793,0,0,0,0,0
66041,0,0,0,0,0
34579,0,0,0,0,0
33809,0,0,0,0,0
57260,0,0,0,0,0
53539,0,0,0,0,0
46805,0,0,0,0,0
43041,0,0,0,0,0
84921,0,0,0,0,0
67691,0,0,0,0,0
72913,0,0,0,0,0
102615,0,0,0,0,0
4323,0,0,0,0,0
11837,0,0,0,0,0
90518,0,0,0,0,0
118905,0,0,0,0,0
52407,0,0,0,0,0
66121,0,0,0,0,0
81506,0,0,0,0,0
27241,0,0,0,0,0
12882,0,0,0,0,0
52187,0,0,0,0,0
105466,0,0,0,0,0
87048,0,0,0,0,0
102704,0,0,0,0,0
26508,0,0,0,0,0
8518,0,0,0,0,0
14353,0,0,0,0,0
27173,0,0,0,0,0
22390,0,0,0,0,0
112299,0,0,0,0,0
56733,0,0,0,0,0
90316,0,0,0,0,0
26396,0,0,0,0,0
75133,0,0,0,0,0
16447,0,0,0,0,0
93701,0,0,0,0,0
9449,0,0,0,0,0
48758,0,0,0,0,0
46007,0,0,0,0,0
29210,0,0,0,0,0
45697,0,0,0,0,0
19325,0,0,0,0,0
113611,0,0,0,0,0
74068,0,0,0,0,0
119421,0,0,0,0,0
101424,0,0,0,0,0
20985,0,0,0,0,0
16603,0,0,0,0,0
23649,0,0,0,0,0
24766,0,0,0,0,0
36311,0,0,0,0,0
82841,0,0,0,0,0
1760,0,0,0,0,0
40806,0,0,0,0,0
39845,0,0,0,0,0
118145,0,0,0,0,0
22324,0,0,0,0,0
106354,1,1,1,0,0
114431,0,0,0,0,0
48411,3,3,3,0,0
39583,0,0,0,0,0
22802,0,0,0,0,0
58191,0,0,0,0,0
45373,0,0,0,0,0
44948,0,0,0,0,0
22707,0,0,0,0,0
2943,1,1,1,0,0
17397,0,0,0,0,0
110787,0,0,0,0,0
115666,0,0,0,0,0
10389,0,0,0,0,0
41829,0,0,0,0,0
30009,0,0,0,0,0
88000,0,0,0,0,0
119550,0,0,0,0,0
75904,0,0,0,0,0
20728,0,0,0,0,0
19560,0,0,0,0,0
19031,0,0,0,0,0
79248,0,0,0,0,0
62582,0,0,0,0,0
39328,0,0,0,0,0
42785,0,0,0,0,0
28251,0,0,0,0,0
99462,0,0,0,0,0
31245,0,0,0,0,0
20606,0,0,0,0,0
112367,0,0,0,0,0
48546,0,0,0,0,0
119403,0,0,0,0,0
53688,0,0,0,0,0
26372,0,0,0,0,0
32602,0,0,0,0,0
91013,0,0,0,0,0
42532,0,0,0,0,0
21610,0,0,0,0,0
18091,0,0,0,0,0
98701,0,0,0,0,0
75078,0,0,0,0,0
83295,0,0,0,0,0
23505,0,0,0,0,0
4627,0,0,0,0,0
89402,0,0,0,0,0
101061,0,0,0,0,0
14818,0,0,0,0,0
34335,0,0,0,0,0
105873,0,0,0,0,0
44366,0,0,0,0,0
94367,0,0,0,0,0
25290,0,0,0,0,0
16698,0,0,0,0,0
95799,0,0,0,0,0
6409,0,0,0,0,0
21537,0,0,0,0,0
75597,0,0,0,0,0
51007,0,0,0,0,0
47046,0,0,0,0,0
26143,0,0,0,0,0
89493,0,0,0,0,0
99663,0,0,0,0,0
85134,0,0,0,0,0
114201,0,0,0,0,0
18589,0,0,0,0,0
65114,0,0,0,0,0
91887,0,0,0,0,0
15771,0,0,0,0,0
42246,0,0,0,0,0
91792,0,0,0,0,0
52296,0,0,0,0,0
10700,0,0,0,0,0
7451,0,0,0,0,0
93423,2,2,2,0,0
38899,0,0,0,0,0
103409,0,0,0,0,0
49521,0,0,0,0,0
91242,0,0,0,0,0
102658,0,0,0,0,0
9874,0,0,0,0,0
96178,0,0,0,0,0
94306,0,0,0,0,0
25113,0,0,0,0,0
10665,0,0,0,0,0
93169,0,0,0,0,0
84339,0,0,0,0,0
90957,0,0,0,0,0
11884,0,0,0,0,0
42400,0,0,0,0,0
82643,0,0,0,0,0
75509,0,0,0,0,0
2206,1,1,1,0,0
29490,0,0,0,0,0
7251,0,0,0,0,0
114580,0,0,0,0,0
113433,0,0,0,0,0
74340,0,0,0,0,0
61851,0,0,0,0,0
93116,0,0,0,0,0
99806,0,0,0,0,0
40795,0,0,0,0,0
89692,0,0,0,0,0
88650,0,0,0,0,0
24289,0,0,0,0,0
88719,0,0,0,0,0
75307,0,0,0,0,0
47661,0,0,0,0,0
55022,0,0,0,0,0
63358,0,0,0,0,0
76986,0,0,0,0,0
3492,0,0,0,0,0
105048,0,0,0,0,0
54199,0,0,0,0,0
20681,0,0,0,0,0
61281,4,4,4,0,0
67181,0,0,0,0,0
111209,0,0,0,0,0
85865,0,0,0,0,0
28686,0,0,0,0,0
88171,0,0,0,0,0
48038,0,0,0,0,0
41818,0,0,0,0,0
97208,1,1,1,0,0
10469,0,0,0,0,0
70631,0,0,0,0,0
59252,0,0,0,0,0
38934,0,0,0,0,0
62421,0,0,0,0,0
75572,0,0,0,0,0
31876,0,0,0,0,0
53654,0,0,0,0,0
17053,0,0,0,0,0
24383,0,0,0,0,0
103265,0,0,0,0,0
286,0,0,0,0,0
92884,0,0,0,0,0
31581,9,9,9,0,0
51888,0,0,0,0,0
34921,0,0,0,0,0
32991,0,0,0,0,0
77028,0,0,0,0,0
55889,0,0,0,0,0
7064,0,0,0,0,0
58032,0,0,0,0,0
72248,0,0,0,0,0
116575,0,0,0,0,0
85190,0,0,0,0,0
85076,0,0,0,0,0
6901,0,0,0,0,0
40355,0,0,0,0,0
24588,0,0,0,0,0
30840,0,0,0,0,0
34031,0,0,0,0,0
55355,5,5,5,0,0
113078,0,0,0,0,0
102468,0,0,0,0,0
21710,0,0,0,0,0
77516,0,0,0,0,0
21654,0,0,0,0,0
109502,0,0,0,0,0
106861,0,0,0,0,0
55875,0,0,0,0,0
25053,0,0,0,0,0
119759,0,0,0,0,0
82280,0,0,0,0,0
54504,0,0,0,0,0
15687,0,0,0,0,0
57727,0,0,0,0,0
104389,0,0,0,0,0
66815,0,0,0,0,0
64727,0,0,0,0,0
84834,0,0,0,0,0
30339,0,0,0,0,0
6821,0,0,0,0,0
13446,0,0,0,0,0
46097,0,0,0,0,0
26483,0,0,0,0,0
106037,0,0,0,0,0
38333,0,0,0,0,0
102640,0,0,0,0,0
1495,0,0,0,0,0
7450,0,0,0,0,0
107333,0,0,0,0,0
18528,0,0,0,0,0
3607,0,0,0,0,0
15258,0,0,0,0,0
64506,0,0,0,0,0
28469,0,0,0,0,0
8541,0,0,0,0,0
101080,0,0,0,0,0
53555,0,0,0,0,0
11928,0,0,0,0,0
75637,0,0,0,0,0
64345,0,0,0,0,0
116280,0,0,0,0,0
85549,0,0,0,0,0
49308,0,0,0,0,0
29144,0,0,0,0,0
13052,0,0,0,0,0
114772,0,0,0,0,0
43261,0,0,0,0,0
28720,0,0,0,0,0
104666,0,0,0,0,0
56304,0,0,0,0,0
14273,0,0,0,0,0
43326,0,0,0,0,0
115283,0,0,0,0,0
49008,0,0,0,0,0
59116,0,0,0,0,0
98553,0,0,0,0,0
36205,0,0,0,0,0
51428,8,8,8,0,0
90602,0,0,0,0,0
93612,0,0,0,0,0
15217,0,0,0,0,0
13874,0,0,0,0,0
26786,0,0,0,0,0
9665,0,0,0,0,0
41032,0,0,0,0,0
113274,0,0,0,0,0
72729,0,0,0,0,0
3362,0,0,0,0,0
82587,0,0,0,0,0
116268,0,0,0,0,0
70355,0,0,0,0,0
118677,0,0,0,0,0
39438,0,0,0,0,0
61655,0,0,0,0,0
79684,0,0,0,0,0
89867,0,0,0,0,0
58034,0,0,0,0,0
99632,0,0,0,0,0
20871,0,0,0,0,0
64719,0,0,0,0,0
111754,0,0,0,0,0
20037,0,0,0,0,0
50386,0,0,0,0,0
90936,0,0,0,0,0
77724,0,0,0,0,0
106690,0,0,0,0,0
65795,0,0,0,0,0
68498,0,0,0,0,0
30931,0,0,0,0,0
90471,0,0,0,0,0
95643,0,0,0,0,0
111332,0,0,0,0,0
44419,0,0,0,0,0
61017,0,0,0,0,0
20779,0,0,0,0,0
102630,0,0,0,0,0
110527,0,0,0,0,0
117341,0,0,0,0,0
34334,0,0,0,0,0
95209,0,0,0,0,0
57203,0,0,0,0,0
107112,0,0,0,0,0
17482,0,0,0,0,0
59995,3,3,3,0,0
95249,0,0,0,0,0
94169,0,0,0,0,0
85511,0,0,0,0,0
119802,0,0,0,0,0
77203,0,0,0,0,0
73618,0,0,0,0,0
98250,0,0,0,0,0
92253,0,0,0,0,0
49875,0,0,0,0,0
60952,0,0,0,0,0
70310,0,0,0,0,0
40400,0,0,0,0,0
91840,1,1,1,0,0
89002,0,0,0,0,0
15384,0,0,0,0,0
60282,0,0,0,0,0
96560,0,0,0,0,0
79688,0,0,0,0,0
58613,0,0,0,0,0
10447,0,0,0,0,0
17896,0,0,0,0,0
49492,0,0,0,0,0
93314,0,0,0,0,0
33359,0,0,0,0,0
37209,0,0,0,0,0
20621,0,0,0,0,0
75027,0,0,0,0,0
94222,0,0,0,0,0
42430,0,0,0,0,0
64175,0,0,0,0,0
73622,0,0,0,0,0
65160,0,0,0,0,0
26121,0,0,0,0,0
102906,0,0,0,0,0
39813,0,0,0,0,0
32165,0,0,0,0,0
111785,0,0,0,0,0
99047,0,0,0,0,0
88620,0,0,0,0,0
19072,0,0,0,0,0
69884,0,0,0,0,0
70724,0,0,0,0,0
83055,0,0,0,0,0
95744,0,0,0,0,0
49093,0,0,0,0,0
74965,0,0,0,0,0
71720,0,0,0,0,0
37904,0,0,0,0,0
117262,0,0,0,0,0
85017,0,0,0,0,0
35421,0,0,0,0,0
10996,0,0,0,0,0
75754,0,0,0,0,0
109166,0,0,0,0,0
53396,0,0,0,0,0
98523,0,0,0,0,0
15573,0,0,0,0,0
90,0,0,0,0,0
16636,0,0,0,0,0
61855,0,0,0,0,0
112943,0,0,0,0,0
97161,0,0,0,0,0
83470,0,0,0,0,0
60348,0,0,0,0,0
59726,0,0,0,0,0
9865,0,0,0,0,0
36561,0,0,0,0,0
52926,0,0,0,0,0
67876,0,0,0,0,0
80863,0,0,0,0,0
47056,0,0,0,0,0
116645,0,0,0,0,0
93889,0,0,0,0,0
89969,0,0,0,0,0
48333,0,0,0,0,0
81995,0,0,0,0,0
112695,0,0,0,0,0
108899,0,0,0,0,0
32704,0,0,0,0,0
63532,0,0,0,0,0
94664,0,0,0,0,0
14309,0,0,0,0,0
6790,0,0,0,0,0
78285,0,0,0,0,0
48448,0,0,0,0,0
76133,0,0,0,0,0
11924,0,0,0,0,0
82385,0,0,0,0,0
53911,0,0,0,0,0
40965,0,0,0,0,0
3823,0,0,0,0,0
91047,0,0,0,0,0
54904,0,0,0,0,0
85000,0,0,0,0,0
48335,0,0,0,0,0
105744,0,0,0,0,0
100881,0,0,0,0,0
37648,0,0,0,0,0
107794,1,1,1,0,0
45740,0,0,0,0,0
105147,0,0,0,0,0
16314,0,0,0,0,0
117080,0,0,0,0,0
46901,0,0,0,0,0
114398,0,0,0,0,0
73765,0,0,0,0,0
117042,0,0,0,0,0
115043,0,0,0,0,0
20139,1,1,1,0,0
35669,0,0,0,0,0
88781,0,0,0,0,0
69265,0,0,0,0,0
93711,0,0,0,0,0
85913,0,0,0,0,0
109796,0,0,0,0,0
46059,0,0,0,0,0
98738,0,0,0,0,0
1981,0,0,0,0,0
81162,0,0,0,0,0
31066,0,0,0,0,0
103479,0,0,0,0,0
47576,0,0,0,0,0
74178,0,0,0,0,0
83085,0,0,0,0,0
8796,0,0,0,0,0
22522,0,0,0,0,0
43298,0,0,0,0,0
103151,0,0,0,0,0
8450,0,0,0,0,0
77981,0,0,0,0,0
83984,0,0,0,0,0
93747,0,0,0,0,0
14477,0,0,0,0,0
31280,0,0,0,0,0
78414,0,0,0,0,0
83363,0,0,0,0,0
33839,0,0,0,0,0
51839,0,0,0,0,0
8694,0,0,0,0,0
45340,0,0,0,0,0
104205,0,0,0,0,0
84671,0,0,0,0,0
32176,0,0,0,0,0
52867,0,0,0,0,0
56565,0,0,0,0,0
75541,0,0,0,0,0
21782,0,0,0,0,0
104875,0,0,0,0,0
13665,0,0,0,0,0
37424,0,0,0,0,0
15969,0,0,0,0,0
24833,0,0,0,0,0
16895,0,0,0,0,0
72341,0,0,0,0,0
76263,0,0,0,0,0
68294,0,0,0,0,0
112407,0,0,0,0,0
71387,0,0,0,0,0
105407,0,0,0,0,0
11938,4,4,4,0,0
38845,0,0,0,0,0
27711,0,0,0,0,0
83790,0,0,0,0,0
46746,0,0,0,0,0
49787,0,0,0,0,0
114251,0,0,0,0,0
112605,0,0,0,0,0
79233,0,0,0,0,0
57100,0,0,0,0,0
66634,0,0,0,0,0
115130,0,0,0,0,0
2316,0,0,0,0,0
46181,0,0,0,0,0
15533,0,0,0,0,0
75613,0,0,0,0,0
7419,0,0,0,0,0
28539,0,0,0,0,0
70699,0,0,0,0,0
94253,0,0,0,0,0
17778,0,0,0,0,0
16772,0,0,0,0,0
83870,0,0,0,0,0
45141,0,0,0,0,0
108048,0,0,0,0,0
104715,0,0,0,0,0
21335,0,0,0,0,0
29578,0,0,0,0,0
112022,0,0,0,0,0
82397,0,0,0,0,0
88377,0,0,0,0,0
4977,0,0,0,0,0
98491,0,0,0,0,0
86102,0,0,0,0,0
94928,0,0,0,0,0
8700,0,0,0,0,0
98676,0,0,0,0,0
105594,0,0,0,0,0
66444,0,0,0,0,0
15742,0,0,0,0,0
92974,0,0,0,0,0
41191,0,0,0,0,0
15872,0,0,0,0,0
20236,0,0,0,0,0
30617,0,0,0,0,0
106411,0,0,0,0,0
82048,0,0,0,0,0
48206,0,0,0,0,0
81674,0,0,0,0,0
42336,2,2,2,0,0
24819,0,0,0,0,0
68263,0,0,0,0,0
106772,0,0,0,0,0
23856,0,0,0,0,0
11538,0,0,0,0,0
117347,0,0,0,0,0
35637,0,0,0,0,0
108144,0,0,0,0,0
3461,0,0,0,0,0
88074,0,0,0,0,0
87551,0,0,0,0,0
52594,0,0,0,0,0
58953,0,0,0,0,0
63516,0,0,0,0,0
75906,0,0,0,0,0
85171,0,0,0,0,0
37856,0,0,0,0,0
113934,0,0,0,0,0
77838,0,0,0,0,0
80597,0,0,0,0,0
38457,0,0,0,0,0
45195,0,0,0,0,0
15871,0,0,0,0,0
106815,0,0,0,0,0
64629,0,0,0,0,0
76771,0,0,0,0,0
116227,0,0,0,0,0
97781,1,1,1,0,0
108387,0,0,0,0,0
3088,0,0,0,0,0
114300,0,0,0,0,0
39776,0,0,0,0,0
117582,0,0,0,0,0
57963,0,0,0,0,0
35485,0,0,0,0,0
84997,0,0,0,0,0
2870,0,0,0,0,0
110334,0,0,0,0,0
46775,0,0,0,0,0
89876,0,0,0,0,0
37738,0,0,0,0,0
31128,0,0,0,0,0
97892,0,0,0,0,0
92419,0,0,0,0,0
16279,0,0,0,0,0
16966,0,0,0,0,0
9618,0,0,0,0,0
13914,0,0,0,0,0
32205,0,0,0,0,0
4293,5,5,5,0,0
639,0,0,0,0,0
113951,0,0,0,0,0
10962,0,0,0,0,0
44415,0,0,0,0,0
10597,0,0,0,0,0
25622,0,0,0,0,0
78087,0,0,0,0,0
86776,0,0,0,0,0
6943,0,0,0,0,0
75913,0,0,0,0,0
49149,0,0,0,0,0
96393,0,0,0,0,0
19241,0,0,0,0,0
45263,0,0,0,0,0
110477,0,0,0,0,0
74437,0,0,0,0,0
40851,0,0,0,0,0
64088,0,0,0,0,0
15054,0,0,0,0,0
117678,0,0,0,0,0
34316,0,0,0,0,0
3714,0,0,0,0,0
63792,0,0,0,0,0
74291,0,0,0,0,0
106322,0,0,0,0,0
96475,0,0,0,0,0
13762,0,0,0,0,0
67968,0,0,0,0,0
67335,0,0,0,0,0
7410,0,0,0,0,0
56594,0,0,0,0,0
109362,0,0,0,0,0
42224,0,0,0,0,0
13545,0,0,0,0,0
108234,0,0,0,0,0
27431,0,0,0,0,0
94675,0,0,0,0,0
53343,0,0,0,0,0
56753,0,0,0,0,0
117574,0,0,0,0,0
20523,0,0,0,0,0
64262,0,0,0,0,0
111224,0,0,0,0,0
99517,0,0,0,0,0
102910,0,0,0,0,0
49086,0,0,0,0,0
106859,0,0,0,0,0
66455,0,0,0,0,0
87132,0,0,0,0,0
100840,0,0,0,0,0
44854,0,0,0,0,0
95444,0,0,0,0,0
12556,0,0,0,0,0
47027,0,0,0,0,0
87908,0,0,0,0,0
34247,0,0,0,0,0
117114,0,0,0,0,0
117683,0,0,0,0,0
116021,0,0,0,0,0
21260,0,0,0,0,0
24337,0,0,0,0,0
7597,1,1,1,0,0
35836,0,0,0,0,0
88062,0,0,0,0,0
5716,0,0,0,0,0
99491,0,0,0,0,0
27708,0,0,0,0,0
35928,0,0,0,0,0
116642,0,0,0,0,0
93264,0,0,0,0,0
49974,0,0,0,0,0
118687,0,0,0,0,0
49527,0,0,0,0,0
46285,0,0,0,0,0
63892,0,0,0,0,0
35912,0,0,0,0,0
64322,0,0,0,0,0
93325,0,0,0,0,0
3090,0,0,0,0,0
73268,0,0,0,0,0
19738,0,0,0,0,0
43311,0,0,0,0,0
5758,0,0,0,0,0
69913,0,0,0,0,0
103939,0,0,0,0,0
79311,0,0,0,0,0
8707,0,0,0,0,0
68114,0,0,0,0,0
47905,0,0,0,0,0
23895,0,0,0,0,0
69181,0,0,0,0,0
94902,0,0,0,0,0
88896,0,0,0,0,0
34249,0,0,0,0,0
104479,0,0,0,0,0
62298,0,0,0,0,0
100495,0,0,0,0,0
100321,0,0,0,0,0
105851,0,0,0,0,0
117092,0,0,0,0,0
35365,0,0,0,0,0
45367,0,0,0,0,0
103377,0,0,0,0,0
50550,0,0,0,0,0
29546,0,0,0,0,0
114203,0,0,0,0,0
90645,0,0,0,0,0
119941,0,0,0,0,0
60024,0,0,0,0,0
55582,0,0,0,0,0
37730,0,0,0,0,0
76089,0,0,0,0,0
11589,0,0,0,0,0
32047,0,0,0,0,0
44434,0,0,0,0,0
120553,0,0,0,0,0
28848,0,0,0,0,0
6669,0,0,0,0,0
36210,0,0,0,0,0
27383,0,0,0,0,0
26533,2,2,2,0,0
59533,0,0,0,0,0
87548,0,0,0,0,0
33595,0,0,0,0,0
106121,0,0,0,0,0
112390,0,0,0,0,0
7881,0,0,0,0,0
109152,0,0,0,0,0
68370,0,0,0,0,0
76375,0,0,0,0,0
83091,0,0,0,0,0
110,0,0,0,0,0
61541,0,0,0,0,0
59047,0,0,0,0,0
84906,0,0,0,0,0
91107,0,0,0,0,0
14509,0,0,0,0,0
35664,0,0,0,0,0
72894,0,0,0,0,0
92070,0,0,0,0,0
60787,0,0,0,0,0
79493,0,0,0,0,0
31374,0,0,0,0,0
16674,0,0,0,0,0
70085,0,0,0,0,0
4723,0,0,0,0,0
89133,0,0,0,0,0
85010,0,0,0,0,0
14006,0,0,0,0,0
69500,0,0,0,0,0
98158,0,0,0,0,0
36118,0,0,0,0,0
67998,0,0,0,0,0
8495,0,0,0,0,0
86847,0,0,0,0,0
77077,0,0,0,0,0
116719,0,0,0,0,0
20968,0,0,0,0,0
53280,0,0,0,0,0
86358,0,0,0,0,0
28409,0,0,0,0,0
93081,0,0,0,0,0
23108,0,0,0,0,0
5605,0,0,0,0,0
55440,0,0,0,0,0
18753,0,0,0,0,0
85436,0,0,0,0,0
54068,0,0,0,0,0
8225,0,0,0,0,0
78685,0,0,0,0,0
77848,0,0,0,0,0
27853,0,0,0,0,0
63662,0,0,0,0,0
81179,0,0,0,0,0
53540,0,0,0,0,0
10320,0,0,0,0,0
118723,0,0,0,0,0
67528,0,0,0,0,0
98072,0,0,0,0,0
57743,0,0,0,0,0
76415,0,0,0,0,0
104665,0,0,0,0,0
72188,0,0,0,0,0
40031,0,0,0,0,0
76435,0,0,0,0,0
82630,0,0,0,0,0
118938,0,0,0,0,0
113166,0,0,0,0,0
32097,0,0,0,0,0
8193,0,0,0,0,0
108709,0,0,0,0,0
68611,0,0,0,0,0
44755,0,0,0,0,0
72822,0,0,0,0,0
55799,0,0,0,0,0
26027,0,0,0,0,0
61685,0,0,0,0,0
114526,0,0,0,0,0
117839,0,0,0,0,0
111842,0,0,0,0,0
117892,0,0,0,0,0
8595,0,0,0,0,0
14235,0,0,0,0,0
75234,0,0,0,0,0
118459,0,0,0,0,0
39293,0,0,0,0,0
10338,0,0,0,0,0
1723,0,0,0,0,0
50172,0,0,0,0,0
62061,1,1,1,0,0
89414,0,0,0,0,0
38090,0,0,0,0,0
45439,0,0,0,0,0
19008,1,1,1,0,0
11522,0,0,0,0,0
2362,0,0,0,0,0
24756,0,0,0,0,0
32941,0,0,0,0,0
29085,0,0,0,0,0
85176,0,0,0,0,0
22761,0,0,0,0,0
110820,0,0,0,0,0
101974,0,0,0,0,0
68770,0,0,0,0,0
39654,0,0,0,0,0
71060,0,0,0,0,0
62684,0,0,0,0,0
14263,0,0,0,0,0
107840,0,0,0,0,0
88412,0,0,0,0,0
28069,0,0,0,0,0
58979,0,0,0,0,0
30749,0,0,0,0,0
102149,0,0,0,0,0
27236,0,0,0,0,0
63347,0,0,0,0,0
115260,0,0,0,0,0
90140,0,0,0,0,0
21893,0,0,0,0,0
42212,0,0,0,0,0
81964,0,0,0,0,0
16515,0,0,0,0,0
470,0,0,0,0,0
95739,0,0,0,0,0
79050,0,0,0,0,0
108598,0,0,0,0,0
75711,0,0,0,0,0
103756,1,1,1,0,0
100789,0,0,0,0,0
19102,0,0,0,0,0
7101,0,0,0,0,0
67269,0,0,0,0,0
94877,0,0,0,0,0
98940,0,0,0,0,0
76808,0,0,0,0,0
33712,0,0,0,0,0
52366,0,0,0,0,0
5584,1,1,1,0,0
8067,0,0,0,0,0
100799,0,0,0,0,0
87501,0,0,0,0,0
53451,0,0,0,0,0
38352,0,0,0,0,0
58611,7,7,7,0,0
78640,0,0,0,0,0
11652,0,0,0,0,0
18975,0,0,0,0,0
13847,0,0,0,0,0
6413,0,0,0,0,0
71164,0,0,0,0,0
91737,0,0,0,0,0
82737,0,0,0,0,0
92866,1,1,1,0,0
6177,0,0,0,0,0
31137,0,0,0,0,0
12422,0,0,0,0,0
92012,0,0,0,0,0
49760,0,0,0,0,0
23563,0,0,0,0,0
76502,0,0,0,0,0
90938,0,0,0,0,0
58637,0,0,0,0,0
93937,0,0,0,0,0
36175,0,0,0,0,0
75073,0,0,0,0,0
104998,0,0,0,0,0
95248,1,1,1,0,0
9890,0,0,0,0,0
80262,0,0,0,0,0
82527,0,0,0,0,0
54679,0,0,0,0,0
43972,0,0,0,0,0
529,0,0,0,0,0
60687,0,0,0,0,0
103808,0,0,0,0,0
39733,0,0,0,0,0
50912,0,0,0,0,0
3001,0,0,0,0,0
83021,0,0,0,0,0
19143,0,0,0,0,0
85027,0,0,0,0,0
32072,0,0,0,0,0
78834,0,0,0,0,0
30121,0,0,0,0,0
39505,0,0,0,0,0
63296,0,0,0,0,0
73307,0,0,0,0,0
48006,0,0,0,0,0
75746,0,0,0,0,0
7249,0,0,0,0,0
62538,0,0,0,0,0
52763,0,0,0,0,0
55543,0,0,0,0,0
103913,0,0,0,0,0
29973,0,0,0,0,0
108103,0,0,0,0,0
76920,0,0,0,0,0
110983,0,0,0,0,0
59433,0,0,0,0,0
58070,0,0,0,0,0
47361,0,0,0,0,0
96132,0,0,0,0,0
106336,0,0,0,0,0
56509,0,0,0,0,0
62375,0,0,0,0,0
18418,0,0,0,0,0
67587,0,0,0,0,0
82554,0,0,0,0,0
56667,0,0,0,0,0
93390,0,0,0,0,0
98634,0,0,0,0,0
24274,0,0,0,0,0
47057,0,0,0,0,0
1577,0,0,0,0,0
102746,0,0,0,0,0
69116,0,0,0,0,0
85640,0,0,0,0,0
31786,0,0,0,0,0
10204,0,0,0,0,0
463,0,0,0,0,0
114950,0,0,0,0,0
31296,0,0,0,0,0
27734,0,0,0,0,0
73118,0,0,0,0,0
50097,0,0,0,0,0
16711,0,0,0,0,0
72187,0,0,0,0,0
22320,0,0,0,0,0
42857,0,0,0,0,0
25969,0,0,0,0,0
95129,0,0,0,0,0
23210,0,0,0,0,0
31005,0,0,0,0,0
74668,0,0,0,0,0
45653,0,0,0,0,0
29017,0,0,0,0,0
100185,0,0,0,0,0
82336,0,0,0,0,0
43497,0,0,0,0,0
69598,0,0,0,0,0
37564,0,0,0,0,0
6101,0,0,0,0,0
6366,0,0,0,0,0
69384,0,0,0,0,0
24540,0,0,0,0,0
101554,0,0,0,0,0
58434,0,0,0,0,0
8514,0,0,0,0,0
113794,0,0,0,0,0
9374,0,0,0,0,0
32767,0,0,0,0,0
75469,0,0,0,0,0
75528,0,0,0,0,0
117974,0,0,0,0,0
60397,0,0,0,0,0
75846,0,0,0,0,0
29860,0,0,0,0,0
16344,0,0,0,0,0
33714,0,0,0,0,0
90348,0,0,0,0,0
76716,0,0,0,0,0
40397,0,0,0,0,0
17509,0,0,0,0,0
120518,0,0,0,0,0
31535,0,0,0,0,0
16851,0,0,0,0,0
85861,0,0,0,0,0
1733,0,0,0,0,0
5866,0,0,0,0,0
32445,0,0,0,0,0
108877,0,0,0,0,0
95948,0,0,0,0,0
99017,0,0,0,0,0
109046,0,0,0,0,0
105104,0,0,0,0,0
90922,0,0,0,0,0
117266,0,0,0,0,0
10484,0,0,0,0,0
77651,0,0,0,0,0
64239,0,0,0,0,0
47655,0,0,0,0,0
47090,0,0,0,0,0
78752,0,0,0,0,0
107490,1,1,1,0,0
79969,0,0,0,0,0
66874,0,0,0,0,0
113266,0,0,0,0,0
120326,0,0,0,0,0
24673,0,0,0,0,0
100397,0,0,0,0,0
6766,0,0,0,0,0
93845,0,0,0,0,0
81921,0,0,0,0,0
71888,0,0,0,0,0
33234,0,0,0,0,0
17114,0,0,0,0,0
43408,0,0,0,0,0
106163,0,0,0,0,0
71644,0,0,0,0,0
116640,0,0,0,0,0
9272,0,0,0,0,0
90733,0,0,0,0,0
101934,0,0,0,0,0
88069,0,0,0,0,0
110023,0,0,0,0,0
61184,0,0,0,0,0
31678,0,0,0,0,0
104602,0,0,0,0,0
87993,0,0,0,0,0
39042,0,0,0,0,0
102892,0,0,0,0,0
49733,0,0,0,0,0
28313,0,0,0,0,0
50356,0,0,0,0,0
68599,0,0,0,0,0
119732,0,0,0,0,0
18864,0,0,0,0,0
86877,0,0,0,0,0
72658,0,0,0,0,0
92445,0,0,0,0,0
25372,0,0,0,0,0
18579,0,0,0,0,0
113343,0,0,0,0,0
110166,0,0,0,0,0
92350,0,0,0,0,0
103067,0,0,0,0,0
79631,0,0,0,0,0
57865,0,0,0,0,0
2690,0,0,0,0,0
84164,0,0,0,0,0
20799,0,0,0,0,0
39267,0,0,0,0,0
75964,0,0,0,0,0
38181,0,0,0,0,0
37599,0,0,0,0,0
3775,0,0,0,0,0
51463,0,0,0,0,0
19351,0,0,0,0,0
42194,0,0,0,0,0
106547,0,0,0,0,0
76409,0,0,0,0,0
115274,0,0,0,0,0
9791,0,0,0,0,0
113608,0,0,0,0,0
85247,0,0,0,0,0
105153,0,0,0,0,0
82471,0,0,0,0,0
51429,0,0,0,0,0
84166,0,0,0,0,0
12528,0,0,0,0,0
14251,0,0,0,0,0
57194,0,0,0,0,0
111121,0,0,0,0,0
94758,0,0,0,0,0
5134,0,0,0,0,0
67183,0,0,0,0,0
58347,0,0,0,0,0
8060,0,0,0,0,0
20134,0,0,0,0,0
34572,0,0,0,0,0
39220,0,0,0,0,0
34044,0,0,0,0,0
105457,0,0,0,0,0
39628,0,0,0,0,0
109621,0,0,0,0,0
78885,0,0,0,0,0
61871,0,0,0,0,0
76904,0,0,0,0,0
70632,0,0,0,0,0
63320,0,0,0,0,0
81205,0,0,0,0,0
46002,0,0,0,0,0
87417,0,0,0,0,0
73977,0,0,0,0,0
5598,0,0,0,0,0
2642,0,0,0,0,0
7861,0,0,0,0,0
35845,0,0,0,0,0
52151,0,0,0,0,0
60493,0,0,0,0,0
33837,0,0,0,0,0
22424,0,0,0,0,0
114860,0,0,0,0,0
16090,0,0,0,0,0
115507,0,0,0,0,0
3051,0,0,0,0,0
67086,0,0,0,0,0
92454,0,0,0,0,0
57087,0,0,0,0,0
59326,0,0,0,0,0
31167,0,0,0,0,0
82723,0,0,0,0,0
94999,0,0,0,0,0
39748,0,0,0,0,0
54080,0,0,0,0,0
85889,0,0,0,0,0
107938,0,0,0,0,0
6247,0,0,0,0,0
113514,0,0,0,0,0
103078,0,0,0,0,0
882,0,0,0,0,0
43560,0,0,0,0,0
55067,0,0,0,0,0
64580,0,0,0,0,0
51403,0,0,0,0,0
77966,0,0,0,0,0
111104,0,0,0,0,0
68625,0,0,0,0,0
94990,0,0,0,0,0
101445,0,0,0,0,0
1558,0,0,0,0,0
75318,0,0,0,0,0
73959,0,0,0,0,0
90203,0,0,0,0,0
70847,0,0,0,0,0
65155,2,2,2,0,0
61621,0,0,0,0,0
69606,0,0,0,0,0
1866,0,0,0,0,0
15454,0,0,0,0,0
72848,0,0,0,0,0
113820,1,1,1,0,0
20418,0,0,0,0,0
84345,0,0,0,0,0
90080,0,0,0,0,0
41163,0,0,0,0,0
15485,0,0,0,0,0
878,0,0,0,0,0
67366,0,0,0,0,0
27959,0,0,0,0,0
69206,0,0,0,0,0
87180,0,0,0,0,0
66202,0,0,0,0,0
7778,0,0,0,0,0
92919,0,0,0,0,0
89690,0,0,0,0,0
50443,0,0,0,0,0
114500,0,0,0,0,0
31560,0,0,0,0,0
92599,0,0,0,0,0
12270,0,0,0,0,0
86135,0,0,0,0,0
63357,0,0,0,0,0
99168,0,0,0,0,0
33574,0,0,0,0,0
114096,0,0,0,0,0
97599,0,0,0,0,0
97067,0,0,0,0,0
67058,0,0,0,0,0
102146,0,0,0,0,0
42074,0,0,0,0,0
30938,0,0,0,0,0
79336,0,0,0,0,0
109282,0,0,0,0,0
94395,0,0,0,0,0
2081,0,0,0,0,0
15932,0,0,0,0,0
117564,0,0,0,0,0
79791,0,0,0,0,0
64206,0,0,0,0,0
8199,0,0,0,0,0
56284,0,0,0,0,0
105310,0,0,0,0,0
104638,0,0,0,0,0
73804,0,0,0,0,0
79526,0,0,0,0,0
66796,0,0,0,0,0
97158,0,0,0,0,0
50212,0,0,0,0,0
56183,0,0,0,0,0
81529,0,0,0,0,0
17399,0,0,0,0,0
25117,0,0,0,0,0
74921,0,0,0,0,0
59307,0,0,0,0,0
74886,0,0,0,0,0
113027,0,0,0,0,0
60426,0,0,0,0,0
36249,0,0,0,0,0
72306,0,0,0,0,0
14177,0,0,0,0,0
22372,0,0,0,0,0
49255,0,0,0,0,0
18654,0,0,0,0,0
76935,1,1,1,0,0
60696,0,0,0,0,0
11453,0,0,0,0,0
73421,0,0,0,0,0
98150,0,0,0,0,0
69214,0,0,0,0,0
115086,0,0,0,0,0
27252,0,0,0,0,0
45397,0,0,0,0,0
106909,0,0,0,0,0
60464,0,0,0,0,0
25559,0,0,0,0,0
19159,1,1,1,0,0
115407,0,0,0,0,0
38715,0,0,0,0,0
33475,0,0,0,0,0
114327,0,0,0,0,0
60317,0,0,0,0,0
99872,0,0,0,0,0
11164,0,0,0,0,0
39046,0,0,0,0,0
28518,0,0,0,0,0
102734,0,0,0,0,0
65702,0,0,0,0,0
71745,0,0,0,0,0
118621,0,0,0,0,0
23247,0,0,0,0,0
33917,0,0,0,0,0
7347,0,0,0,0,0
77644,0,0,0,0,0
12170,0,0,0,0,0
93596,0,0,0,0,0
88977,0,0,0,0,0
24148,0,0,0,0,0
70525,0,0,0,0,0
88768,0,0,0,0,0
79709,0,0,0,0,0
23458,0,0,0,0,0
54803,0,0,0,0,0
9459,0,0,0,0,0
106753,0,0,0,0,0
65756,0,0,0,0,0
24472,0,0,0,0,0
112079,0,0,0,0,0
105037,0,0,0,0,0
34192,0,0,0,0,0
68965,0,0,0,0,0
63127,0,0,0,0,0
50805,0,0,0,0,0
83818,0,0,0,0,0
72001,0,0,0,0,0
115583,0,0,0,0,0
115596,0,0,0,0,0
109205,0,0,0,0,0
74962,0,0,0,0,0
14001,0,0,0,0,0
94789,0,0,0,0,0
67311,0,0,0,0,0
105612,0,0,0,0,0
16154,0,0,0,0,0
41392,0,0,0,0,0
87712,0,0,0,0,0
70980,0,0,0,0,0
11542,0,0,0,0,0
29068,0,0,0,0,0
84060,0,0,0,0,0
90097,0,0,0,0,0
93434,0,0,0,0,0
56285,0,0,0,0,0
85977,0,0,0,0,0
56384,0,0,0,0,0
11856,0,0,0,0,0
28608,0,0,0,0,0
43173,0,0,0,0,0
119084,0,0,0,0,0
84995,0,0,0,0,0
86176,0,0,0,0,0
14073,0,0,0,0,0
73254,0,0,0,0,0
55842,0,0,0,0,0
45870,0,0,0,0,0
87561,0,0,0,0,0
101128,0,0,0,0,0
81553,0,0,0,0,0
96707,0,0,0,0,0
100432,0,0,0,0,0
61985,0,0,0,0,0
10904,0,0,0,0,0
51019,0,0,0,0,0
109240,0,0,0,0,0
82359,0,0,0,0,0
49310,0,0,0,0,0
66968,0,0,0,0,0
99546,0,0,0,0,0
33641,1,1,1,0,0
23158,0,0,0,0,0
29865,0,0,0,0,0
78956,0,0,0,0,0
84815,0,0,0,0,0
24376,0,0,0,0,0
73476,0,0,0,0,0
9914,0,0,0,0,0
15029,0,0,0,0,0
42045,0,0,0,0,0
6253,0,0,0,0,0
15966,0,0,0,0,0
80402,0,0,0,0,0
34761,0,0,0,0,0
27826,0,0,0,0,0
5604,0,0,0,0,0
26801,0,0,0,0,0
85723,0,0,0,0,0
109671,0,0,0,0,0
15089,0,0,0,0,0
42648,0,0,0,0,0
81278,0,0,0,0,0
33238,0,0,0,0,0
42323,1,1,1,0,0
16394,0,0,0,0,0
116449,0,0,0,0,0
55030,0,0,0,0,0
47148,1,1,1,0,0
117415,0,0,0,0,0
38388,0,0,0,0,0
97223,1,1,1,0,0
39446,0,0,0,0,0
39150,0,0,0,0,0
94624,0,0,0,0,0
27020,0,0,0,0,0
82672,0,0,0,0,0
81719,0,0,0,0,0
115459,0,0,0,0,0
59904,0,0,0,0,0
64462,0,0,0,0,0
92967,0,0,0,0,0
7391,0,0,0,0,0
51290,0,0,0,0,0
61470,0,0,0,0,0
23881,0,0,0,0,0
78120,0,0,0,0,0
81090,0,0,0,0,0
95048,0,0,0,0,0
100237,2,2,2,0,0
119582,0,0,0,0,0
93000,0,0,0,0,0
41155,0,0,0,0,0
27927,0,0,0,0,0
119598,0,0,0,0,0
46296,0,0,0,0,0
48511,0,0,0,0,0
88706,0,0,0,0,0
104854,0,0,0,0,0
114893,0,0,0,0,0
31701,0,0,0,0,0
27785,0,0,0,0,0
105813,0,0,0,0,0
62784,0,0,0,0,0
104702,0,0,0,0,0
104266,0,0,0,0,0
12834,0,0,0,0,0
41359,0,0,0,0,0
83265,0,0,0,0,0
69544,0,0,0,0,0
106871,0,0,0,0,0
42678,0,0,0,0,0
999,0,0,0,0,0
115626,0,0,0,0,0
6120,2,2,2,0,0
67846,0,0,0,0,0
68152,0,0,0,0,0
55597,0,0,0,0,0
69417,0,0,0,0,0
89022,3,3,3,0,0
100489,0,0,0,0,0
71809,0,0,0,0,0
11266,0,0,0,0,0
112474,0,0,0,0,0
56529,0,0,0,0,0
110264,0,0,0,0,0
53883,0,0,0,0,0
22295,0,0,0,0,0
18841,0,0,0,0,0
101052,0,0,0,0,0
90429,0,0,0,0,0
74892,0,0,0,0,0
107592,0,0,0,0,0
32468,0,0,0,0,0
15545,0,0,0,0,0
37104,0,0,0,0,0
3372,0,0,0,0,0
9753,0,0,0,0,0
112485,0,0,0,0,0
2780,0,0,0,0,0
94724,0,0,0,0,0
54384,0,0,0,0,0
65534,0,0,0,0,0
4931,0,0,0,0,0
111856,0,0,0,0,0
108925,0,0,0,0,0
21180,0,0,0,0,0
62340,0,0,0,0,0
4453,0,0,0,0,0
19716,0,0,0,0,0
113243,0,0,0,0,0
65164,0,0,0,0,0
9715,0,0,0,0,0
49001,0,0,0,0,0
109339,0,0,0,0,0
4762,0,0,0,0,0
47918,0,0,0,0,0
9183,0,0,0,0,0
28813,0,0,0,0,0
63621,0,0,0,0,0
100196,0,0,0,0,0
8087,0,0,0,0,0
13676,0,0,0,0,0
25438,0,0,0,0,0
58436,0,0,0,0,0
66290,0,0,0,0,0
66561,0,0,0,0,0
58919,0,0,0,0,0
100971,0,0,0,0,0
18895,0,0,0,0,0
48204,1,1,1,0,0
73988,0,0,0,0,0
58441,0,0,0,0,0
66377,0,0,0,0,0
57336,0,0,0,0,0
35513,0,0,0,0,0
10705,0,0,0,0,0
73843,0,0,0,0,0
116888,0,0,0,0,0
67897,0,0,0,0,0
109619,0,0,0,0,0
63349,0,0,0,0,0
65564,0,0,0,0,0
51334,0,0,0,0,0
29057,0,0,0,0,0
16310,0,0,0,0,0
21060,2,2,2,0,0
100529,0,0,0,0,0
46949,0,0,0,0,0
70687,0,0,0,0,0
47040,0,0,0,0,0
114003,0,0,0,0,0
17824,0,0,0,0,0
83773,0,0,0,0,0
22341,0,0,0,0,0
86969,0,0,0,0,0
44906,3,3,3,0,0
17284,0,0,0,0,0
115908,0,0,0,0,0
67208,1,1,1,0,0
4569,0,0,0,0,0
74942,0,0,0,0,0
106284,0,0,0,0,0
4898,0,0,0,0,0
25899,0,0,0,0,0
107613,0,0,0,0,0
7976,0,0,0,0,0
6512,0,0,0,0,0
100269,0,0,0,0,0
90709,0,0,0,0,0
106481,0,0,0,0,0
60356,0,0,0,0,0
7768,0,0,0,0,0
56290,0,0,0,0,0
46189,0,0,0,0,0
104976,0,0,0,0,0
78508,0,0,0,0,0
73953,0,0,0,0,0
93546,0,0,0,0,0
47325,0,0,0,0,0
103739,0,0,0,0,0
102931,0,0,0,0,0
82353,0,0,0,0,0
117877,0,0,0,0,0
104118,0,0,0,0,0
21837,0,0,0,0,0
87817,0,0,0,0,0
117374,0,0,0,0,0
91008,0,0,0,0,0
83242,0,0,0,0,0
107809,0,0,0,0,0
57070,0,0,0,0,0
84753,0,0,0,0,0
52231,0,0,0,0,0
52247,0,0,0,0,0
30577,0,0,0,0,0
11490,0,0,0,0,0
94171,0,0,0,0,0
12454,0,0,0,0,0
61252,0,0,0,0,0
83821,0,0,0,0,0
72635,0,0,0,0,0
117507,0,0,0,0,0
68273,0,0,0,0,0
71227,0,0,0,0,0
84266,0,0,0,0,0
68211,0,0,0,0,0
9077,0,0,0,0,0
35839,0,0,0,0,0
45428,0,0,0,0,0
105029,0,0,0,0,0
30575,0,0,0,0,0
74818,0,0,0,0,0
102655,0,0,0,0,0
46737,0,0,0,0,0
94165,0,0,0,0,0
55558,0,0,0,0,0
113151,0,0,0,0,0
15247,0,0,0,0,0
72155,0,0,0,0,0
83379,0,0,0,0,0
25498,0,0,0,0,0
96404,0,0,0,0,0
99622,0,0,0,0,0
9079,0,0,0,0,0
98808,0,0,0,0,0
65632,0,0,0,0,0
65984,0,0,0,0,0
109590,0,0,0,0,0
92583,0,0,0,0,0
44886,0,0,0,0,0
90578,0,0,0,0,0
20009,0,0,0,0,0
96858,0,0,0,0,0
76233,0,0,0,0,0
24730,0,0,0,0,0
23005,0,0,0,0,0
75043,0,0,0,0,0
73909,0,0,0,0,0
51776,0,0,0,0,0
40124,0,0,0,0,0
42642,0,0,0,0,0
54647,0,0,0,0,0
103024,0,0,0,0,0
6830,0,0,0,0,0
30157,0,0,0,0,0
100837,0,0,0,0,0
33723,0,0,0,0,0
115324,0,0,0,0,0
85335,0,0,0,0,0
63593,0,0,0,0,0
22902,0,0,0,0,0
52634,0,0,0,0,0
77835,0,0,0,0,0
100768,0,0,0,0,0
6528,0,0,0,0,0
96795,0,0,0,0,0
64857,0,0,0,0,0
55577,0,0,0,0,0
37400,0,0,0,0,0
70694,0,0,0,0,0
116960,0,0,0,0,0
79754,0,0,0,0,0
65292,0,0,0,0,0
19528,0,0,0,0,0
4033,0,0,0,0,0
87223,0,0,0,0,0
88621,0,0,0,0,0
101910,0,0,0,0,0
64737,0,0,0,0,0
88802,0,0,0,0,0
101271,0,0,0,0,0
67733,0,0,0,0,0
39218,0,0,0,0,0
80090,0,0,0,0,0
10583,0,0,0,0,0
101582,0,0,0,0,0
101069,0,0,0,0,0
91670,0,0,0,0,0
42970,0,0,0,0,0
30524,1,1,1,0,0
17198,0,0,0,0,0
2218,0,0,0,0,0
77038,0,0,0,0,0
23398,0,0,0,0,0
23253,0,0,0,0,0
102302,0,0,0,0,0
12733,0,0,0,0,0
14635,0,0,0,0,0
14149,0,0,0,0,0
86621,0,0,0,0,0
74771,0,0,0,0,0
56988,0,0,0,0,0
48494,0,0,0,0,0
107946,0,0,0,0,0
96487,0,0,0,0,0
101189,0,0,0,0,0
62617,0,0,0,0,0
27050,0,0,0,0,0
28609,0,0,0,0,0
54240,0,0,0,0,0
35749,0,0,0,0,0
15989,0,0,0,0,0
39383,0,0,0,0,0
64877,0,0,0,0,0
109417,0,0,0,0,0
14614,0,0,0,0,0
12916,0,0,0,0,0
65420,0,0,0,0,0
101979,1,1,1,0,0
3411,0,0,0,0,0
54952,0,0,0,0,0
36163,0,0,0,0,0
99477,0,0,0,0,0
35789,0,0,0,0,0
95315,0,0,0,0,0
43271,1,1,1,0,0
93636,0,0,0,0,0
34041,0,0,0,0,0
14753,0,0,0,0,0
71147,0,0,0,0,0
82188,0,0,0,0,0
24960,0,0,0,0,0
6677,0,0,0,0,0
70682,0,0,0,0,0
40875,0,0,0,0,0
70082,0,0,0,0,0
37272,0,0,0,0,0
78947,0,0,0,0,0
90931,0,0,0,0,0
94391,0,0,0,0,0
112798,0,0,0,0,0
30777,0,0,0,0,0
50401,0,0,0,0,0
15499,0,0,0,0,0
102298,0,0,0,0,0
5473,0,0,0,0,0
93849,0,0,0,0,0
14570,0,0,0,0,0
28097,0,0,0,0,0
44000,0,0,0,0,0
115514,0,0,0,0,0
8584,0,0,0,0,0
37453,0,0,0,0,0
17889,0,0,0,0,0
23397,0,0,0,0,0
95331,0,0,0,0,0
93459,0,0,0,0,0
48622,0,0,0,0,0
49085,0,0,0,0,0
37976,0,0,0,0,0
11008,0,0,0,0,0
98050,0,0,0,0,0
108251,0,0,0,0,0
19667,0,0,0,0,0
43027,0,0,0,0,0
2793,0,0,0,0,0
88490,0,0,0,0,0
100072,0,0,0,0,0
13262,0,0,0,0,0
75589,0,0,0,0,0
69000,0,0,0,0,0
106132,0,0,0,0,0
32986,0,0,0,0,0
107739,0,0,0,0,0
18389,0,0,0,0,0
11251,0,0,0,0,0
116196,0,0,0,0,0
107724,0,0,0,0,0
94117,1,1,1,0,0
116273,0,0,0,0,0
115621,0,0,0,0,0
100729,0,0,0,0,0
104861,0,0,0,0,0
58685,0,0,0,0,0
101315,0,0,0,0,0
118175,0,0,0,0,0
97607,0,0,0,0,0
47892,1,1,1,0,0
95615,0,0,0,0,0
38152,0,0,0,0,0
5522,0,0,0,0,0
40761,0,0,0,0,0
19602,0,0,0,0,0
52773,0,0,0,0,0
103850,0,0,0,0,0
64768,0,0,0,0,0
93635,0,0,0,0,0
63272,0,0,0,0,0
35027,0,0,0,0,0
44576,0,0,0,0,0
48154,0,0,0,0,0
45021,0,0,0,0,0
117879,0,0,0,0,0
43849,0,0,0,0,0
39034,0,0,0,0,0
14091,0,0,0,0,0
105031,0,0,0,0,0
107058,0,0,0,0,0
90040,0,0,0,0,0
98954,0,0,0,0,0
52059,0,0,0,0,0
52685,0,0,0,0,0
1282,0,0,0,0,0
79247,0,0,0,0,0
47521,0,0,0,0,0
118585,0,0,0,0,0
4756,0,0,0,0,0
11235,0,0,0,0,0
86263,0,0,0,0,0
19078,0,0,0,0,0
68612,0,0,0,0,0
101759,0,0,0,0,0
50735,0,0,0,0,0
19611,0,0,0,0,0
53264,0,0,0,0,0
26641,0,0,0,0,0
25759,0,0,0,0,0
120006,0,0,0,0,0
105487,0,0,0,0,0
17474,0,0,0,0,0
86583,1,1,1,0,0
113159,0,0,0,0,0
98054,0,0,0,0,0
112873,0,0,0,0,0
84319,0,0,0,0,0
41411,0,0,0,0,0
22720,0,0,0,0,0
54924,0,0,0,0,0
28696,0,0,0,0,0
92585,0,0,0,0,0
67538,0,0,0,0,0
64769,0,0,0,0,0
106945,0,0,0,0,0
94976,0,0,0,0,0
65797,0,0,0,0,0
94686,0,0,0,0,0
24888,0,0,0,0,0
90486,0,0,0,0,0
46979,0,0,0,0,0
75648,0,0,0,0,0
110762,0,0,0,0,0
33688,0,0,0,0,0
99013,0,0,0,0,0
63040,0,0,0,0,0
61915,0,0,0,0,0
95586,0,0,0,0,0
29096,0,0,0,0,0
58183,0,0,0,0,0
71521,0,0,0,0,0
4283,0,0,0,0,0
69123,0,0,0,0,0
48960,3,3,3,0,0
93704,0,0,0,0,0
99345,0,0,0,0,0
94959,0,0,0,0,0
29220,0,0,0,0,0
43550,0,0,0,0,0
59522,0,0,0,0,0
57752,0,0,0,0,0
68076,0,0,0,0,0
31179,0,0,0,0,0
69770,0,0,0,0,0
65206,0,0,0,0,0
115954,0,0,0,0,0
94513,0,0,0,0,0
95973,0,0,0,0,0
8781,0,0,0,0,0
58836,0,0,0,0,0
10728,0,0,0,0,0
115031,0,0,0,0,0
57991,0,0,0,0,0
75968,0,0,0,0,0
22371,0,0,0,0,0
77618,0,0,0,0,0
65050,0,0,0,0,0
77571,0,0,0,0,0
75402,0,0,0,0,0
40862,0,0,0,0,0
101186,1,1,1,0,0
3603,0,0,0,0,0
109892,0,0,0,0,0
108653,1,1,1,0,0
565,0,0,0,0,0
80121,0,0,0,0,0
42666,0,0,0,0,0
26702,0,0,0,0,0
2047,0,0,0,0,0
37575,0,0,0,0,0
47253,0,0,0,0,0
71769,0,0,0,0,0
5070,0,0,0,0,0
53809,0,0,0,0,0
56701,0,0,0,0,0
54711,0,0,0,0,0
12878,0,0,0,0,0
88756,0,0,0,0,0
4134,0,0,0,0,0
118878,0,0,0,0,0
109359,0,0,0,0,0
63592,0,0,0,0,0
86495,0,0,0,0,0
40582,0,0,0,0,0
4178,0,0,0,0,0
12491,0,0,0,0,0
92711,0,0,0,0,0
76245,0,0,0,0,0
102131,4,4,4,0,0
56730,0,0,0,0,0
2220,0,0,0,0,0
92570,0,0,0,0,0
74574,0,0,0,0,0
1103,0,0,0,0,0
68207,0,0,0,0,0
91200,0,0,0,0,0
13738,0,0,0,0,0
112859,0,0,0,0,0
12194,0,0,0,0,0
38474,0,0,0,0,0
83453,8,8,8,0,0
34952,0,0,0,0,0
73304,0,0,0,0,0
114097,0,0,0,0,0
81820,0,0,0,0,0
120460,0,0,0,0,0
48986,0,0,0,0,0
91383,0,0,0,0,0
61023,0,0,0,0,0
118410,0,0,0,0,0
51555,0,0,0,0,0
8914,0,0,0,0,0
50809,0,0,0,0,0
105598,0,0,0,0,0
69055,0,0,0,0,0
86265,0,0,0,0,0
100164,0,0,0,0,0
4775,2,2,2,0,0
13998,0,0,0,0,0
99461,0,0,0,0,0
33054,0,0,0,0,0
9669,0,0,0,0,0
2288,0,0,0,0,0
99324,0,0,0,0,0
7333,6,6,6,0,0
107631,0,0,0,0,0
105949,0,0,0,0,0
103660,0,0,0,0,0
368,0,0,0,0,0
52011,0,0,0,0,0
34195,0,0,0,0,0
64166,0,0,0,0,0
28113,0,0,0,0,0
68630,0,0,0,0,0
40714,0,0,0,0,0
88647,0,0,0,0,0
19469,0,0,0,0,0
12367,0,0,0,0,0
97203,0,0,0,0,0
100539,0,0,0,0,0
36550,0,0,0,0,0
14377,0,0,0,0,0
49513,0,0,0,0,0
2835,0,0,0,0,0
104900,0,0,0,0,0
41833,0,0,0,0,0
79857,0,0,0,0,0
2895,0,0,0,0,0
34187,0,0,0,0,0
33491,0,0,0,0,0
98412,0,0,0,0,0
81822,0,0,0,0,0
808,0,0,0,0,0
81215,0,0,0,0,0
66938,0,0,0,0,0
30765,0,0,0,0,0
1308,0,0,0,0,0
14496,0,0,0,0,0
70413,0,0,0,0,0
55653,0,0,0,0,0
1090,0,0,0,0,0
76212,0,0,0,0,0
57548,0,0,0,0,0
62012,0,0,0,0,0
75207,0,0,0,0,0
89585,0,0,0,0,0
88248,0,0,0,0,0
29038,0,0,0,0,0
48301,0,0,0,0,0
54282,0,0,0,0,0
66458,0,0,0,0,0
4019,0,0,0,0,0
73218,0,0,0,0,0
45912,0,0,0,0,0
44389,0,0,0,0,0
117706,0,0,0,0,0
64430,0,0,0,0,0
115605,0,0,0,0,0
99773,0,0,0,0,0
30588,0,0,0,0,0
80164,0,0,0,0,0
93516,0,0,0,0,0
23940,0,0,0,0,0
94396,0,0,0,0,0
44418,0,0,0,0,0
3277,0,0,0,0,0
94436,0,0,0,0,0
93752,0,0,0,0,0
62608,0,0,0,0,0
11227,0,0,0,0,0
71819,0,0,0,0,0
113939,0,0,0,0,0
107998,0,0,0,0,0
42829,1,1,1,0,0
47167,0,0,0,0,0
114770,0,0,0,0,0
81499,0,0,0,0,0
32306,0,0,0,0,0
18457,0,0,0,0,0
79236,0,0,0,0,0
57922,0,0,0,0,0
70468,0,0,0,0,0
99443,0,0,0,0,0
33280,0,0,0,0,0
14652,0,0,0,0,0
2329,0,0,0,0,0
14679,0,0,0,0,0
108533,0,0,0,0,0
1814,0,0,0,0,0
43582,0,0,0,0,0
96022,0,0,0,0,0
34742,1,1,1,0,0
69579,0,0,0,0,0
105229,0,0,0,0,0
76881,0,0,0,0,0
49151,0,0,0,0,0
4026,0,0,0,0,0
75580,0,0,0,0,0
15796,0,0,0,0,0
78000,0,0,0,0,0
116356,0,0,0,0,0
8563,0,0,0,0,0
85970,0,0,0,0,0
70087,0,0,0,0,0
45933,0,0,0,0,0
38578,0,0,0,0,0
119200,0,0,0,0,0
95261,0,0,0,0,0
112252,0,0,0,0,0
4703,0,0,0,0,0
87470,0,0,0,0,0
12324,0,0,0,0,0
63622,0,0,0,0,0
105522,0,0,0,0,0
13421,0,0,0,0,0
9922,0,0,0,0,0
112601,0,0,0,0,0
4584,0,0,0,0,0
40477,0,0,0,0,0
90662,0,0,0,0,0
114435,0,0,0,0,0
93050,0,0,0,0,0
56980,0,0,0,0,0
48179,0,0,0,0,0
56998,0,0,0,0,0
30412,0,0,0,0,0
12763,0,0,0,0,0
13634,0,0,0,0,0
92414,0,0,0,0,0
52046,0,0,0,0,0
106048,0,0,0,0,0
24446,0,0,0,0,0
75554,0,0,0,0,0
99382,0,0,0,0,0
66954,0,0,0,0,0
66833,0,0,0,0,0
44277,0,0,0,0,0
8389,0,0,0,0,0
52983,0,0,0,0,0
69468,0,0,0,0,0
43389,0,0,0,0,0
77368,0,0,0,0,0
44121,0,0,0,0,0
107740,0,0,0,0,0
85556,0,0,0,0,0
29495,0,0,0,0,0
101957,0,0,0,0,0
41560,0,0,0,0,0
106882,0,0,0,0,0
71994,0,0,0,0,0
94581,0,0,0,0,0
112007,0,0,0,0,0
6102,2,2,2,0,0
62509,0,0,0,0,0
9527,0,0,0,0,0
18723,0,0,0,0,0
15821,0,0,0,0,0
23246,0,0,0,0,0
89095,0,0,0,0,0
20276,0,0,0,0,0
18941,0,0,0,0,0
99907,0,0,0,0,0
19536,0,0,0,0,0
26212,0,0,0,0,0
80264,0,0,0,0,0
91741,0,0,0,0,0
86286,0,0,0,0,0
100278,0,0,0,0,0
85883,0,0,0,0,0
59248,0,0,0,0,0
113385,0,0,0,0,0
48698,0,0,0,0,0
111588,0,0,0,0,0
10947,0,0,0,0,0
88492,0,0,0,0,0
81971,0,0,0,0,0
71102,0,0,0,0,0
80901,0,0,0,0,0
45630,0,0,0,0,0
101807,0,0,0,0,0
46991,0,0,0,0,0
68202,0,0,0,0,0
112060,0,0,0,0,0
36203,0,0,0,0,0
99878,0,0,0,0,0
33511,0,0,0,0,0
109581,0,0,0,0,0
39953,0,0,0,0,0
5177,0,0,0,0,0
104286,0,0,0,0,0
112671,0,0,0,0,0
42951,0,0,0,0,0
19827,0,0,0,0,0
115477,0,0,0,0,0
34612,1,1,1,0,0
73293,0,0,0,0,0
59133,0,0,0,0,0
12647,0,0,0,0,0
11411,0,0,0,0,0
113686,0,0,0,0,0
26288,0,0,0,0,0
24961,0,0,0,0,0
25660,0,0,0,0,0
109684,0,0,0,0,0
82257,0,0,0,0,0
19694,0,0,0,0,0
76836,0,0,0,0,0
16397,0,0,0,0,0
79653,0,0,0,0,0
83996,0,0,0,0,0
88960,0,0,0,0,0
19225,0,0,0,0,0
77348,0,0,0,0,0
26477,0,0,0,0,0
117082,0,0,0,0,0
73248,0,0,0,0,0
9526,0,0,0,0,0
38383,0,0,0,0,0
49735,0,0,0,0,0
48509,0,0,0,0,0
114890,2,2,2,0,0
59501,0,0,0,0,0
110399,0,0,0,0,0
15222,0,0,0,0,0
24551,0,0,0,0,0
7564,0,0,0,0,0
11697,0,0,0,0,0
94527,0,0,0,0,0
114604,0,0,0,0,0
64860,0,0,0,0,0
20773,0,0,0,0,0
115397,0,0,0,0,0
50475,0,0,0,0,0
62688,0,0,0,0,0
93588,0,0,0,0,0
34318,0,0,0,0,0
111748,0,0,0,0,0
29548,0,0,0,0,0
103825,0,0,0,0,0
4315,0,0,0,0,0
67590,0,0,0,0,0
95077,0,0,0,0,0
65767,0,0,0,0,0
39719,0,0,0,0,0
21099,0,0,0,0,0
83907,0,0,0,0,0
45745,0,0,0,0,0
53471,0,0,0,0,0
67178,0,0,0,0,0
51380,0,0,0,0,0
45726,0,0,0,0,0
7500,0,0,0,0,0
68978,0,0,0,0,0
62014,0,0,0,0,0
23473,0,0,0,0,0
25789,0,0,0,0,0
13236,0,0,0,0,0
67424,0,0,0,0,0
100275,0,0,0,0,0
48237,0,0,0,0,0
90196,0,0,0,0,0
59301,0,0,0,0,0
41642,0,0,0,0,0
46994,0,0,0,0,0
75992,0,0,0,0,0
97400,0,0,0,0,0
116015,0,0,0,0,0
25314,0,0,0,0,0
100535,0,0,0,0,0
104066,0,0,0,0,0
56076,0,0,0,0,0
108575,1,1,1,0,0
91638,0,0,0,0,0
25196,0,0,0,0,0
9087,0,0,0,0,0
100751,0,0,0,0,0
83213,0,0,0,0,0
87611,0,0,0,0,0
106505,0,0,0,0,0
95387,0,0,0,0,0
62332,0,0,0,0,0
22912,0,0,0,0,0
101342,0,0,0,0,0
89341,0,0,0,0,0
2748,0,0,0,0,0
820,0,0,0,0,0
41433,0,0,0,0,0
75150,0,0,0,0,0
114353,0,0,0,0,0
10439,0,0,0,0,0
2841,0,0,0,0,0
25239,0,0,0,0,0
95053,0,0,0,0,0
84884,0,0,0,0,0
30390,0,0,0,0,0
34029,0,0,0,0,0
112568,0,0,0,0,0
48263,0,0,0,0,0
74067,0,0,0,0,0
73948,0,0,0,0,0
8674,0,0,0,0,0
75297,0,0,0,0,0
54408,0,0,0,0,0
97655,0,0,0,0,0
85715,0,0,0,0,0
26367,0,0,0,0,0
10926,0,0,0,0,0
47916,0,0,0,0,0
12571,0,0,0,0,0
94790,0,0,0,0,0
89450,0,0,0,0,0
17433,0,0,0,0,0
33892,0,0,0,0,0
73709,0,0,0,0,0
33657,0,0,0,0,0
4089,0,0,0,0,0
104332,0,0,0,0,0
65377,0,0,0,0,0
27085,0,0,0,0,0
21282,0,0,0,0,0
113359,0,0,0,0,0
16523,0,0,0,0,0
1099,0,0,0,0,0
41352,0,0,0,0,0
63406,0,0,0,0,0
85746,0,0,0,0,0
100699,0,0,0,0,0
23493,0,0,0,0,0
101649,0,0,0,0,0
21283,0,0,0,0,0
38206,0,0,0,0,0
33252,0,0,0,0,0
26629,3,3,3,0,0
63351,0,0,0,0,0
87889,0,0,0,0,0
28671,0,0,0,0,0
13012,0,0,0,0,0
6617,0,0,0,0,0
54445,0,0,0,0,0
98855,0,0,0,0,0
19830,0,0,0,0,0
44221,0,0,0,0,0
91661,0,0,0,0,0
87207,0,0,0,0,0
26113,0,0,0,0,0
28333,0,0,0,0,0
93004,0,0,0,0,0
92893,0,0,0,0,0
90672,0,0,0,0,0
26296,0,0,0,0,0
41709,0,0,0,0,0
90154,0,0,0,0,0
58395,0,0,0,0,0
107755,0,0,0,0,0
68250,0,0,0,0,0
24940,0,0,0,0,0
97472,0,0,0,0,0
53221,0,0,0,0,0
97493,0,0,0,0,0
46300,0,0,0,0,0
92030,0,0,0,0,0
70145,0,0,0,0,0
71353,0,0,0,0,0
31895,0,0,0,0,0
6100,0,0,0,0,0
64864,0,0,0,0,0
76422,0,0,0,0,0
106874,0,0,0,0,0
112465,0,0,0,0,0
115113,0,0,0,0,0
92712,0,0,0,0,0
27911,0,0,0,0,0
116624,0,0,0,0,0
107151,0,0,0,0,0
63675,0,0,0,0,0
114007,0,0,0,0,0
27238,0,0,0,0,0
78582,0,0,0,0,0
41278,0,0,0,0,0
45143,0,0,0,0,0
58126,0,0,0,0,0
11843,0,0,0,0,0
70903,0,0,0,0,0
32530,0,0,0,0,0
59830,0,0,0,0,0
84069,0,0,0,0,0
49314,0,0,0,0,0
74641,0,0,0,0,0
114173,0,0,0,0,0
86895,0,0,0,0,0
4482,0,0,0,0,0
96116,0,0,0,0,0
20736,0,0,0,0,0
79977,0,0,0,0,0
19697,0,0,0,0,0
116771,0,0,0,0,0
96342,0,0,0,0,0
63680,0,0,0,0,0
33448,0,0,0,0,0
15364,0,0,0,0,0
252,0,0,0,0,0
3752,0,0,0,0,0
78490,0,0,0,0,0
54644,0,0,0,0,0
16924,0,0,0,0,0
59100,0,0,0,0,0
109560,0,0,0,0,0
70765,0,0,0,0,0
102854,0,0,0,0,0
112428,0,0,0,0,0
111431,0,0,0,0,0
10268,0,0,0,0,0
92381,0,0,0,0,0
116733,0,0,0,0,0
40793,0,0,0,0,0
104215,0,0,0,0,0
28009,0,0,0,0,0
88612,0,0,0,0,0
112648,0,0,0,0,0
109110,0,0,0,0,0
106309,0,0,0,0,0
74605,0,0,0,0,0
90551,0,0,0,0,0
13519,0,0,0,0,0
49528,0,0,0,0,0
8380,0,0,0,0,0
64126,0,0,0,0,0
16555,0,0,0,0,0
35667,0,0,0,0,0
80022,0,0,0,0,0
39581,0,0,0,0,0
93791,0,0,0,0,0
114399,0,0,0,0,0
118808,0,0,0,0,0
59731,0,0,0,0,0
106320,0,0,0,0,0
15191,0,0,0,0,0
86511,0,0,0,0,0
102597,0,0,0,0,0
116137,0,0,0,0,0
80037,0,0,0,0,0
13588,0,0,0,0,0
84900,0,0,0,0,0
77684,0,0,0,0,0
28722,0,0,0,0,0
90765,0,0,0,0,0
22190,0,0,0,0,0
76595,0,0,0,0,0
59082,0,0,0,0,0
21564,0,0,0,0,0
88990,0,0,0,0,0
24559,0,0,0,0,0
53217,5,5,5,0,0
97923,0,0,0,0,0
22102,0,0,0,0,0
99827,4,4,4,0,0
6532,0,0,0,0,0
41980,0,0,0,0,0
113728,0,0,0,0,0
60173,0,0,0,0,0
49978,0,0,0,0,0
74975,0,0,0,0,0
35425,0,0,0,0,0
103516,0,0,0,0,0
52168,0,0,0,0,0
89497,0,0,0,0,0
69445,0,0,0,0,0
27482,0,0,0,0,0
24082,0,0,0,0,0
21412,0,0,0,0,0
89144,0,0,0,0,0
89365,0,0,0,0,0
58758,0,0,0,0,0
63573,0,0,0,0,0
89431,0,0,0,0,0
107510,3,3,3,0,0
60214,0,0,0,0,0
108326,0,0,0,0,0
39338,0,0,0,0,0
71284,0,0,0,0,0
22673,0,0,0,0,0
90170,0,0,0,0,0
71512,0,0,0,0,0
107797,0,0,0,0,0
104698,0,0,0,0,0
48515,0,0,0,0,0
51951,0,0,0,0,0
35744,0,0,0,0,0
21398,0,0,0,0,0
99398,0,0,0,0,0
25325,0,0,0,0,0
114386,0,0,0,0,0
62331,0,0,0,0,0
84469,0,0,0,0,0
97927,0,0,0,0,0
111383,0,0,0,0,0
73882,0,0,0,0,0
27484,0,0,0,0,0
14746,3,3,3,0,0
105143,0,0,0,0,0
78930,0,0,0,0,0
103384,0,0,0,0,0
62335,0,0,0,0,0
99109,0,0,0,0,0
100636,0,0,0,0,0
47032,0,0,0,0,0
76544,0,0,0,0,0
2647,0,0,0,0,0
85322,0,0,0,0,0
112494,0,0,0,0,0
39453,0,0,0,0,0
81089,0,0,0,0,0
40388,0,0,0,0,0
63935,0,0,0,0,0
34589,0,0,0,0,0
33463,0,0,0,0,0
92427,0,0,0,0,0
28352,0,0,0,0,0
77377,0,0,0,0,0
111387,0,0,0,0,0
109252,0,0,0,0,0
41250,0,0,0,0,0
6841,0,0,0,0,0
78536,0,0,0,0,0
120566,0,0,0,0,0
70913,0,0,0,0,0
111487,0,0,0,0,0
2920,0,0,0,0,0
81106,0,0,0,0,0
97680,0,0,0,0,0
31135,0,0,0,0,0
20317,0,0,0,0,0
64541,0,0,0,0,0
117427,0,0,0,0,0
23401,0,0,0,0,0
25727,0,0,0,0,0
68703,0,0,0,0,0
35852,0,0,0,0,0
51113,0,0,0,0,0
84565,0,0,0,0,0
71790,0,0,0,0,0
27859,0,0,0,0,0
37408,0,0,0,0,0
20762,0,0,0,0,0
75719,0,0,0,0,0
16628,0,0,0,0,0
76810,0,0,0,0,0
52861,0,0,0,0,0
47901,0,0,0,0,0
112773,0,0,0,0,0
97360,0,0,0,0,0
61556,0,0,0,0,0
16738,0,0,0,0,0
49418,0,0,0,0,0
18686,0,0,0,0,0
37007,0,0,0,0,0
114622,0,0,0,0,0
71462,0,0,0,0,0
46715,0,0,0,0,0
41664,6,6,6,0,0
3590,0,0,0,0,0
72216,0,0,0,0,0
111259,0,0,0,0,0
84652,0,0,0,0,0
3605,0,0,0,0,0
91364,0,0,0,0,0
51643,0,0,0,0,0
8786,0,0,0,0,0
8636,0,0,0,0,0
3571,0,0,0,0,0
116924,0,0,0,0,0
106665,0,0,0,0,0
64555,0,0,0,0,0
60240,0,0,0,0,0
75736,0,0,0,0,0
48300,0,0,0,0,0
29759,0,0,0,0,0
17206,0,0,0,0,0
79300,0,0,0,0,0
11773,0,0,0,0,0
43451,0,0,0,0,0
86040,0,0,0,0,0
38161,0,0,0,0,0
56510,0,0,0,0,0
55476,0,0,0,0,0
78081,0,0,0,0,0
78860,0,0,0,0,0
115118,0,0,0,0,0
110751,0,0,0,0,0
56856,0,0,0,0,0
104457,0,0,0,0,0
71262,0,0,0,0,0
18438,0,0,0,0,0
70757,0,0,0,0,0
39678,0,0,0,0,0
115430,0,0,0,0,0
90252,0,0,0,0,0
26493,0,0,0,0,0
99842,0,0,0,0,0
80489,0,0,0,0,0
46491,0,0,0,0,0
89475,0,0,0,0,0
18515,0,0,0,0,0
81544,0,0,0,0,0
8746,0,0,0,0,0
108463,0,0,0,0,0
101172,1,1,1,0,0
109161,0,0,0,0,0
29031,0,0,0,0,0
111896,0,0,0,0,0
71093,0,0,0,0,0
42719,0,0,0,0,0
96819,0,0,0,0,0
49699,0,0,0,0,0
89110,0,0,0,0,0
23683,0,0,0,0,0
30715,0,0,0,0,0
69891,0,0,0,0,0
71037,0,0,0,0,0
19494,0,0,0,0,0
12883,0,0,0,0,0
16061,0,0,0,0,0
51238,0,0,0,0,0
70925,0,0,0,0,0
94140,0,0,0,0,0
79841,0,0,0,0,0
92630,0,0,0,0,0
42060,0,0,0,0,0
110274,0,0,0,0,0
107786,0,0,0,0,0
107726,0,0,0,0,0
52288,0,0,0,0,0
12508,0,0,0,0,0
46275,0,0,0,0,0
27551,0,0,0,0,0
107019,1,1,1,0,0
29588,0,0,0,0,0
104506,0,0,0,0,0
44687,0,0,0,0,0
84177,0,0,0,0,0
43956,0,0,0,0,0
8663,0,0,0,0,0
105628,0,0,0,0,0
46835,0,0,0,0,0
75840,0,0,0,0,0
119527,0,0,0,0,0
61173,0,0,0,0,0
7069,0,0,0,0,0
44455,0,0,0,0,0
76211,0,0,0,0,0
93946,0,0,0,0,0
3889,0,0,0,0,0
24231,0,0,0,0,0
26275,0,0,0,0,0
25223,0,0,0,0,0
85542,0,0,0,0,0
24005,0,0,0,0,0
11303,0,0,0,0,0
2282,0,0,0,0,0
50075,0,0,0,0,0
45810,0,0,0,0,0
116853,0,0,0,0,0
21472,0,0,0,0,0
13635,1,1,1,0,0
83495,0,0,0,0,0
83685,0,0,0,0,0
84022,0,0,0,0,0
55594,0,0,0,0,0
74040,0,0,0,0,0
37376,0,0,0,0,0
39307,0,0,0,0,0
88679,0,0,0,0,0
64776,0,0,0,0,0
11966,0,0,0,0,0
17457,0,0,0,0,0
57486,0,0,0,0,0
77920,0,0,0,0,0
96062,0,0,0,0,0
59212,0,0,0,0,0
38789,0,0,0,0,0
116223,0,0,0,0,0
61505,0,0,0,0,0
18220,0,0,0,0,0
13631,0,0,0,0,0
48434,0,0,0,0,0
103817,0,0,0,0,0
87991,0,0,0,0,0
52563,0,0,0,0,0
36844,0,0,0,0,0
11199,0,0,0,0,0
5267,0,0,0,0,0
33300,0,0,0,0,0
56574,0,0,0,0,0
62263,0,0,0,0,0
27944,0,0,0,0,0
112818,0,0,0,0,0
120030,0,0,0,0,0
104200,0,0,0,0,0
7502,0,0,0,0,0
54680,0,0,0,0,0
86270,0,0,0,0,0
9778,0,0,0,0,0
10761,0,0,0,0,0
42777,0,0,0,0,0
48849,0,0,0,0,0
93526,0,0,0,0,0
31348,0,0,0,0,0
20915,0,0,0,0,0
28227,0,0,0,0,0
16780,0,0,0,0,0
78881,0,0,0,0,0
87002,0,0,0,0,0
120039,0,0,0,0,0
48045,0,0,0,0,0
23735,0,0,0,0,0
92054,0,0,0,0,0
88440,0,0,0,0,0
45239,0,0,0,0,0
25124,0,0,0,0,0
115135,3,3,3,0,0
71730,0,0,0,0,0
46102,0,0,0,0,0
3535,0,0,0,0,0
8817,0,0,0,0,0
112850,0,0,0,0,0
26220,0,0,0,0,0
28303,0,0,0,0,0
5797,0,0,0,0,0
38268,0,0,0,0,0
16635,0,0,0,0,0
72616,0,0,0,0,0
40417,0,0,0,0,0
79174,0,0,0,0,0
73520,0,0,0,0,0
103157,0,0,0,0,0
89663,0,0,0,0,0
65829,0,0,0,0,0
103134,0,0,0,0,0
9888,0,0,0,0,0
22322,0,0,0,0,0
110869,0,0,0,0,0
111117,0,0,0,0,0
731,0,0,0,0,0
37118,0,0,0,0,0
119247,0,0,0,0,0
66526,0,0,0,0,0
40095,0,0,0,0,0
119774,0,0,0,0,0
57591,0,0,0,0,0
105076,0,0,0,0,0
46426,0,0,0,0,0
94491,0,0,0,0,0
99511,0,0,0,0,0
43470,0,0,0,0,0
54065,0,0,0,0,0
35020,0,0,0,0,0
114745,0,0,0,0,0
32123,0,0,0,0,0
85544,0,0,0,0,0
27462,0,0,0,0,0
47003,0,0,0,0,0
109583,0,0,0,0,0
18652,0,0,0,0,0
53939,0,0,0,0,0
90437,0,0,0,0,0
50715,0,0,0,0,0
31878,0,0,0,0,0
22694,0,0,0,0,0
6981,0,0,0,0,0
30599,0,0,0,0,0
56331,0,0,0,0,0
119309,0,0,0,0,0
83970,0,0,0,0,0
9539,0,0,0,0,0
120195,0,0,0,0,0
33899,0,0,0,0,0
14764,0,0,0,0,0
117968,0,0,0,0,0
59042,1,1,1,0,0
54734,0,0,0,0,0
45190,0,0,0,0,0
65820,0,0,0,0,0
52589,0,0,0,0,0
98678,0,0,0,0,0
23627,0,0,0,0,0
67859,0,0,0,0,0
76873,0,0,0,0,0
58897,0,0,0,0,0
97063,0,0,0,0,0
11019,0,0,0,0,0
81511,0,0,0,0,0
103671,0,0,0,0,0
119260,0,0,0,0,0
100076,0,0,0,0,0
69049,0,0,0,0,0
50248,0,0,0,0,0
19329,0,0,0,0,0
61485,0,0,0,0,0
56407,0,0,0,0,0
44015,0,0,0,0,0
24548,0,0,0,0,0
47029,0,0,0,0,0
70438,0,0,0,0,0
118043,0,0,0,0,0
58548,0,0,0,0,0
23857,0,0,0,0,0
47701,0,0,0,0,0
10694,0,0,0,0,0
55093,0,0,0,0,0
52106,0,0,0,0,0
109971,0,0,0,0,0
99957,0,0,0,0,0
28990,0,0,0,0,0
19096,0,0,0,0,0
113920,2,2,2,0,0
82174,1,1,1,0,0
74626,0,0,0,0,0
87562,0,0,0,0,0
105397,0,0,0,0,0
112179,0,0,0,0,0
63666,0,0,0,0,0
108890,0,0,0,0,0
108592,0,0,0,0,0
35060,0,0,0,0,0
87799,0,0,0,0,0
114629,0,0,0,0,0
118326,0,0,0,0,0
75369,0,0,0,0,0
1704,0,0,0,0,0
8679,0,0,0,0,0
114575,0,0,0,0,0
85260,0,0,0,0,0
56740,0,0,0,0,0
43435,0,0,0,0,0
3078,0,0,0,0,0
81752,0,0,0,0,0
57597,0,0,0,0,0
118936,0,0,0,0,0
48696,0,0,0,0,0
85316,0,0,0,0,0
38917,0,0,0,0,0
117817,0,0,0,0,0
104376,0,0,0,0,0
82408,0,0,0,0,0
96307,0,0,0,0,0
90310,0,0,0,0,0
57815,0,0,0,0,0
18294,0,0,0,0,0
50785,0,0,0,0,0
92435,0,0,0,0,0
17135,0,0,0,0,0
43415,0,0,0,0,0
9706,0,0,0,0,0
102497,0,0,0,0,0
76927,0,0,0,0,0
88488,0,0,0,0,0
77256,0,0,0,0,0
9002,0,0,0,0,0
38261,0,0,0,0,0
59753,0,0,0,0,0
66470,0,0,0,0,0
10676,0,0,0,0,0
76705,0,0,0,0,0
22156,0,0,0,0,0
20720,0,0,0,0,0
14537,0,0,0,0,0
83874,0,0,0,0,0
113086,0,0,0,0,0
56034,0,0,0,0,0
101513,0,0,0,0,0
117643,0,0,0,0,0
86331,0,0,0,0,0
113870,0,0,0,0,0
37099,0,0,0,0,0
19820,0,0,0,0,0
61808,0,0,0,0,0
36895,0,0,0,0,0
12880,0,0,0,0,0
11514,0,0,0,0,0
98722,0,0,0,0,0
36843,0,0,0,0,0
40548,0,0,0,0,0
41948,0,0,0,0,0
91198,0,0,0,0,0
108027,0,0,0,0,0
34963,0,0,0,0,0
118212,0,0,0,0,0
110422,0,0,0,0,0
60581,0,0,0,0,0
81815,0,0,0,0,0
92465,0,0,0,0,0
9955,0,0,0,0,0
729,0,0,0,0,0
39732,0,0,0,0,0
45213,0,0,0,0,0
91346,0,0,0,0,0
100711,0,0,0,0,0
31449,0,0,0,0,0
44498,0,0,0,0,0
33623,0,0,0,0,0
56482,0,0,0,0,0
56393,5,5,5,0,0
48834,0,0,0,0,0
45129,0,0,0,0,0
61728,0,0,0,0,0
58598,0,0,0,0,0
47796,0,0,0,0,0
65905,0,0,0,0,0
15535,0,0,0,0,0
98120,0,0,0,0,0
54782,0,0,0,0,0
35408,0,0,0,0,0
114126,0,0,0,0,0
7503,0,0,0,0,0
1584,0,0,0,0,0
28417,0,0,0,0,0
116051,0,0,0,0,0
38495,1,1,1,0,0
44036,0,0,0,0,0
118284,0,0,0,0,0
9525,0,0,0,0,0
22260,0,0,0,0,0
76324,0,0,0,0,0
92753,0,0,0,0,0
85336,0,0,0,0,0
22686,0,0,0,0,0
45321,0,0,0,0,0
67492,0,0,0,0,0
106709,0,0,0,0,0
83486,0,0,0,0,0
100889,0,0,0,0,0
97974,0,0,0,0,0
47577,0,0,0,0,0
30045,0,0,0,0,0
103261,0,0,0,0,0
67571,0,0,0,0,0
72335,0,0,0,0,0
119199,0,0,0,0,0
63908,4,4,4,0,0
93848,0,0,0,0,0
95899,0,0,0,0,0
61746,0,0,0,0,0
72414,0,0,0,0,0
107250,0,0,0,0,0
24158,0,0,0,0,0
97436,0,0,0,0,0
107062,0,0,0,0,0
60360,3,3,3,0,0
61890,0,0,0,0,0
10664,0,0,0,0,0
111044,0,0,0,0,0
7447,0,0,0,0,0
63449,0,0,0,0,0
80898,0,0,0,0,0
108872,0,0,0,0,0
50474,0,0,0,0,0
84630,0,0,0,0,0
22290,0,0,0,0,0
38615,0,0,0,0,0
7486,0,0,0,0,0
8966,0,0,0,0,0
36287,0,0,0,0,0
117316,0,0,0,0,0
74184,0,0,0,0,0
65758,0,0,0,0,0
106726,0,0,0,0,0
28482,0,0,0,0,0
75947,0,0,0,0,0
33841,0,0,0,0,0
9348,0,0,0,0,0
79899,0,0,0,0,0
98300,0,0,0,0,0
105827,0,0,0,0,0
116159,0,0,0,0,0
114295,0,0,0,0,0
32134,0,0,0,0,0
51964,0,0,0,0,0
90829,0,0,0,0,0
44291,0,0,0,0,0
9193,0,0,0,0,0
26600,0,0,0,0,0
25941,0,0,0,0,0
91367,0,0,0,0,0
40484,0,0,0,0,0
63050,0,0,0,0,0
102308,0,0,0,0,0
61221,0,0,0,0,0
47151,0,0,0,0,0
75626,0,0,0,0,0
3159,0,0,0,0,0
32392,0,0,0,0,0
69451,0,0,0,0,0
15669,0,0,0,0,0
53009,0,0,0,0,0
25410,0,0,0,0,0
976,0,0,0,0,0
25286,0,0,0,0,0
43908,0,0,0,0,0
42701,0,0,0,0,0
96466,0,0,0,0,0
21052,0,0,0,0,0
69311,0,0,0,0,0
9414,0,0,0,0,0
49450,0,0,0,0,0
43036,0,0,0,0,0
111504,0,0,0,0,0
103950,0,0,0,0,0
44124,0,0,0,0,0
974,0,0,0,0,0
77380,0,0,0,0,0
101796,0,0,0,0,0
48198,0,0,0,0,0
57093,0,0,0,0,0
86754,0,0,0,0,0
62088,0,0,0,0,0
17759,0,0,0,0,0
45488,0,0,0,0,0
93011,0,0,0,0,0
104150,0,0,0,0,0
119791,0,0,0,0,0
36799,0,0,0,0,0
14886,0,0,0,0,0
50266,0,0,0,0,0
19570,0,0,0,0,0
108530,0,0,0,0,0
90011,0,0,0,0,0
79802,0,0,0,0,0
7593,0,0,0,0,0
113322,0,0,0,0,0
99682,0,0,0,0,0
46846,0,0,0,0,0
100025,0,0,0,0,0
45179,0,0,0,0,0
77556,0,0,0,0,0
91512,0,0,0,0,0
90641,0,0,0,0,0
112737,0,0,0,0,0
85155,0,0,0,0,0
26353,0,0,0,0,0
61988,0,0,0,0,0
60268,0,0,0,0,0
114698,0,0,0,0,0
109489,0,0,0,0,0
14582,0,0,0,0,0
2111,0,0,0,0,0
113979,0,0,0,0,0
57393,0,0,0,0,0
32506,0,0,0,0,0
100330,0,0,0,0,0
18549,0,0,0,0,0
8877,0,0,0,0,0
24689,0,0,0,0,0
55312,0,0,0,0,0
29458,0,0,0,0,0
5890,0,0,0,0,0
107184,0,0,0,0,0
89800,0,0,0,0,0
91845,0,0,0,0,0
58177,0,0,0,0,0
104832,0,0,0,0,0
110383,0,0,0,0,0
71763,0,0,0,0,0
92895,0,0,0,0,0
113242,0,0,0,0,0
79122,0,0,0,0,0
42609,0,0,0,0,0
58800,4,4,4,0,0
112145,0,0,0,0,0
110988,0,0,0,0,0
24499,0,0,0,0,0
115673,0,0,0,0,0
72271,0,0,0,0,0
23795,0,0,0,0,0
43291,0,0,0,0,0
5338,0,0,0,0,0
62605,0,0,0,0,0
74813,0,0,0,0,0
2692,0,0,0,0,0
64763,0,0,0,0,0
3014,0,0,0,0,0
83033,0,0,0,0,0
89077,0,0,0,0,0
29264,0,0,0,0,0
66774,0,0,0,0,0
44039,0,0,0,0,0
18367,0,0,0,0,0
104292,0,0,0,0,0
74122,0,0,0,0,0
63487,0,0,0,0,0
102635,0,0,0,0,0
42608,0,0,0,0,0
93469,0,0,0,0,0
25734,0,0,0,0,0
33473,0,0,0,0,0
108338,0,0,0,0,0
82616,0,0,0,0,0
80187,0,0,0,0,0
114039,0,0,0,0,0
40716,0,0,0,0,0
35671,0,0,0,0,0
119211,0,0,0,0,0
34782,0,0,0,0,0
68585,0,0,0,0,0
78619,0,0,0,0,0
104805,0,0,0,0,0
54795,0,0,0,0,0
27306,0,0,0,0,0
116991,0,0,0,0,0
80911,0,0,0,0,0
25651,0,0,0,0,0
98536,0,0,0,0,0
55585,0,0,0,0,0
4604,0,0,0,0,0
94379,0,0,0,0,0
58329,0,0,0,0,0
79819,0,0,0,0,0
95137,0,0,0,0,0
115706,0,0,0,0,0
88589,0,0,0,0,0
59063,0,0,0,0,0
50623,0,0,0,0,0
46535,0,0,0,0,0
35690,0,0,0,0,0
13013,0,0,0,0,0
457,0,0,0,0,0
92769,0,0,0,0,0
83855,0,0,0,0,0
67349,1,1,1,0,0
18615,0,0,0,0,0
14040,0,0,0,0,0
35506,0,0,0,0,0
79228,0,0,0,0,0
54478,0,0,0,0,0
31315,0,0,0,0,0
29721,0,0,0,0,0
87529,0,0,0,0,0
82988,0,0,0,0,0
17277,0,0,0,0,0
75795,0,0,0,0,0
60178,0,0,0,0,0
91293,0,0,0,0,0
81522,0,0,0,0,0
117084,0,0,0,0,0
42547,0,0,0,0,0
85228,0,0,0,0,0
12876,0,0,0,0,0
2890,0,0,0,0,0
9794,0,0,0,0,0
24832,0,0,0,0,0
5563,0,0,0,0,0
7507,0,0,0,0,0
107119,0,0,0,0,0
8654,0,0,0,0,0
22824,0,0,0,0,0
77149,0,0,0,0,0
90715,0,0,0,0,0
79747,0,0,0,0,0
52131,0,0,0,0,0
31554,0,0,0,0,0
29581,0,0,0,0,0
54886,0,0,0,0,0
79265,0,0,0,0,0
4254,0,0,0,0,0
24199,0,0,0,0,0
72510,0,0,0,0,0
54893,0,0,0,0,0
39935,0,0,0,0,0
92323,0,0,0,0,0
53112,0,0,0,0,0
72574,0,0,0,0,0
113923,0,0,0,0,0
17907,0,0,0,0,0
61259,0,0,0,0,0
120200,0,0,0,0,0
32213,0,0,0,0,0
106618,0,0,0,0,0
55219,0,0,0,0,0
61497,0,0,0,0,0
74239,0,0,0,0,0
108996,0,0,0,0,0
93023,0,0,0,0,0
81655,0,0,0,0,0
43565,0,0,0,0,0
93025,0,0,0,0,0
37680,0,0,0,0,0
115253,0,0,0,0,0
18362,0,0,0,0,0
2338,0,0,0,0,0
29439,0,0,0,0,0
58576,0,0,0,0,0
85072,0,0,0,0,0
108560,0,0,0,0,0
21948,0,0,0,0,0
4046,0,0,0,0,0
28103,0,0,0,0,0
58966,0,0,0,0,0
111216,0,0,0,0,0
74338,0,0,0,0,0
77447,0,0,0,0,0
75797,0,0,0,0,0
83886,0,0,0,0,0
2143,0,0,0,0,0
97334,0,0,0,0,0
102938,0,0,0,0,0
48727,0,0,0,0,0
118849,0,0,0,0,0
30802,0,0,0,0,0
21827,0,0,0,0,0
58723,0,0,0,0,0
875,0,0,0,0,0
77988,0,0,0,0,0
15033,0,0,0,0,0
5397,0,0,0,0,0
70228,0,0,0,0,0
111777,0,0,0,0,0
48630,0,0,0,0,0
62461,0,0,0,0,0
86879,0,0,0,0,0
17588,0,0,0,0,0
12715,0,0,0,0,0
75550,0,0,0,0,0
61593,0,0,0,0,0
87814,0,0,0,0,0
3908,0,0,0,0,0
119853,0,0,0,0,0
66344,0,0,0,0,0
10273,0,0,0,0,0
105624,0,0,0,0,0
18336,0,0,0,0,0
5340,0,0,0,0,0
292,0,0,0,0,0
68584,0,0,0,0,0
29080,0,0,0,0,0
103436,0,0,0,0,0
66024,0,0,0,0,0
17440,0,0,0,0,0
40698,0,0,0,0,0
118683,0,0,0,0,0
96097,0,0,0,0,0
19959,0,0,0,0,0
79596,0,0,0,0,0
65866,0,0,0,0,0
23953,0,0,0,0,0
73140,0,0,0,0,0
42121,0,0,0,0,0
89685,0,0,0,0,0
105019,0,0,0,0,0
85478,0,0,0,0,0
61288,0,0,0,0,0
105154,0,0,0,0,0
82058,0,0,0,0,0
44934,0,0,0,0,0
108409,0,0,0,0,0
3751,0,0,0,0,0
56037,0,0,0,0,0
98403,0,0,0,0,0
40065,0,0,0,0,0
54721,0,0,0,0,0
60576,0,0,0,0,0
53742,0,0,0,0,0
95445,0,0,0,0,0
52282,0,0,0,0,0
60745,0,0,0,0,0
80181,0,0,0,0,0
86182,0,0,0,0,0
5168,0,0,0,0,0
73160,0,0,0,0,0
51745,0,0,0,0,0
18801,0,0,0,0,0
61529,0,0,0,0,0
80276,0,0,0,0,0
94286,0,0,0,0,0
70452,0,0,0,0,0
34731,0,0,0,0,0
33412,0,0,0,0,0
22118,0,0,0,0,0
39359,0,0,0,0,0
32322,0,0,0,0,0
5854,0,0,0,0,0
78213,0,0,0,0,0
34244,0,0,0,0,0
116402,0,0,0,0,0
120547,0,0,0,0,0
75628,0,0,0,0,0
63733,0,0,0,0,0
21331,0,0,0,0,0
87522,0,0,0,0,0
111514,0,0,0,0,0
52853,0,0,0,0,0
23276,0,0,0,0,0
82053,0,0,0,0,0
22340,0,0,0,0,0
38230,0,0,0,0,0
84227,0,0,0,0,0
64094,0,0,0,0,0
28643,0,0,0,0,0
102464,0,0,0,0,0
96703,0,0,0,0,0
94930,0,0,0,0,0
108552,0,0,0,0,0
26138,0,0,0,0,0
89822,0,0,0,0,0
65606,0,0,0,0,0
6136,0,0,0,0,0
74762,0,0,0,0,0
85533,0,0,0,0,0
53847,0,0,0,0,0
87204,0,0,0,0,0
29204,0,0,0,0,0
107593,0,0,0,0,0
108922,0,0,0,0,0
35991,0,0,0,0,0
74883,0,0,0,0,0
22647,0,0,0,0,0
98810,0,0,0,0,0
65586,0,0,0,0,0
74470,1,1,1,0,0
113279,0,0,0,0,0
58660,0,0,0,0,0
102195,0,0,0,0,0
86232,0,0,0,0,0
40764,0,0,0,0,0
72455,0,0,0,0,0
83858,0,0,0,0,0
46735,0,0,0,0,0
102526,0,0,0,0,0
85289,0,0,0,0,0
14135,0,0,0,0,0
38493,0,0,0,0,0
7184,0,0,0,0,0
87722,0,0,0,0,0
100388,0,0,0,0,0
72138,0,0,0,0,0
62815,0,0,0,0,0
54521,0,0,0,0,0
105224,2,2,2,0,0
33650,0,0,0,0,0
1699,0,0,0,0,0
97174,0,0,0,0,0
4970,0,0,0,0,0
100770,0,0,0,0,0
61456,0,0,0,0,0
54309,0,0,0,0,0
83461,0,0,0,0,0
55327,0,0,0,0,0
63684,0,0,0,0,0
57964,0,0,0,0,0
99428,0,0,0,0,0
38728,0,0,0,0,0
75766,0,0,0,0,0
116954,0,0,0,0,0
84723,0,0,0,0,0
106263,0,0,0,0,0
68143,0,0,0,0,0
103759,0,0,0,0,0
90627,0,0,0,0,0
67771,0,0,0,0,0
65493,0,0,0,0,0
102035,0,0,0,0,0
119800,0,0,0,0,0
92488,0,0,0,0,0
20061,0,0,0,0,0
101390,0,0,0,0,0
118903,0,0,0,0,0
35672,0,0,0,0,0
75579,0,0,0,0,0
16938,0,0,0,0,0
74243,0,0,0,0,0
46809,0,0,0,0,0
49000,0,0,0,0,0
4230,0,0,0,0,0
107230,0,0,0,0,0
13661,0,0,0,0,0
49607,0,0,0,0,0
78530,0,0,0,0,0
34520,0,0,0,0,0
63014,0,0,0,0,0
79639,0,0,0,0,0
33340,0,0,0,0,0
73142,0,0,0,0,0
88540,0,0,0,0,0
15903,0,0,0,0,0
68531,0,0,0,0,0
44338,0,0,0,0,0
22609,0,0,0,0,0
78036,0,0,0,0,0
15397,0,0,0,0,0
45224,0,0,0,0,0
110017,0,0,0,0,0
93965,0,0,0,0,0
25765,0,0,0,0,0
55039,0,0,0,0,0
116890,2,2,2,0,0
2068,0,0,0,0,0
25975,0,0,0,0,0
36246,0,0,0,0,0
46369,0,0,0,0,0
83146,0,0,0,0,0
5978,0,0,0,0,0
7304,0,0,0,0,0
110516,0,0,0,0,0
116312,0,0,0,0,0
5043,0,0,0,0,0
86780,0,0,0,0,0
34479,0,0,0,0,0
118454,0,0,0,0,0
76217,0,0,0,0,0
82842,0,0,0,0,0
36439,0,0,0,0,0
15631,0,0,0,0,0
43885,0,0,0,0,0
70032,0,0,0,0,0
44690,0,0,0,0,0
20669,0,0,0,0,0
67599,0,0,0,0,0
105504,0,0,0,0,0
96699,0,0,0,0,0
22356,0,0,0,0,0
42505,0,0,0,0,0
77185,0,0,0,0,0
37428,0,0,0,0,0
10076,0,0,0,0,0
12607,0,0,0,0,0
81705,0,0,0,0,0
16853,0,0,0,0,0
61668,0,0,0,0,0
68011,0,0,0,0,0
74958,0,0,0,0,0
67581,0,0,0,0,0
58864,0,0,0,0,0
31241,0,0,0,0,0
5448,0,0,0,0,0
57135,0,0,0,0,0
59015,0,0,0,0,0
99473,0,0,0,0,0
87833,0,0,0,0,0
91811,0,0,0,0,0
29674,0,0,0,0,0
902,0,0,0,0,0
85594,0,0,0,0,0
97814,0,0,0,0,0
27710,0,0,0,0,0
105529,0,0,0,0,0
23092,0,0,0,0,0
37830,0,0,0,0,0
87818,0,0,0,0,0
61465,0,0,0,0,0
44585,0,0,0,0,0
111488,0,0,0,0,0
106819,2,2,2,0,0
57225,0,0,0,0,0
28221,0,0,0,0,0
30817,0,0,0,0,0
21862,0,0,0,0,0
4758,0,0,0,0,0
118339,0,0,0,0,0
115819,0,0,0,0,0
104877,0,0,0,0,0
60773,0,0,0,0,0
94721,0,0,0,0,0
47318,0,0,0,0,0
88672,4,4,4,0,0
58997,0,0,0,0,0
29617,0,0,0,0,0
64299,0,0,0,0,0
49326,0,0,0,0,0
79065,0,0,0,0,0
83011,0,0,0,0,0
31321,0,0,0,0,0
57004,0,0,0,0,0
107906,0,0,0,0,0
2198,0,0,0,0,0
86441,0,0,0,0,0
84264,0,0,0,0,0
114513,0,0,0,0,0
75126,0,0,0,0,0
74006,0,0,0,0,0
16195,0,0,0,0,0
3620,0,0,0,0,0
43453,0,0,0,0,0
52821,0,0,0,0,0
6465,0,0,0,0,0
9297,0,0,0,0,0
51919,0,0,0,0,0
80406,0,0,0,0,0
79978,0,0,0,0,0
17257,0,0,0,0,0
37824,0,0,0,0,0
4102,0,0,0,0,0
30513,0,0,0,0,0
108545,0,0,0,0,0
109926,0,0,0,0,0
24742,0,0,0,0,0
63853,0,0,0,0,0
103517,0,0,0,0,0
58029,0,0,0,0,0
47223,0,0,0,0,0
21508,0,0,0,0,0
87390,0,0,0,0,0
14745,0,0,0,0,0
43164,0,0,0,0,0
5138,0,0,0,0,0
47797,0,0,0,0,0
34325,0,0,0,0,0
60776,0,0,0,0,0
58484,0,0,0,0,0
108888,0,0,0,0,0
43727,4,4,4,0,0
39659,0,0,0,0,0
13761,0,0,0,0,0
104488,0,0,0,0,0
111579,0,0,0,0,0
90110,0,0,0,0,0
114284,0,0,0,0,0
26088,0,0,0,0,0
78068,0,0,0,0,0
43624,0,0,0,0,0
20667,0,0,0,0,0
39553,0,0,0,0,0
63642,0,0,0,0,0
120117,0,0,0,0,0
24351,0,0,0,0,0
12452,0,0,0,0,0
35267,0,0,0,0,0
34151,0,0,0,0,0
74375,0,0,0,0,0
35616,0,0,0,0,0
22632,0,0,0,0,0
8366,0,0,0,0,0
84292,0,0,0,0,0
23033,0,0,0,0,0
104459,0,0,0,0,0
37431,0,0,0,0,0
9744,0,0,0,0,0
9442,0,0,0,0,0
42357,0,0,0,0,0
106972,0,0,0,0,0
8742,0,0,0,0,0
76850,0,0,0,0,0
8529,0,0,0,0,0
40510,0,0,0,0,0
7196,0,0,0,0,0
40036,0,0,0,0,0
21657,0,0,0,0,0
28566,0,0,0,0,0
63386,0,0,0,0,0
73245,0,0,0,0,0
51896,0,0,0,0,0
446,0,0,0,0,0
91285,0,0,0,0,0
81127,0,0,0,0,0
10536,0,0,0,0,0
107981,0,0,0,0,0
85733,0,0,0,0,0
30084,0,0,0,0,0
71776,0,0,0,0,0
86453,0,0,0,0,0
52943,0,0,0,0,0
104819,0,0,0,0,0
83465,0,0,0,0,0
53361,0,0,0,0,0
52261,0,0,0,0,0
28910,0,0,0,0,0
85793,0,0,0,0,0
64197,0,0,0,0,0
96234,0,0,0,0,0
51826,0,0,0,0,0
38794,0,0,0,0,0
44256,0,0,0,0,0
69446,0,0,0,0,0
93454,0,0,0,0,0
47866,0,0,0,0,0
90332,0,0,0,0,0
60892,0,0,0,0,0
43038,0,0,0,0,0
57338,0,0,0,0,0
40248,0,0,0,0,0
49945,1,1,1,0,0
50205,0,0,0,0,0
104291,0,0,0,0,0
106606,0,0,0,0,0
54345,0,0,0,0,0
4706,0,0,0,0,0
91873,0,0,0,0,0
48131,0,0,0,0,0
66798,0,0,0,0,0
14050,0,0,0,0,0
4441,0,0,0,0,0
115799,0,0,0,0,0
89091,0,0,0,0,0
26073,0,0,0,0,0
29448,0,0,0,0,0
78173,0,0,0,0,0
270,1,1,1,0,0
46055,0,0,0,0,0
335,0,0,0,0,0
102114,0,0,0,0,0
102097,0,0,0,0,0
2631,0,0,0,0,0
66606,0,0,0,0,0
112473,0,0,0,0,0
72718,0,0,0,0,0
41573,0,0,0,0,0
77894,0,0,0,0,0
105059,0,0,0,0,0
118885,0,0,0,0,0
72450,0,0,0,0,0
40347,0,0,0,0,0
119829,0,0,0,0,0
101086,0,0,0,0,0
110004,0,0,0,0,0
62695,0,0,0,0,0
69478,0,0,0,0,0
70733,0,0,0,0,0
23084,0,0,0,0,0
38044,0,0,0,0,0
8549,0,0,0,0,0
73105,0,0,0,0,0
89158,0,0,0,0,0
101393,0,0,0,0,0
26893,0,0,0,0,0
103681,0,0,0,0,0
18355,0,0,0,0,0
86412,0,0,0,0,0
83194,0,0,0,0,0
18207,0,0,0,0,0
108649,0,0,0,0,0
12710,0,0,0,0,0
26988,0,0,0,0,0
39181,0,0,0,0,0
16594,0,0,0,0,0
43536,0,0,0,0,0
28689,0,0,0,0,0
58259,0,0,0,0,0
19702,0,0,0,0,0
68318,0,0,0,0,0
91810,0,0,0,0,0
37825,0,0,0,0,0
3060,0,0,0,0,0
85795,0,0,0,0,0
86430,0,0,0,0,0
17718,0,0,0,0,0
52944,0,0,0,0,0
4692,0,0,0,0,0
15888,0,0,0,0,0
78561,0,0,0,0,0
102432,0,0,0,0,0
68175,0,0,0,0,0
60470,0,0,0,0,0
94607,0,0,0,0,0
36137,0,0,0,0,0
36409,0,0,0,0,0
56633,0,0,0,0,0
74508,0,0,0,0,0
49383,0,0,0,0,0
97077,0,0,0,0,0
23409,0,0,0,0,0
74669,0,0,0,0,0
98375,0,0,0,0,0
110154,0,0,0,0,0
34767,0,0,0,0,0
13939,0,0,0,0,0
99832,0,0,0,0,0
109186,0,0,0,0,0
48142,0,0,0,0,0
7492,0,0,0,0,0
88319,0,0,0,0,0
5289,0,0,0,0,0
114335,0,0,0,0,0
44514,1,1,1,0,0
21250,0,0,0,0,0
1695,0,0,0,0,0
102898,0,0,0,0,0
93154,0,0,0,0,0
65170,0,0,0,0,0
106797,0,0,0,0,0
82381,0,0,0,0,0
90937,0,0,0,0,0
29967,0,0,0,0,0
75700,0,0,0,0,0
23434,0,0,0,0,0
91217,0,0,0,0,0
90021,0,0,0,0,0
103276,0,0,0,0,0
8898,0,0,0,0,0
120157,0,0,0,0,0
5829,0,0,0,0,0
37351,0,0,0,0,0
107367,0,0,0,0,0
47532,0,0,0,0,0
64749,1,1,1,0,0
6018,0,0,0,0,0
1702,0,0,0,0,0
105308,0,0,0,0,0
44852,0,0,0,0,0
70135,0,0,0,0,0
48157,0,0,0,0,0
66112,0,0,0,0,0
2711,0,0,0,0,0
93084,0,0,0,0,0
66702,0,0,0,0,0
7675,0,0,0,0,0
97420,0,0,0,0,0
59998,0,0,0,0,0
9982,1,1,1,0,0
104914,0,0,0,0,0
65975,0,0,0,0,0
1189,0,0,0,0,0
112188,0,0,0,0,0
77087,0,0,0,0,0
14060,0,0,0,0,0
16989,0,0,0,0,0
45209,0,0,0,0,0
102849,0,0,0,0,0
61912,0,0,0,0,0
13958,0,0,0,0,0
66830,1,1,1,0,0
94069,0,0,0,0,0
80743,0,0,0,0,0
55235,0,0,0,0,0
60042,0,0,0,0,0
4263,0,0,0,0,0
111126,0,0,0,0,0
79707,0,0,0,0,0
55152,0,0,0,0,0
81240,0,0,0,0,0
114897,0,0,0,0,0
41277,0,0,0,0,0
24208,0,0,0,0,0
50330,1,1,1,0,0
25605,0,0,0,0,0
68277,0,0,0,0,0
81087,0,0,0,0,0
115680,0,0,0,0,0
11604,0,0,0,0,0
52750,0,0,0,0,0
55781,0,0,0,0,0
95828,0,0,0,0,0
19520,0,0,0,0,0
54524,0,0,0,0,0
14952,0,0,0,0,0
48257,0,0,0,0,0
54037,0,0,0,0,0
100754,0,0,0,0,0
29429,0,0,0,0,0
95435,0,0,0,0,0
101488,0,0,0,0,0
857,0,0,0,0,0
88205,0,0,0,0,0
58475,0,0,0,0,0
17532,0,0,0,0,0
72227,0,0,0,0,0
20228,0,0,0,0,0
88093,0,0,0,0,0
55348,0,0,0,0,0
51709,0,0,0,0,0
363,0,0,0,0,0
63786,0,0,0,0,0
17974,0,0,0,0,0
101875,0,0,0,0,0
86382,0,0,0,0,0
35473,0,0,0,0,0
112226,0,0,0,0,0
75810,0,0,0,0,0
63132,0,0,0,0,0
1431,0,0,0,0,0
44409,0,0,0,0,0
108370,0,0,0,0,0
1686,0,0,0,0,0
102712,0,0,0,0,0
70965,0,0,0,0,0
110898,0,0,0,0,0
19485,0,0,0,0,0
1240,0,0,0,0,0
83505,0,0,0,0,0
106705,0,0,0,0,0
98594,0,0,0,0,0
70727,0,0,0,0,0
3567,0,0,0,0,0
4082,0,0,0,0,0
118050,0,0,0,0,0
79967,0,0,0,0,0
65910,0,0,0,0,0
97452,0,0,0,0,0
53833,0,0,0,0,0
7673,0,0,0,0,0
118951,0,0,0,0,0
25170,0,0,0,0,0
95136,0,0,0,0,0
104159,0,0,0,0,0
51201,0,0,0,0,0
1329,0,0,0,0,0
61360,0,0,0,0,0
112765,0,0,0,0,0
113816,0,0,0,0,0
75543,0,0,0,0,0
103165,0,0,0,0,0
54420,0,0,0,0,0
56831,0,0,0,0,0
94347,0,0,0,0,0
72933,0,0,0,0,0
83,0,0,0,0,0
83763,0,0,0,0,0
18022,0,0,0,0,0
74320,0,0,0,0,0
12709,0,0,0,0,0
99845,0,0,0,0,0
98888,0,0,0,0,0
58470,0,0,0,0,0
86692,0,0,0,0,0
1295,0,0,0,0,0
60479,0,0,0,0,0
62455,0,0,0,0,0
51973,0,0,0,0,0
117501,0,0,0,0,0
70340,0,0,0,0,0
36854,0,0,0,0,0
92705,0,0,0,0,0
47013,0,0,0,0,0
57918,0,0,0,0,0
93876,0,0,0,0,0
19206,0,0,0,0,0
71558,0,0,0,0,0
53905,0,0,0,0,0
72344,0,0,0,0,0
50419,0,0,0,0,0
28646,0,0,0,0,0
65701,0,0,0,0,0
71662,0,0,0,0,0
42343,0,0,0,0,0
38516,0,0,0,0,0
78048,0,0,0,0,0
47687,0,0,0,0,0
10192,0,0,0,0,0
78617,0,0,0,0,0
17106,0,0,0,0,0
102650,0,0,0,0,0
97641,0,0,0,0,0
108109,1,1,1,0,0
95915,0,0,0,0,0
38696,0,0,0,0,0
117217,0,0,0,0,0
116867,0,0,0,0,0
16315,0,0,0,0,0
55847,0,0,0,0,0
28198,0,0,0,0,0
71393,0,0,0,0,0
53910,0,0,0,0,0
43255,0,0,0,0,0
74255,0,0,0,0,0
6216,0,0,0,0,0
33815,0,0,0,0,0
1101,0,0,0,0,0
95139,1,1,1,0,0
3215,0,0,0,0,0
41354,0,0,0,0,0
77342,0,0,0,0,0
62434,0,0,0,0,0
87415,0,0,0,0,0
27325,0,0,0,0,0
75408,0,0,0,0,0
105684,0,0,0,0,0
19986,1,1,1,0,0
10003,0,0,0,0,0
20504,0,0,0,0,0
31836,0,0,0,0,0
44029,0,0,0,0,0
77786,0,0,0,0,0
28458,0,0,0,0,0
30317,0,0,0,0,0
5687,0,0,0,0,0
110482,0,0,0,0,0
24841,0,0,0,0,0
9900,0,0,0,0,0
97958,0,0,0,0,0
1673,0,0,0,0,0
99126,0,0,0,0,0
120155,0,0,0,0,0
37955,0,0,0,0,0
16232,0,0,0,0,0
48363,0,0,0,0,0
53108,0,0,0,0,0
104248,0,0,0,0,0
89824,0,0,0,0,0
29058,0,0,0,0,0
95231,0,0,0,0,0
23035,0,0,0,0,0
115763,0,0,0,0,0
100019,0,0,0,0,0
52982,0,0,0,0,0
98989,0,0,0,0,0
20851,0,0,0,0,0
63422,0,0,0,0,0
109057,0,0,0,0,0
76660,0,0,0,0,0
27163,0,0,0,0,0
99639,0,0,0,0,0
21421,0,0,0,0,0
69833,0,0,0,0,0
88112,0,0,0,0,0
1600,0,0,0,0,0
54187,0,0,0,0,0
105152,0,0,0,0,0
26977,0,0,0,0,0
62865,0,0,0,0,0
94309,0,0,0,0,0
84583,0,0,0,0,0
90572,0,0,0,0,0
44058,0,0,0,0,0
2782,0,0,0,0,0
74532,0,0,0,0,0
114325,0,0,0,0,0
76054,0,0,0,0,0
41521,0,0,0,0,0
18178,0,0,0,0,0
10899,0,0,0,0,0
26862,0,0,0,0,0
19214,0,0,0,0,0
95110,0,0,0,0,0
12296,0,0,0,0,0
41217,0,0,0,0,0
37405,0,0,0,0,0
78436,0,0,0,0,0
111538,0,0,0,0,0
115977,0,0,0,0,0
38289,0,0,0,0,0
38905,0,0,0,0,0
115062,3,3,3,0,0
63369,0,0,0,0,0
52262,0,0,0,0,0
91395,0,0,0,0,0
15923,0,0,0,0,0
112804,0,0,0,0,0
84091,0,0,0,0,0
93707,0,0,0,0,0
79577,0,0,0,0,0
32405,0,0,0,0,0
29348,0,0,0,0,0
64603,0,0,0,0,0
4941,0,0,0,0,0
49131,0,0,0,0,0
101054,0,0,0,0,0
53227,0,0,0,0,0
62390,0,0,0,0,0
26597,0,0,0,0,0
42739,0,0,0,0,0
19478,0,0,0,0,0
42157,0,0,0,0,0
98318,0,0,0,0,0
95287,0,0,0,0,0
48537,0,0,0,0,0
61458,0,0,0,0,0
92374,0,0,0,0,0
84688,1,1,1,0,0
19480,0,0,0,0,0
31392,0,0,0,0,0
103136,0,0,0,0,0
108332,0,0,0,0,0
82043,0,0,0,0,0
110057,0,0,0,0,0
73849,0,0,0,0,0
115915,0,0,0,0,0
2871,0,0,0,0,0
76932,0,0,0,0,0
10493,0,0,0,0,0
20098,0,0,0,0,0
9561,0,0,0,0,0
39473,0,0,0,0,0
16600,0,0,0,0,0
53296,0,0,0,0,0
62611,0,0,0,0,0
100488,0,0,0,0,0
77660,0,0,0,0,0
106738,0,0,0,0,0
42491,0,0,0,0,0
92615,0,0,0,0,0
42893,0,0,0,0,0
27296,0,0,0,0,0
7271,0,0,0,0,0
58516,0,0,0,0,0
105578,0,0,0,0,0
43893,0,0,0,0,0
38722,0,0,0,0,0
49366,0,0,0,0,0
93725,0,0,0,0,0
46057,0,0,0,0,0
77719,0,0,0,0,0
56784,0,0,0,0,0
57279,0,0,0,0,0
12801,0,0,0,0,0
95924,0,0,0,0,0
26399,0,0,0,0,0
12147,0,0,0,0,0
17822,0,0,0,0,0
48057,0,0,0,0,0
5588,0,0,0,0,0
68763,0,0,0,0,0
53813,0,0,0,0,0
26788,0,0,0,0,0
99070,0,0,0,0,0
72758,0,0,0,0,0
90817,0,0,0,0,0
92071,0,0,0,0,0
81571,0,0,0,0,0
55508,0,0,0,0,0
55083,0,0,0,0,0
25230,0,0,0,0,0
40443,0,0,0,0,0
37641,0,0,0,0,0
52104,0,0,0,0,0
110831,0,0,0,0,0
90352,0,0,0,0,0
89039,0,0,0,0,0
91577,0,0,0,0,0
21184,0,0,0,0,0
28336,0,0,0,0,0
75084,0,0,0,0,0
47765,0,0,0,0,0
84817,4,4,4,0,0
66195,0,0,0,0,0
42788,0,0,0,0,0
115674,0,0,0,0,0
45106,0,0,0,0,0
109730,0,0,0,0,0
81176,0,0,0,0,0
30341,0,0,0,0,0
51504,0,0,0,0,0
109607,0,0,0,0,0
85554,0,0,0,0,0
114842,0,0,0,0,0
96633,1,1,1,0,0
52562,0,0,0,0,0
119809,0,0,0,0,0
46071,0,0,0,0,0
41795,0,0,0,0,0
68819,0,0,0,0,0
40717,0,0,0,0,0
82700,0,0,0,0,0
55341,0,0,0,0,0
15259,0,0,0,0,0
44195,0,0,0,0,0
66348,0,0,0,0,0
51875,0,0,0,0,0
85152,0,0,0,0,0
65466,0,0,0,0,0
7063,0,0,0,0,0
57608,0,0,0,0,0
18202,0,0,0,0,0
62295,0,0,0,0,0
96871,0,0,0,0,0
55661,1,1,1,0,0
43606,0,0,0,0,0
38801,0,0,0,0,0
36603,0,0,0,0,0
44575,0,0,0,0,0
23184,0,0,0,0,0
34947,0,0,0,0,0
100901,0,0,0,0,0
43651,0,0,0,0,0
22215,0,0,0,0,0
111934,0,0,0,0,0
8279,0,0,0,0,0
98183,0,0,0,0,0
104493,0,0,0,0,0
49796,0,0,0,0,0
77155,0,0,0,0,0
42468,0,0,0,0,0
7942,0,0,0,0,0
42884,0,0,0,0,0
80027,0,0,0,0,0
100192,0,0,0,0,0
8644,0,0,0,0,0
46256,0,0,0,0,0
59949,0,0,0,0,0
98528,0,0,0,0,0
63827,0,0,0,0,0
94899,0,0,0,0,0
45526,0,0,0,0,0
92667,0,0,0,0,0
32505,0,0,0,0,0
102198,0,0,0,0,0
64722,0,0,0,0,0
75557,0,0,0,0,0
46174,0,0,0,0,0
60277,0,0,0,0,0
67780,0,0,0,0,0
81886,0,0,0,0,0
86541,0,0,0,0,0
11500,0,0,0,0,0
79410,0,0,0,0,0
51406,0,0,0,0,0
23830,0,0,0,0,0
82943,0,0,0,0,0
114071,0,0,0,0,0
78746,0,0,0,0,0
77331,0,0,0,0,0
24402,0,0,0,0,0
26351,0,0,0,0,0
57648,0,0,0,0,0
118391,0,0,0,0,0
76086,0,0,0,0,0
7885,0,0,0,0,0
83579,0,0,0,0,0
46995,0,0,0,0,0
88509,0,0,0,0,0
84787,0,0,0,0,0
13254,0,0,0,0,0
62312,0,0,0,0,0
15041,0,0,0,0,0
115150,0,0,0,0,0
104598,0,0,0,0,0
63907,0,0,0,0,0
101456,0,0,0,0,0
89292,0,0,0,0,0
62212,0,0,0,0,0
65357,0,0,0,0,0
37951,0,0,0,0,0
69778,0,0,0,0,0
31145,0,0,0,0,0
98309,0,0,0,0,0
83791,0,0,0,0,0
119298,0,0,0,0,0
60193,0,0,0,0,0
22703,0,0,0,0,0
89266,0,0,0,0,0
84169,0,0,0,0,0
114734,0,0,0,0,0
49300,0,0,0,0,0
87453,0,0,0,0,0
113743,0,0,0,0,0
72395,0,0,0,0,0
25390,0,0,0,0,0
53524,0,0,0,0,0
108988,0,0,0,0,0
39962,0,0,0,0,0
35164,0,0,0,0,0
48158,0,0,0,0,0
33985,0,0,0,0,0
44351,0,0,0,0,0
61381,0,0,0,0,0
64783,0,0,0,0,0
29449,0,0,0,0,0
113441,0,0,0,0,0
684,0,0,0,0,0
67116,0,0,0,0,0
6665,0,0,0,0,0
113645,0,0,0,0,0
8097,0,0,0,0,0
120078,0,0,0,0,0
119697,0,0,0,0,0
90342,0,0,0,0,0
69872,0,0,0,0,0
30886,0,0,0,0,0
62874,0,0,0,0,0
54371,0,0,0,0,0
58345,0,0,0,0,0
111569,0,0,0,0,0
45483,0,0,0,0,0
32778,0,0,0,0,0
9513,0,0,0,0,0
12253,0,0,0,0,0
28159,0,0,0,0,0
107020,0,0,0,0,0
95806,0,0,0,0,0
110295,0,0,0,0,0
95504,0,0,0,0,0
18633,0,0,0,0,0
38605,0,0,0,0,0
16641,0,0,0,0,0
11400,0,0,0,0,0
112592,0,0,0,0,0
108582,1,1,1,0,0
104939,0,0,0,0,0
34448,0,0,0,0,0
117224,0,0,0,0,0
23701,0,0,0,0,0
76909,0,0,0,0,0
5837,0,0,0,0,0
50819,0,0,0,0,0
31191,0,0,0,0,0
5756,0,0,0,0,0
12959,0,0,0,0,0
104610,0,0,0,0,0
105823,0,0,0,0,0
59085,0,0,0,0,0
29109,0,0,0,0,0
49937,0,0,0,0,0
78215,0,0,0,0,0
35206,0,0,0,0,0
114863,0,0,0,0,0
5121,0,0,0,0,0
44695,0,0,0,0,0
39676,0,0,0,0,0
10718,0,0,0,0,0
30017,0,0,0,0,0
10840,0,0,0,0,0
11061,0,0,0,0,0
113792,0,0,0,0,0
114160,0,0,0,0,0
13330,0,0,0,0,0
95920,0,0,0,0,0
113425,0,0,0,0,0
47112,0,0,0,0,0
54955,0,0,0,0,0
103821,0,0,0,0,0
43771,0,0,0,0,0
46777,0,0,0,0,0
77323,0,0,0,0,0
74363,0,0,0,0,0
5950,0,0,0,0,0
91940,0,0,0,0,0
97059,0,0,0,0,0
72428,0,0,0,0,0
51644,0,0,0,0,0
32110,0,0,0,0,0
35980,0,0,0,0,0
106799,0,0,0,0,0
110589,0,0,0,0,0
81118,0,0,0,0,0
79192,0,0,0,0,0
120342,0,0,0,0,0
86167,0,0,0,0,0
36450,0,0,0,0,0
35494,0,0,0,0,0
24817,0,0,0,0,0
118076,0,0,0,0,0
1861,0,0,0,0,0
94950,0,0,0,0,0
82128,0,0,0,0,0
5086,0,0,0,0,0
120208,0,0,0,0,0
18006,0,0,0,0,0
68122,0,0,0,0,0
117772,0,0,0,0,0
220,3,3,3,0,0
48410,0,0,0,0,0
46729,0,0,0,0,0
37243,0,0,0,0,0
19498,0,0,0,0,0
72691,0,0,0,0,0
119923,0,0,0,0,0
7090,0,0,0,0,0
71247,0,0,0,0,0
16598,0,0,0,0,0
18502,0,0,0,0,0
72769,0,0,0,0,0
61603,0,0,0,0,0
23967,0,0,0,0,0
115252,0,0,0,0,0
14382,0,0,0,0,0
62051,0,0,0,0,0
116808,0,0,0,0,0
97812,0,0,0,0,0
73057,0,0,0,0,0
30241,0,0,0,0,0
9294,0,0,0,0,0
88813,0,0,0,0,0
15716,0,0,0,0,0
112837,1,1,1,0,0
79045,0,0,0,0,0
38117,0,0,0,0,0
101135,0,0,0,0,0
69573,0,0,0,0,0
104663,0,0,0,0,0
63881,0,0,0,0,0
69985,0,0,0,0,0
105317,0,0,0,0,0
4212,0,0,0,0,0
46663,0,0,0,0,0
75874,0,0,0,0,0
46156,0,0,0,0,0
97464,0,0,0,0,0
43900,0,0,0,0,0
76968,0,0,0,0,0
43992,0,0,0,0,0
96790,0,0,0,0,0
97281,0,0,0,0,0
3144,0,0,0,0,0
71045,0,0,0,0,0
56452,0,0,0,0,0
9718,0,0,0,0,0
51747,0,0,0,0,0
10042,0,0,0,0,0
56548,0,0,0,0,0
34403,0,0,0,0,0
107219,0,0,0,0,0
81104,0,0,0,0,0
64746,0,0,0,0,0
114829,0,0,0,0,0
62550,0,0,0,0,0
47468,0,0,0,0,0
105254,0,0,0,0,0
22181,0,0,0,0,0
20468,0,0,0,0,0
49143,0,0,0,0,0
115885,0,0,0,0,0
34396,3,3,3,0,0
55136,0,0,0,0,0
63761,0,0,0,0,0
37318,0,0,0,0,0
86934,0,0,0,0,0
3102,0,0,0,0,0
85257,0,0,0,0,0
80689,0,0,0,0,0
46802,0,0,0,0,0
69048,0,0,0,0,0
70703,0,0,0,0,0
9245,0,0,0,0,0
112852,0,0,0,0,0
4342,0,0,0,0,0
112542,0,0,0,0,0
5914,0,0,0,0,0
644,0,0,0,0,0
52565,0,0,0,0,0
66636,0,0,0,0,0
4481,0,0,0,0,0
114081,0,0,0,0,0
89560,0,0,0,0,0
49503,0,0,0,0,0
104860,0,0,0,0,0
19354,0,0,0,0,0
79008,0,0,0,0,0
40832,1,1,1,0,0
96730,0,0,0,0,0
46643,0,0,0,0,0
41698,2,2,2,0,0
68200,0,0,0,0,0
42707,0,0,0,0,0
93898,0,0,0,0,0
6300,0,0,0,0,0
32187,0,0,0,0,0
19323,0,0,0,0,0
59320,0,0,0,0,0
15138,0,0,0,0,0
39320,0,0,0,0,0
4622,0,0,0,0,0
37051,0,0,0,0,0
57323,0,0,0,0,0
90241,0,0,0,0,0
93212,0,0,0,0,0
58321,0,0,0,0,0
90099,0,0,0,0,0
49127,0,0,0,0,0
19653,0,0,0,0,0
18060,0,0,0,0,0
42581,0,0,0,0,0
91668,0,0,0,0,0
80182,0,0,0,0,0
28921,0,0,0,0,0
37895,0,0,0,0,0
26402,0,0,0,0,0
15971,0,0,0,0,0
3715,0,0,0,0,0
38050,0,0,0,0,0
112041,0,0,0,0,0
61695,0,0,0,0,0
27690,0,0,0,0,0
11597,0,0,0,0,0
31972,0,0,0,0,0
88913,0,0,0,0,0
27420,0,0,0,0,0
75142,0,0,0,0,0
22622,0,0,0,0,0
37309,0,0,0,0,0
58594,0,0,0,0,0
5463,0,0,0,0,0
99755,0,0,0,0,0
85824,0,0,0,0,0
15925,0,0,0,0,0
18095,0,0,0,0,0
105604,0,0,0,0,0
33982,0,0,0,0,0
21165,0,0,0,0,0
78891,0,0,0,0,0
55778,0,0,0,0,0
13984,0,0,0,0,0
53940,0,0,0,0,0
83189,0,0,0,0,0
53885,0,0,0,0,0
25593,0,0,0,0,0
20090,0,0,0,0,0
78602,0,0,0,0,0
42793,0,0,0,0,0
8800,0,0,0,0,0
84744,0,0,0,0,0
49580,0,0,0,0,0
94526,0,0,0,0,0
44021,0,0,0,0,0
117222,0,0,0,0,0
24401,9,9,9,0,0
33140,0,0,0,0,0
19305,0,0,0,0,0
47995,0,0,0,0,0
94499,0,0,0,0,0
38296,0,0,0,0,0
18121,0,0,0,0,0
52894,0,0,0,0,0
90338,0,0,0,0,0
16846,0,0,0,0,0
39456,0,0,0,0,0
68692,0,0,0,0,0
35264,0,0,0,0,0
106099,0,0,0,0,0
120221,0,0,0,0,0
94512,0,0,0,0,0
7260,0,0,0,0,0
66955,0,0,0,0,0
84672,0,0,0,0,0
16585,0,0,0,0,0
115627,0,0,0,0,0
1262,0,0,0,0,0
32313,0,0,0,0,0
33231,0,0,0,0,0
28744,0,0,0,0,0
109668,0,0,0,0,0
96066,0,0,0,0,0
43092,0,0,0,0,0
34505,0,0,0,0,0
58728,0,0,0,0,0
53858,0,0,0,0,0
47417,0,0,0,0,0
20457,0,0,0,0,0
36149,0,0,0,0,0
71129,0,0,0,0,0
106276,0,0,0,0,0
107556,0,0,0,0,0
51151,0,0,0,0,0
72598,0,0,0,0,0
113623,0,0,0,0,0
61650,0,0,0,0,0
9444,0,0,0,0,0
88739,0,0,0,0,0
96837,0,0,0,0,0
106221,0,0,0,0,0
77956,0,0,0,0,0
20357,0,0,0,0,0
74860,0,0,0,0,0
93394,0,0,0,0,0
50162,0,0,0,0,0
79568,0,0,0,0,0
7310,0,0,0,0,0
13391,0,0,0,0,0
86247,0,0,0,0,0
62465,2,2,2,0,0
55813,0,0,0,0,0
23436,0,0,0,0,0
87673,0,0,0,0,0
64709,0,0,0,0,0
54651,0,0,0,0,0
101281,0,0,0,0,0
44885,0,0,0,0,0
40216,0,0,0,0,0
60823,0,0,0,0,0
30019,0,0,0,0,0
15180,0,0,0,0,0
89946,0,0,0,0,0
114218,0,0,0,0,0
75368,0,0,0,0,0
3646,0,0,0,0,0
98387,0,0,0,0,0
26762,0,0,0,0,0
32889,0,0,0,0,0
57933,0,0,0,0,0
88585,0,0,0,0,0
44792,0,0,0,0,0
4744,0,0,0,0,0
60421,0,0,0,0,0
120526,0,0,0,0,0
88755,0,0,0,0,0
117456,0,0,0,0,0
5063,0,0,0,0,0
91677,0,0,0,0,0
109907,0,0,0,0,0
86501,0,0,0,0,0
113847,0,0,0,0,0
53398,0,0,0,0,0
97510,0,0,0,0,0
69626,0,0,0,0,0
51061,0,0,0,0,0
82596,0,0,0,0,0
16686,0,0,0,0,0
39147,0,0,0,0,0
104737,0,0,0,0,0
4881,0,0,0,0,0
128,0,0,0,0,0
88353,0,0,0,0,0
82921,0,0,0,0,0
9742,0,0,0,0,0
80448,0,0,0,0,0
90736,0,0,0,0,0
71319,0,0,0,0,0
19913,0,0,0,0,0
118740,0,0,0,0,0
113973,0,0,0,0,0
65992,0,0,0,0,0
28400,0,0,0,0,0
89835,0,0,0,0,0
3439,0,0,0,0,0
46374,0,0,0,0,0
95918,0,0,0,0,0
105845,0,0,0,0,0
63152,0,0,0,0,0
117956,0,0,0,0,0
18147,0,0,0,0,0
115632,0,0,0,0,0
44360,0,0,0,0,0
17746,0,0,0,0,0
115848,0,0,0,0,0
99996,0,0,0,0,0
109902,0,0,0,0,0
76892,0,0,0,0,0
32770,0,0,0,0,0
115401,0,0,0,0,0
29318,0,0,0,0,0
94159,0,0,0,0,0
111072,0,0,0,0,0
93996,0,0,0,0,0
111811,0,0,0,0,0
10515,0,0,0,0,0
22829,0,0,0,0,0
41735,0,0,0,0,0
78904,0,0,0,0,0
23924,0,0,0,0,0
20593,0,0,0,0,0
86516,0,0,0,0,0
59862,0,0,0,0,0
65217,0,0,0,0,0
3234,1,1,1,0,0
75898,0,0,0,0,0
105383,0,0,0,0,0
60372,0,0,0,0,0
57748,0,0,0,0,0
51589,0,0,0,0,0
13279,0,0,0,0,0
93592,0,0,0,0,0
99606,0,0,0,0,0
77712,0,0,0,0,0
8487,0,0,0,0,0
71945,0,0,0,0,0
96823,0,0,0,0,0
112499,0,0,0,0,0
37167,0,0,0,0,0
44242,0,0,0,0,0
26305,0,0,0,0,0
81863,0,0,0,0,0
70922,0,0,0,0,0
76427,0,0,0,0,0
88971,0,0,0,0,0
71628,0,0,0,0,0
79743,0,0,0,0,0
84606,0,0,0,0,0
119246,0,0,0,0,0
34427,0,0,0,0,0
6782,0,0,0,0,0
101377,0,0,0,0,0
110417,0,0,0,0,0
16468,0,0,0,0,0
106216,0,0,0,0,0
45149,0,0,0,0,0
83353,0,0,0,0,0
2627,0,0,0,0,0
39039,0,0,0,0,0
76199,0,0,0,0,0
96926,0,0,0,0,0
107520,0,0,0,0,0
88080,0,0,0,0,0
6847,0,0,0,0,0
111348,2,2,2,0,0
35359,0,0,0,0,0
32883,0,0,0,0,0
63092,0,0,0,0,0
58424,0,0,0,0,0
74244,0,0,0,0,0
15086,0,0,0,0,0
771,0,0,0,0,0
30119,0,0,0,0,0
42671,0,0,0,0,0
99836,0,0,0,0,0
10227,0,0,0,0,0
22876,0,0,0,0,0
89052,0,0,0,0,0
59414,0,0,0,0,0
60797,0,0,0,0,0
71460,0,0,0,0,0
59610,0,0,0,0,0
55641,0,0,0,0,0
51731,0,0,0,0,0
77809,0,0,0,0,0
65144,0,0,0,0,0
86635,0,0,0,0,0
15576,0,0,0,0,0
49258,0,0,0,0,0
91906,0,0,0,0,0
64521,0,0,0,0,0
32543,0,0,0,0,0
19710,0,0,0,0,0
100485,0,0,0,0,0
26410,0,0,0,0,0
66227,0,0,0,0,0
22969,0,0,0,0,0
14977,0,0,0,0,0
77449,0,0,0,0,0
91372,0,0,0,0,0
117168,1,1,1,0,0
108882,0,0,0,0,0
74604,0,0,0,0,0
28941,0,0,0,0,0
72867,0,0,0,0,0
5700,0,0,0,0,0
53573,0,0,0,0,0
37018,0,0,0,0,0
72422,0,0,0,0,0
81206,0,0,0,0,0
94931,0,0,0,0,0
97216,0,0,0,0,0
47499,0,0,0,0,0
74823,0,0,0,0,0
102150,0,0,0,0,0
24873,0,0,0,0,0
102126,0,0,0,0,0
103998,0,0,0,0,0
116758,0,0,0,0,0
111345,0,0,0,0,0
107072,0,0,0,0,0
61927,0,0,0,0,0
34529,0,0,0,0,0
109507,0,0,0,0,0
23670,0,0,0,0,0
35888,0,0,0,0,0
13315,0,0,0,0,0
78155,0,0,0,0,0
34532,0,0,0,0,0
50303,0,0,0,0,0
52748,0,0,0,0,0
18090,0,0,0,0,0
106761,4,4,4,0,0
29186,0,0,0,0,0
85791,0,0,0,0,0
105411,0,0,0,0,0
100633,0,0,0,0,0
97939,0,0,0,0,0
1110,0,0,0,0,0
42543,0,0,0,0,0
56375,0,0,0,0,0
69208,2,2,2,0,0
13855,0,0,0,0,0
110666,0,0,0,0,0
32924,0,0,0,0,0
28964,0,0,0,0,0
106470,0,0,0,0,0
45499,0,0,0,0,0
10572,0,0,0,0,0
28551,0,0,0,0,0
111409,0,0,0,0,0
106331,0,0,0,0,0
29558,0,0,0,0,0
44788,0,0,0,0,0
68628,0,0,0,0,0
64346,0,0,0,0,0
4636,0,0,0,0,0
65364,0,0,0,0,0
105779,0,0,0,0,0
108303,0,0,0,0,0
50396,0,0,0,0,0
59461,0,0,0,0,0
92833,0,0,0,0,0
16457,0,0,0,0,0
99171,0,0,0,0,0
78652,0,0,0,0,0
46446,0,0,0,0,0
18482,0,0,0,0,0
55798,0,0,0,0,0
77630,0,0,0,0,0
101314,0,0,0,0,0
101291,0,0,0,0,0
117798,0,0,0,0,0
46594,0,0,0,0,0
93570,0,0,0,0,0
100862,0,0,0,0,0
66510,0,0,0,0,0
42619,0,0,0,0,0
65812,0,0,0,0,0
13403,0,0,0,0,0
14276,0,0,0,0,0
5421,0,0,0,0,0
11850,0,0,0,0,0
20189,0,0,0,0,0
115008,0,0,0,0,0
23848,0,0,0,0,0
82987,0,0,0,0,0
20042,0,0,0,0,0
90571,0,0,0,0,0
100120,0,0,0,0,0
23966,0,0,0,0,0
99172,0,0,0,0,0
27654,0,0,0,0,0
81869,0,0,0,0,0
61019,0,0,0,0,0
52266,0,0,0,0,0
84907,0,0,0,0,0
83738,0,0,0,0,0
88409,0,0,0,0,0
13933,0,0,0,0,0
24224,0,0,0,0,0
87500,0,0,0,0,0
31140,0,0,0,0,0
77019,0,0,0,0,0
26778,0,0,0,0,0
107745,0,0,0,0,0
38894,0,0,0,0,0
43482,0,0,0,0,0
74400,0,0,0,0,0
65462,0,0,0,0,0
96428,0,0,0,0,0
69259,0,0,0,0,0
70002,0,0,0,0,0
80847,0,0,0,0,0
46010,0,0,0,0,0
22456,0,0,0,0,0
75741,0,0,0,0,0
47048,0,0,0,0,0
85816,1,1,1,0,0
105459,0,0,0,0,0
57688,0,0,0,0,0
62412,0,0,0,0,0
15577,0,0,0,0,0
9192,0,0,0,0,0
38626,0,0,0,0,0
29212,0,0,0,0,0
29468,0,0,0,0,0
41538,0,0,0,0,0
81619,0,0,0,0,0
63696,0,0,0,0,0
35199,0,0,0,0,0
49994,0,0,0,0,0
98937,0,0,0,0,0
52029,0,0,0,0,0
62320,0,0,0,0,0
108728,0,0,0,0,0
62669,0,0,0,0,0
45909,0,0,0,0,0
116830,0,0,0,0,0
68020,0,0,0,0,0
117774,0,0,0,0,0
75173,0,0,0,0,0
110680,0,0,0,0,0
23594,1,1,1,0,0
85566,0,0,0,0,0
74209,0,0,0,0,0
92983,0,0,0,0,0
91651,0,0,0,0,0
69562,0,0,0,0,0
14283,0,0,0,0,0
98187,0,0,0,0,0
25831,4,4,4,0,0
99245,1,1,1,0,0
48104,0,0,0,0,0
76657,0,0,0,0,0
104962,0,0,0,0,0
1451,0,0,0,0,0
14321,0,0,0,0,0
17337,0,0,0,0,0
42571,0,0,0,0,0
49358,0,0,0,0,0
19032,0,0,0,0,0
65411,0,0,0,0,0
25854,0,0,0,0,0
61344,0,0,0,0,0
74865,0,0,0,0,0
11300,0,0,0,0,0
39589,0,0,0,0,0
61127,0,0,0,0,0
2217,0,0,0,0,0
31843,0,0,0,0,0
14025,0,0,0,0,0
13768,0,0,0,0,0
50164,0,0.025,0,-0.025,0
113512,0,0.033333333,0,-0.033333333,0
102715,0,0.066666667,0,-0.066666667,0
5384,0,0.071428571,0,-0.071428571,0
11360,0,0.085,0,-0.085,0
98869,0,0.088888889,0,-0.088888889,0
58886,5,5.1,5,-0.1,0
99672,10,10.1,10,-0.1,0
84303,10,10.1,10,-0.1,0
52467,10,10.1,10,-0.1,0
16342,14,14.1,14,-0.1,0
84385,12,12.1,12,-0.1,0
45001,4,4.1,4,-0.1,0
104748,4,4.1,4,-0.1,0
119813,0,0.1,0,-0.1,0
38298,0,0.1,0,-0.1,0
119108,0,0.1,0,-0.1,0
47547,1,1.1,1,-0.1,0
675,1,1.1,1,-0.1,0
68668,1,1.1,1,-0.1,0
47496,1,1.1,1,-0.1,0
85973,1,1.1,1,-0.1,0
76885,1,1.1,1,-0.1,0
119812,1,1.1,1,-0.1,0
107107,1,1.1,1,-0.1,0
89067,1,1.1,1,-0.1,0
18335,1,1.1,1,-0.1,0
32964,1,1.1,1,-0.1,0
90488,2,2.1,2,-0.1,0
49217,1,1.1,1,-0.1,0
55826,1,1.1,1,-0.1,0
10199,1,1.1,1,-0.1,0
101611,2,2.1,2,-0.1,0
109929,1,1.1,1,-0.1,0
43834,1,1.1,1,-0.1,0
12995,1,1.1,1,-0.1,0
70986,1,1.1,1,-0.1,0
37694,1,1.1,1,-0.1,0
14175,1,1.1,1,-0.1,0
18228,1,1.1,1,-0.1,0
55733,1,1.1,1,-0.1,0
43828,1,1.1,1,-0.1,0
4140,1,1.175,1,-0.175,0
7689,12,12.2,12,-0.2,0
71985,9,9.2,9,-0.2,0
68664,14,14.2,14,-0.2,0
47880,1,1.2,1,-0.2,0
120372,1,1.2,1,-0.2,0
39209,1,1.2,1,-0.2,0
60388,1,1.2,1,-0.2,0
83560,1,1.2,1,-0.2,0
12893,1,1.2,1,-0.2,0
118560,1,1.2,1,-0.2,0
87490,1,1.2,1,-0.2,0
28438,1,1.2,1,-0.2,0
77658,0,0.2,0,-0.2,0
87399,0,0.2,0,-0.2,0
114613,0,0.2,0,-0.2,0
88953,0,0.2,0,-0.2,0
56644,2,2.2,2,-0.2,0
6762,2,2.2,2,-0.2,0
4948,2,2.2,2,-0.2,0
10466,2,2.2,2,-0.2,0
91973,2,2.2,2,-0.2,0
13398,2,2.2,2,-0.2,0
9085,2,2.2,2,-0.2,0
106150,3,3.2,3,-0.2,0
104157,0,0.225,0,-0.225,0
35320,1,1.260873016,1,-0.260873016,0
58461,3,3.3,3,-0.3,0
111944,3,3.3,3,-0.3,0
57662,2,2.3,2,-0.3,0
83228,3,3.3,3,-0.3,0
35294,3,3.3,3,-0.3,0
103144,2,2.3,2,-0.3,0
1497,0,0.3,0,-0.3,0
41204,1,1.3,1,-0.3,0
115030,1,1.3,1,-0.3,0
106533,1,1.3,1,-0.3,0
59011,1,1.3,1,-0.3,0
40594,1,1.3,1,-0.3,0
54226,1,1.3,1,-0.3,0
10000,10,10.3,10,-0.3,0
8398,0,0.381388889,0,-0.381388889,0
11667,2,2.4,2,-0.4,0
116027,1,1.4,1,-0.4,0
10692,1,1.4,1,-0.4,0
30073,0,0.4,0,-0.4,0
58112,9,9.4,9,-0.4,0
34684,4,4.4,4,-0.4,0
82271,4,4.4,4,-0.4,0
4407,0,0.402772922,0,-0.402772922,0
2408,0,0.402772922,0,-0.402772922,0
98866,0,0.402772922,0,-0.402772922,0
115887,1,1.417857143,1,-0.417857143,0
61879,0,0.433333333,0,-0.433333333,0
85381,1,1.5,1,-0.5,0
22519,17,17.5,17,-0.5,0
20118,1,1.5,1,-0.5,0
72408,3,3.5,3,-0.5,0
23829,4,4.516666667,4,-0.516666667,0
104206,8,8.6,8,-0.6,0
95644,11,11.6,11,-0.6,0
47533,6,6.6,6,-0.6,0
74496,0,0.6,0,-0.6,0
34002,1,1.6,1,-0.6,0
14435,1,1.6,1,-0.6,0
49504,2,2.6,2,-0.6,0
13910,1,1.6,1,-0.6,0
48290,2,2.6,2,-0.6,0
79188,2,2.691666667,2,-0.691666667,0
10097,8,8.7,8,-0.7,0
20518,28,28.7,28,-0.7,0
87488,0,0.7,0,-0.7,0
89245,1,1.7,1,-0.7,0
99295,0,0.7,0,-0.7,0
87120,7,7.7,7,-0.7,0
97617,0,0.711247972,0,-0.711247972,0
92474,0,0.711247972,0,-0.711247972,0
2550,0,0.711247972,0,-0.711247972,0
21959,0,0.711247972,0,-0.711247972,0
112640,0,0.711247972,0,-0.711247972,0
75137,4,4.753333333,4,-0.753333333,0
34373,3,3.8,3,-0.8,0
24206,2,2.8,2,-0.8,0
24778,6,6.8,6,-0.8,0
106196,0,0.8,0,-0.8,0
63785,1,1.8,1,-0.8,0
71466,12,12.8,12,-0.8,0
114121,0,0.834139225,0,-0.834139225,0
71725,1,1.847619048,1,-0.847619048,0
110056,0,0.858452951,0,-0.858452951,0
42728,3,3.9,3,-0.9,0
3348,3,3.9,3,-0.9,0
27544,3,3.9,3,-0.9,0
57155,1,1.9,1,-0.9,0
9453,3,3.9,3,-0.9,0
3024,1,1.9,1,-0.9,0
100174,0,0.9,0,-0.9,0
83558,1,2,2,-1,-1
36036,0,1,1,-1,-1
4126,3,4,4,-1,-1
93567,6,7,7,-1,-1
75767,0,1,1,-1,-1
32082,12,13,13,-1,-1
18508,1,2,2,-1,-1
57979,10,11.1,11,-1.1,-1
49364,4,5.1,5,-1.1,-1
953,19,20.1,20,-1.1,-1
47135,2,3.3,3,-1.3,-1
4375,1,2.3,2,-1.3,-1
114932,0,1.4,1,-1.4,-1
11547,2,3.4,3,-1.4,-1
47408,9,10.4,10,-1.4,-1
1147,4,5.4,5,-1.4,-1
1331,7,8.4,8,-1.4,-1
15112,11,12.4,12,-1.4,-1
1784,3,4.4,4,-1.4,-1
3155,14,15.4,15,-1.4,-1
1986,0,1.5,1,-1.5,-1
54791,2,3.6,3,-1.6,-1
32275,2,3.7,3,-1.7,-1
33906,0,1.744761905,1,-1.744761905,-1
11853,0,1.744761905,1,-1.744761905,-1
63826,3,4.8,4,-1.8,-1
55437,5,6.8,6,-1.8,-1
13718,3,4.8,4,-1.8,-1
4832,4,6,6,-2,-2
76757,9,11,11,-2,-2
2021,2,4,4,-2,-2
56920,3,5.11,5,-2.11,-2
112366,6,8.4,8,-2.4,-2
117949,0,2.7,2,-2.7,-2
2233,0,2.7,2,-2.7,-2
88898,4,6.7,6,-2.7,-2
7727,3,5.8,5,-2.8,-2
65122,6,8.8,8,-2.8,-2
104952,3,6.1,6,-3.1,-3
10987,17,20.2,20,-3.2,-3
33387,4,7.4,7,-3.4,-3
1421,3,6.7,6,-3.7,-3
24149,4,8,8,-4,-4
24808,21,25.3,25,-4.3,-4
2696,21,25.8,25,-4.8,-4
